甭	(dialect) very; (contraction of 不用[bù yòng]) need not; please don't||(dialect) very
牢固	firm; secure
鼓动	to urge (an activity that may be beneficial, harmful or neutral); to encourage; to agitate; to instigate; to incite; to beat; to flap (wings, a fan etc)
仁慈	benevolent; charitable; kind; kindly; kindness; merciful
熄灭	to stop burning; to go out (of fire); to die out; extinguished
狭窄	narrow
嘱咐	to urge; to exhort
铸造	to cast (pour metal into a mold)
魄力	courage; daring; boldness; resolution; drive
周密	careful; thorough; meticulous; dense; impenetrable
乡镇	village; township
推论	to infer; inference; corollary; reasoned conclusion
务必	must; to need to; to be sure to
眨	to blink; to wink
经纬	warp and woof; longitude and latitude; main points
操劳	to work hard; to look after
挎	to carry (esp. slung over the arm, shoulder or side)
舒畅	happy; entirely free from worry
阶层	social class
永恒	eternal; everlasting; fig. to pass into eternity (i.e. to die)
验证	to inspect and verify; experimental verification; to validate (a theory); to authenticate
恐吓	to threaten; to menace
迁徙	to migrate; to move
溪	variant of 溪[xī]; creek; rivulet
保管	to hold in safekeeping; to have in one's care; to guarantee; certainly; surely; custodian; curator
现成	ready-made; readily available
走漏	to leak (information, secrets etc); to smuggle and evade tax; to suffer shrinkage (partial loss of goods due to theft etc)
书面	in writing; written
闭塞	to stop up; to close up; hard to get to; out of the way; inaccessible; unenlightened; blocking
捎	to bring sth to sb; to deliver
气魄	spirit; boldness; positive outlook; imposing attitude
摧残	to ravage; to ruin
细致	delicate; fine; careful; meticulous; painstaking
动力	motive power; force; (fig.) motivation; impetus
算数	to count numbers; to keep to one's word; to hold (i.e. to remain valid); to count (i.e. to be important)
还原	to restore to the original state; to reconstruct (an event); reduction (chemistry)
化验	chemical examination; to do a lab test
剧本	script for play, opera, movie etc; screenplay; scenario
口气	tone of voice; the way one speaks; manner of expression; tone
不像话	unreasonable; shocking; outrageous
守护	to guard; to protect
预先	beforehand; in advance
溶解	to dissolve
展示	to reveal; to display; to show; to exhibit
毫无	not in the least; to completely lack
伴随	to accompany; to follow; to occur together with; concomitant
干旱	drought; arid; dry
问世	to be published; to come out
师范	teacher-training; pedagogical; normal (school, e.g. Beijing Normal University)
枯燥	dry and dull; uninteresting; tedious
动身	to go on a journey; to leave
配偶	spouse
瞬间	in an instant; in a flash
拟定	to draw up; to draft; to formulate
合算	worthwhile; to be a good deal; to be a bargain; to reckon up; to calculate
力争	to work hard for; to do all one can; to contend strongly
失踪	to be missing; to disappear; unaccounted for
哼	to groan; to snort; to hum; to croon; humph!
繁华	flourishing; bustling
储蓄	to save money (in a bank); savings
源泉	fountainhead; well-spring; water source; fig. origin
窝	nest; pit or hollow on the human body; lair; den; place; to harbor or shelter; to hold in check; to bend; classifier for litters and broods
悬殊	vastly different; poles apart
懒惰	idle; lazy
发育	to develop; to mature; growth; development; (sexually) mature
嫂子	(coll.) older brother's wife; sister-in-law
哦	sentence-final particle that conveys informality, warmth, friendliness or intimacy; may also indicate that one is stating a fact that the other person is not aware of; to chant||oh (interjection indicating doubt or surprise)||oh (interjection indicating that one has just learned sth)||sentence-final particle that conveys informality, warmth, friendliness or intimacy
混淆	to obscure; to confuse; to mix up; to blur; to mislead
预言	to predict; prophecy
征收	to levy (a tax); to expropriate
责怪	to blame; to rebuke
呼唤	to call out (a name etc); to shout
平行	parallel; of equal rank; simultaneous
折腾	to toss from side to side (e.g. sleeplessly); to repeat sth over and over again; to torment sb; to play crazy; to squander (time, money)
落成	to complete a construction project
拘束	to restrict; to restrain; constrained; awkward; ill at ease; uncomfortable; reticent
朝代	dynasty; reign (of a king)
短促	short in time; fleeting; brief; gasping (breath); curt (tone of voice)
自发	spontaneous
廉洁	incorruptible; unbribable; honest
饮食	eating and drinking; food and drink; diet
飘扬	to wave; to flutter; to fly
布置	to put in order; to arrange; to decorate; to fix up; to deploy
反常	unusual; abnormal
外表	external; outside; outward appearance
收缩	to pull back; to shrink; to contract; (physiology) systole
灿烂	to glitter; brilliant; splendid
目睹	to witness; to see at first hand; to see with one's own eyes
精密	accuracy; exact; precise; refined
领悟	to understand; to comprehend
压抑	to constrain or repress emotions; oppressive; stifling; depressing; repression
敞开	to open wide; unrestrictedly
凝聚	to condense; to coagulate; coacervation (i.e. form tiny droplets); aggregation; coherent
勇于	to dare to; to be brave enough to
视频	video
畅销	to sell well; bestselling; chart-topping
反射	to reflect; reflection (from a mirror etc); reflex (i.e. automatic reaction of organism)
敏锐	keen; sharp; acute
渗透	(lit. and fig.) to permeate; to seep into; (of a product, idea etc) to penetrate (in a population); (of hostile forces) to infiltrate; (chemistry) osmosis
栽培	to grow; to cultivate; to train; to educate; to patronize
奠定	to establish; to fix; to settle
打量	to size sb up; to look sb up and down; to take the measure of; to suppose; to reckon
皇后	empress; imperial consort
专程	specifically; specially (for that purpose)
抵制	to resist; to boycott; to refuse (to cooperate); to reject; resistance; refusal
偏僻	remote; desolate; far from the city
贤惠	variant of 贤慧[xián huì]
增添	to add; to increase
砍伐	to hew; to cut down
轮胎	tire; pneumatic tire
并非	really isn't
意图	intent; intention; to intend
蒸发	to evaporate; evaporation
含糊	ambiguous; vague; careless; perfunctory
眼色	signal made with one's eyes; meaningful glance
砸	to smash; to pound; to fail; to muck up; to bungle
势必	to be bound to; undoubtedly will
排练	to rehearse; rehearsal
驻扎	to station; to garrison (troops)
贵族	lord; nobility; nobleman; noblewoman; aristocrat; aristocracy
渔民	fisherman; fisher folk
嫌疑	suspicion; to have suspicions
正月	first month of the lunar year
气功	qigong, a traditional Chinese system of cultivating vital energy 气[qì] through coordinated breathing, movement and meditation
样品	sample; specimen
丘陵	hills
蔚蓝	azure; sky blue
炊烟	smoke from kitchen chimneys
计较	to bother about; to haggle; to bicker; to argue; plan; stratagem
顽固	stubborn; obstinate
派遣	to send (on a mission); to dispatch
冲突	to conflict; clash of opposing forces; collision (of interests); contention
妥当	appropriate; proper; ready
压缩	to compress; compression
嘈杂	noisy; clamorous
丁	male adult; the 4th of the 10 Heavenly Stems 天干[tiān gān]; fourth (used like "4" or "D"); small cube of meat or vegetable; (literary) to encounter; (archaic) ancient Chinese compass point: 195°; (chemistry) butyl; surname Ding
瓦解	to collapse; to disintegrate; to crumble; to disrupt; to break up
和蔼	kindly; nice; amiable
携带	to carry (on one's person); to support (old)
手艺	craftmanship; workmanship; handicraft; trade
文凭	diploma
掰	to break off or break open sth with one's hands; (fig.) to break off (a relationship)
颤抖	to shudder; to shiver; to shake; to tremble
姑且	for the time being; tentatively
盘旋	to spiral; to circle; to go around; to hover; to orbit
寄托	to entrust (to sb); to place (one's hope, energy etc) in; a thing in which one invests (one's hope, energy etc)
肿瘤	tumor
履行	to fulfill (one's obligations); to carry out (a task); to implement (an agreement); to perform
生物	organism; living creature; life form; biological; CL:个[gè]
宇宙	universe; cosmos
坠	to fall; to drop; to weigh down
重叠	to overlap; to superimpose; to telescope; to run together; to duplicate; one over another; superposition; an overlap; redundancy; reduplication (in Chinese grammar, e.g. 散散步[sàn sàn bù] to have a stroll)
体面	dignity; prestige; face; honorable; creditable; (of sb's appearance) presentable; respectable
靠拢	to draw close to
案件	case; instance; CL:宗[zōng],桩[zhuāng],起[qǐ]
阵地	(military) position; front
无耻	without any sense of shame; unembarrassed; shameless
传授	to impart; to pass on; to teach
见闻	what one has seen and heard; knowledge; one's experience
施加	to exert (effort or pressure)
响亮	loud and clear; resounding
柴油	diesel fuel
塑造	to model; to mold; (fig.) to create (a character, a market, an image etc); (fig.) (literature) to portray (in words)
开明	enlightened; open-minded; enlightenment
微观	micro-; subatomic
起草	to make a draft; to draw up (plans)
上任	to take office; previous (incumbent); predecessor
拼搏	to struggle; to wrestle
雕刻	to carve; to engrave; carving
焦急	anxiety; anxious
宣扬	to publicize; to advertise; to spread far and wide
引擎	engine (loanword); CL:台[tái]
级别	(military) rank; level; grade
英明	wise; brilliant
索取	to ask; to demand
表彰	to honor; to commend; to cite (in dispatches)
边界	boundary; border
嚷	to shout; to bellow; to make a big deal of sth; to make a fuss about sth
皱纹	wrinkle; CL:道[dào]
奴隶	slave
浑身	all over; from head to foot
规章	rule; regulation
刹那	an instant (Sanskrit: ksana); split second; the twinkling of an eye
赤字	(financial) deficit; red letter
空虚	hollow; emptiness; meaningless
濒临	on the edge of; (fig.) on the verge of; close to
融洽	harmonious; friendly relations; on good terms with one another
团圆	to have a reunion
凝固	to freeze; to solidify; to congeal; fig. with rapt attention
牢骚	discontent; complaint; to complain
稿件	piece of writing submitted for publication; manuscript; article
叮嘱	to warn repeatedly; to urge; to exhort again and again
能量	energy; capabilities
晃	to sway; to shake; to wander about; to dazzle; to flash past||to sway
激励	to encourage; to urge; motivation; incentive
沉淀	(chemistry) to settle; to precipitate; (chemistry) sediment; to precipitate; (fig.) to accumulate; precipitate
啰唆	variant of 啰嗦[luō suo]
固然	admittedly (it's true that...)
合伙	to act jointly; to form a partnership
污蔑	to slander; to smear; to tarnish
拨	to push aside with the hand, foot, a stick etc; to dial; to allocate; to set aside (money); to poke (the fire); to pluck (a string instrument); to turn round; classifier: group, batch
适宜	suitable; appropriate
桨	oar; paddle; CL:只[zhī]
娇气	delicate; squeamish; finicky
界限	boundary
恳切	earnest; sincere
清晰	clear; distinct
胸膛	chest
袭击	attack (esp. surprise attack); raid; to attack
俘虏	captive
从容	to go easy; unhurried; calm
愚蠢	silly; stupid
递增	to increase by degrees; in increasing order; incremental; progressive
舆论	public opinion
罕见	rare; rarely seen
澄清	to settle (of liquid); to become clear (by precipitation of impurities); precipitate (chemistry); to put in order; to quell disturbances; clear (of liquid); limpid; to clarify; to make sth clear; to be clear (about the facts)||to settle (of liquid)
成天	(coll.) all day long; all the time
刑事	criminal; penal
保重	to take care of oneself
活该	(coll.) serve sb right; deservedly; ought; should
急剧	rapid; sudden
偏偏	(indicating that sth turns out just the opposite of what one would wish) unfortunately; as it happened; (indicating that sth is the opposite of what would be normal or reasonable) stubbornly; contrarily; against reason; (indicating that sb or a group is singled out) precisely; only; of all people
墨水儿	erhua variant of 墨水[mò shuǐ]; ink; CL:瓶[píng]
格式	form; specification; format
杜绝	to put an end to
贝壳	shell (of a mollusk)
侧面	lateral side; side; aspect; profile
荣幸	honored (to have the privilege of ...)
局势	situation; state (of affairs)
伺候	to serve; to wait upon
尸体	dead body; corpse; carcass; CL:具[jù]
思念	to think of; to long for; to miss
溜	used in 冰溜[bīng liù]; to slip away; to escape in stealth; to skate||used in 冰溜[bīng liù]
一度	for a time; at one time; one time; once
草率	careless; negligent; sloppy; not serious
瘸	lame
范畴	category
紧迫	pressing; urgent
无比	incomparable; matchless
大意	careless; general idea; main idea||careless
成心	intentionally; deliberately; on purpose
意料	to anticipate; to expect; expectations
宣誓	to swear an oath (of office); to make a vow
遏制	to check; to contain; to hold back; to keep within limits; to constrain; to restrain
无辜	innocent; innocence; not guilty (law)
株	tree trunk; stump (tree root); a plant; classifier for trees or plants; strain (biology); to involve others (in shady business)
示威	to demonstrate (as a protest); a demonstration; a military show of force
爽快	refreshed; rejuvenated; frank and straightforward
序言	preface; introductory remarks; preamble; prelude
宪法	constitution (of a country); CL:部[bù]
弱点	weak point; failing
惦记	to think of; to keep thinking about; to be concerned about
疤	scar; scab
猛烈	fierce; violent; vigorous; intense
撇	to throw; to cast; left-slanting downward brush stroke (calligraphy); to cast away; to fling aside||to throw
新颖	lit. new bud; fig. new and original
和解	to settle (a dispute out of court); to reconcile; settlement; conciliation; to become reconciled
受罪	to endure; to suffer; hardships; torments; a hard time; a nuisance
日益	day by day; more and more; increasingly; more and more with each passing day
瘫痪	paralysis; be paralyzed (body, transportation, etc)
散布	to disseminate
眼神	expression or emotion showing in one's eyes; meaningful glance; wink; eyesight (dialect)
堵塞	to clog up; blockage
解雇	to fire; to sack; to dismiss; to terminate employment
密封	to seal up
废除	to abolish; to abrogate; to repeal
生锈	to rust; to grow rusty; to corrode; oxidization
行政	administration; (attributive) administrative; executive
报酬	reward; remuneration
过问	to show an interest in; to get involved with
简化	to simplify
附和	to agree; to go along with; to echo (what sb says)
沉闷	oppressive (of weather); heavy; depressed; not happy; (of sound) dull; muffled
嘿	hey
较量	to pit oneself against sb; to compete with sb; contest; battle; to haggle; to quibble
海拔	height above sea level; elevation
任意	any; arbitrary; at will; at random
滞留	(of a person) to remain in (a place) (due to circumstances that prevent one leaving); to be stranded; (of sth that would typically dissipate, e.g. floodwater, pollutants) to remain; to linger
灌溉	to irrigate
作风	style; style of work; way
荒唐	beyond belief; preposterous; absurd; intemperate; dissipated
压榨	to press; to squeeze; to extract juice, oil etc by squeezing
孔	hole; CL:个[gè]; classifier for cave dwellings; surname Kong
巴不得	(coll.) to be eager for; to long for; to look forward to
辩护	to speak in defense of; to argue in favor of; to defend; to plead
维持	to keep; to maintain; to preserve
慎重	cautious; careful; prudent
干劲	enthusiasm for doing sth
丰盛	rich; sumptuous
元首	head of state
频率	frequency
忍耐	to endure; to bear with; to exercise patience; to restrain oneself; patience; endurance
争端	dispute; controversy; conflict
缴纳	to pay (taxes etc)
隆重	grand; prosperous; ceremonious; solemn
古怪	strange; weird; eccentric; bizarre
出身	to be born of; to come from; family background; class origin
相差	to differ
愣	to look distracted; to stare blankly; distracted; blank; (coll.) unexpectedly; rash; rashly
朴素	plain and simple; unadorned; simple living; not frivolous
悲哀	grieved; sorrowful
呵	expel breath; my goodness
克制	to restrain; to control; restraint; self-control
拘留	to detain (a prisoner); to keep sb in custody
绣	to embroider; embroidery
大臣	chancellor (of a monarchy); cabinet minister
将就	to accept (a bit reluctantly); to put up with
跟踪	to follow sb's tracks; to tail; to shadow; tracking
吹捧	to flatter; to laud sb's accomplishments; adulation
噪音	rumble; noise; static (in a signal)
比喻	to compare; to liken to; metaphor; analogy; figure of speech; figuratively
解散	to dissolve; to disband
出卖	to offer for sale; to sell; to sell out; to betray
报复	to make reprisals; to retaliate; revenge; retaliation
及早	at the earliest possible time; as soon as possible
预兆	omen; sign (of sth yet to occur); prior indication; to foreshadow
擅自	without permission
独裁	dictatorship
起哄	to heckle; rowdy jeering; to create a disturbance
隐瞒	to conceal; to hide (a taboo subject); to cover up the truth
尖锐	sharp; intense; penetrating; pointed; acute (illness)
严峻	grim; severe; rigorous
才干	ability; competence
陡峭	precipitous
畏惧	to fear; to dread; foreboding
犹如	similar to; like
疏远	to drift apart; to become estranged; to alienate; estrangement
宽敞	spacious; wide
间隔	gap; interval; compartment; to divide; to separate; to leave a gap of (two weeks, three meters etc)
盗窃	to steal
引用	to quote; to cite; to recommend; to appoint; (computing) reference
绅士	gentleman
勤劳	hardworking; industrious; diligent
盛开	blooming; in full flower
揍	to hit; to beat (sb); (coll.) to smash (sth)
君子	nobleman; person of noble character
法人	legal person; corporation; see also 自然人[zì rán rén]
款待	to entertain; to be hospitable to
气压	atmospheric pressure; barometric pressure
承包	to contract; to undertake (a job)
空白	blank space
恰巧	by chance; as chance would have it
血压	blood pressure
滋润	moist; humid; to moisten; to provide moisture; comfortably off
扒	to rake up; to steal; to braise; to crawl; to peel; to skin; to tear; to pull down; to cling to (sth on which one is climbing); to dig||to rake up
真挚	sincere; sincerity
过失	error; fault; (law) negligence; delinquency
外向	extroverted (personality); (economics etc) export-oriented
拥护	to endorse; to support
榜样	example; model; CL:个[gè]
巷	lane; alley
压岁钱	money given to children as a gift on Chinese New Year's Eve
昂贵	expensive; costly
吝啬	stingy; mean; miserly
亏待	to treat sb unfairly
陈列	to display; to exhibit
确信	to be convinced; to be sure; to firmly believe; to be positive that; definite news
磨合	to break in; to wear in
固体	solid
惯例	convention; usual practice
人质	hostage
嘴唇	lip; CL:片[piàn]
朴实	plain; simple; guileless; down-to-earth; sincere and honest
媒介	intermediary; vehicle; vector; medium; media
奖赏	reward; prize; award
胡乱	careless; reckless; casually; absent-mindedly; at will; at random; any old how
根源	origin; root (cause)
诞辰	birthday
准则	norm; standard; criterion
招收	to hire; to recruit
天生	nature; disposition; innate; natural
会晤	to meet; meeting; conference
巡逻	to patrol (police, army or navy)
本能	instinct
苦涩	bitter and astringent; pained; agonized
吃苦	to bear hardships
诽谤	to slander; to libel
优异	exceptional; outstandingly good
哭泣	to weep
譬如	for example; for instance; such as
神仙	Daoist immortal; supernatural entity; (in modern fiction) fairy, elf, leprechaun etc; fig. lighthearted person
沮丧	dispirited; dejected; dismayed
湖泊	lake
传单	leaflet; flier; pamphlet
习俗	custom; tradition; local tradition; convention
启示	to reveal; to enlighten; enlightenment; revelation; illumination; moral (of a story etc); lesson
元宵节	Lantern Festival, the final event of the Spring Festival 春节, on 15th of first month of the lunar calendar
气概	lofty quality; mettle; spirit
种子	seed; CL:颗[kē],粒[lì]
生育	to give birth to; to bear; fertility
宗旨	objective; aim; goal
力求	to make every effort to; striving to do one's best
掩饰	to cover up; to conceal; to mask; to gloss over
拖延	to delay; to put off; to procrastinate
复兴	to revive; to rejuvenate; Fuxing district of Handan city 邯郸市[hán dān shì], Hebei; Fuxing or Fuhsing township in Taoyuan county 桃园县[táo yuán xiàn], north Taiwan
遗传	heredity; to inherit (a trait); to pass on (to one's offspring)
孕育	to be pregnant; to produce offspring; to nurture (a development, school of thought, artwork etc); fig. replete with (culture etc)
酝酿	(of alcohol) to ferment; (of a crisis) to be brewing; to mull over (an issue); to hold exploratory discussions
开朗	spacious and well-lit; open and clear; (of character) optimistic; cheerful; carefree
行列	formation; array; (fig.) ranks (as in "join the ranks of ...")
谴责	to denounce; to condemn; to criticize; condemnation; criticism
敬业	dedicated to one's work
拐杖	crutches; crutch; walking stick
做主	see 作主[zuò zhǔ]
调剂	to adjust; to balance; to make up a medical prescription
磕	variant of 嗑[kè]; to tap; to knock (against sth hard); to knock (mud from boots, ashes from a pipe etc)
关照	to take care; to keep an eye on; to look after; to tell; to remind
崇敬	to revere; to venerate; high esteem
贼	thief; traitor; wily; deceitful; evil; extremely
倡议	to suggest; to initiate; proposal; initiative
驱逐	to expel; to deport; banishment
释放	to release; to set free; to liberate (a prisoner); to discharge
交涉	to negotiate (with); to have dealings (with)
冤枉	to accuse wrongly; to treat unjustly; injustice; wronged; not worthwhile
胆怯	timidity; timid; cowardly
赤道	equator (of the earth or a celestial body); celestial equator
迈	to take a step; to stride
牵制	to control; to curb; to restrict; to impede; to pin down (enemy troops)
拜托	to request sb to do sth; please!
乐谱	a musical score; sheet music
遵循	to follow; to abide by; to comply with
大不了	at worst; if worst comes to worst; (usu. in the negative) serious; alarming
神气	expression; manner; vigorous; impressive; lofty; pretentious
盛情	great kindness; magnificent hospitality
忧郁	sullen; depressed; melancholy; dejected
争气	to work hard for sth; to resolve on improvement; determined not to fall short
慢性	slow and patient; chronic (disease); slow to take effect (e.g. a slow poison)
严寒	bitter cold; severe winter
构思	to design; to plot; to plan out; to compose; to draw a mental sketch; conception; plan; idea; composition
欺骗	to deceive; to cheat
耗费	to waste; to spend; to consume; to squander
调和	harmonious; to mediate; to reconcile; mediation; to compromise; to mix; to blend; blended; to season; seasoning; to placate
导航	navigation
容忍	to put up with; to tolerate
上进	to make progress; to do better; fig. ambitious to improve oneself; to move forwards
空洞	cavity; empty; vacuous
反馈	to send back information; feedback
鉴于	in view of; seeing that; considering; whereas
强制	to force; to compel; to coerce; forced; compulsory
司令	commanding officer
请柬	invitation card; written invitation
宁愿	would rather ... (than ...)
论坛	forum (for discussion)
座右铭	motto; maxim
清除	to clear away; to eliminate; to get rid of
掀起	to lift; to raise (a lid etc); (of a storm) to surge; to stir up (waves etc); (fig.) to trigger; set off (a wave of popularity, a controversy etc)
堤坝	dam; dike
验收	to inspect and accept; acceptance
盯	to watch attentively; to fix one's attention on; to stare at; to gaze at
弊端	systemic problem (sometimes refers specifically to corrupt practices)
雄厚	substantial; robust; ample; abundant
生理	physiology
气质	personality traits; temperament; disposition; aura; air; feel; vibe; refinement; sophistication; class
庄严	solemn; dignified; stately
分明	clear; distinct; evidently; clearly
点缀	to decorate; to adorn; sprinkled; studded; only for show
舟	boat
残留	to remain; to be left over; residual; remnant; residue
迹象	sign; indication; mark; indicator
饲养	to raise; to rear
演变	to develop; to evolve
和气	friendly; polite; amiable
处置	to handle; to take care of; to punish
良心	conscience
挽回	to retrieve; to redeem
毅力	perseverance; willpower
境界	boundary; state; realm
蔓延	to extend; to spread
庄重	grave; solemn; dignified
效益	benefit; effectiveness; efficiency
眯	to narrow one's eyes; to squint; (dialect) to take a nap; to blind (as with dust)
革命	to withdraw the mandate of heaven (and transition to a new dynasty) (original meaning); revolution; revolutionary; to revolt (against sb or sth); to revolutionize (sth); (separable verb sometimes used in the pattern 革noun的命); CL:次[cì]
哨	a whistle; sentry
亲密	intimate; close
沼泽	marsh; swamp; wetlands; glade
庄稼	farm crop
安详	serene
搓	to rub or roll between the hands or fingers; to twist
盆地	(geography) basin; depression
咋	loud noise; shout; suddenly; dialectal equivalent of 怎么[zěn me]||gnaw||loud noise
沐浴	to take a bath; to bathe; to immerse
款式	elegant; elegance; good taste; pattern; style; design; CL:种[zhǒng]||elegant
陷害	to entrap; to set up; to frame (up); to make false charges against
萌芽	to sprout (lit. or fig.); to bud; to germinate; germ; seed; to bud; bud
呼吁	to call on (sb to do sth); to appeal (to); an appeal
附属	subsidiary; auxiliary; attached; affiliated; subordinate; subordinating
冷酷	unfeeling; callous
恼火	annoyed; riled; vexed
乌黑	jet-black; dark
惹祸	to stir up trouble; to invite disaster
告辞	to say goodbye; to take one's leave
羞耻	(a feeling of) shame
销毁	to destroy (by melting or burning); to obliterate
诧异	flabbergasted; astonished
丙	third of the ten Heavenly Stems 十天干[shí tiān gān]; third in order; letter "C" or Roman "III" in list "A, B, C", or "I, II, III" etc; ancient Chinese compass point: 165°; propyl
熬	to cook on a slow fire; to extract by heating; to decoct; to endure; to boil; to simmer||to cook on a slow fire
典型	model; typical case; archetype; typical; representative
规格	standard; norm; specification
股份	a share (in a company); stock
瞻仰	to revere; to admire
向往	to yearn for; to look forward to
愈	variant of 愈[yù]; to heal; the more...(the more...); to recover; better
蛋白质	protein
蕴藏	to hold in store; to contain (untapped reserves etc)
虚荣	vanity
刹车	to brake (when driving); to stop; to switch off; to check (bad habits); a brake
任命	to appoint; (job) appointment; CL:纸[zhǐ]
见解	opinion; view; understanding
是非	right and wrong; quarrel
扭转	to reverse; to turn around (an undesirable situation); (mechanics) torsion
败坏	to ruin; to corrupt; to undermine
奔波	to rush about; to be constantly on the move
雷达	radar (loanword)
贯彻	to implement; to put into practice; to carry out
撤退	to retreat
纯粹	pure; unadulterated; purely; completely
糟蹋	to waste; to defile; to abuse; to insult; to trample on; to wreck
反驳	to retort; to refute
隐蔽	to conceal; to hide; covert; under cover
逝世	to pass away; to die
分量	quantity; weight; measure; (vector) component||quantity
寂静	quiet
缺口	nick; jag; gap; shortfall
毅然	firmly; resolutely; without hesitation
盲目	blind; blindly; ignorant; lacking understanding
震撼	to shake; to shock; to stun; shocking; stunning; to shock; shock
同志	comrade; (slang) homosexual; CL:个[gè]
崭新	brand new
暧昧	vague; ambiguous; equivocal; dubious
欣慰	to be gratified
万分	very much; extremely; one ten thousandth part
国务院	State Council (PRC); State Department (USA)
人道	human sympathy; humanitarianism; humane; the "human way", one of the stages in the cycle of reincarnation (Buddhism); sexual intercourse
纵横	lit. warp and weft in weaving; vertically and horizontal; length and breadth; criss-crossed; able to move unhindered; abbr. for 合纵连横[hé zòng lián héng], School of Diplomacy during the Warring States Period (475-221 BC)
筹备	preparations; to get ready for sth
批发	wholesale; bulk trade; distribution
搁	to bear; to stand; to endure; to place; to put aside; to shelve||to bear
情报	information; intelligence
美妙	beautiful; wonderful; splendid
肥沃	fertile
淹没	to submerge; to drown; to flood; to drown out (also fig.)
烹饪	cooking; culinary arts
执着	to be strongly attached to; to be dedicated; to cling to; (Buddhism) attachment
容器	receptacle; vessel; (computing) container
翘	to stick up; to rise on one end; to tilt; outstanding; to raise||to stick up
沉着	steady; calm and collected; not nervous
愚昧	ignorant; uneducated; ignorance
摘要	summary; abstract
粉碎	to crush; to smash; to shatter
抹杀	to erase; to cover traces; to obliterate evidence; to expunge; to blot out; to suppress
腐朽	rotten; decayed; decadent; degenerate
笼罩	to envelop; to shroud
专长	specialty; special knowledge or ability
致力	to work for; to devote one's efforts to
探测	to probe; to survey
壮丽	magnificence; magnificent; majestic; glorious
记性	memory (ability to retain information)
汹涌	to surge up violently (of ocean, river, lake etc); turbulent
临床	clinical
霞	rose-tinted sky or clouds at sunrise or sunset
陈述	an assertion; to declare; to state
不得已	to act against one's will; to have no alternative but to; to have to; to have no choice; must
请示	to ask for instructions
文献	document
喇叭	horn (automobile etc); loudspeaker; brass wind instrument; trumpet; suona 锁呐[suǒ nà]
发扬	to develop; to make full use of
辨认	to recognize; to identify
往常	usual; customary
壮烈	brave; heroic
通缉	to order the arrest of sb as criminal; to list as wanted
诬陷	to entrap; to frame; to plant false evidence against sb
冒充	to feign; to pretend to be; to pass oneself off as
饥饿	hunger; starvation; famine
条约	treaty; pact; CL:个[gè]
列举	a list; to list; to enumerate
揭露	to expose; to unmask; to ferret out; to disclose; disclosure
化肥	fertilizer
完备	faultless; complete; perfect; to leave nothing to be desired
坦白	honest; forthcoming; to confess
光彩	luster; splendor; radiance; brilliance
章程	rules; regulations; constitution; statute; articles of association (of company); articles of incorporation; charter (of a corporation); by-laws
否决	to veto; to overrule
简陋	simple and crude
固有	intrinsic to sth; inherent; native
郑重	serious; solemn; earnest; conscientious
麻痹	paralysis; palsy; numbness; to benumb; (fig.) to lull; negligent; apathetic
融化	to melt; to thaw; to dissolve; to blend into; to combine; to fuse
温带	temperate zone
忌讳	taboo; to avoid as taboo; to abstain from
启蒙	to instruct the young; to initiate; to awake sb from ignorance; to free sb from prejudice or superstition; primer; enlightened; the Enlightenment; Western learning from the late Qing dynasty
心眼儿	one's thoughts; mind; intention; willingness to accept new ideas; baseless suspicions
冷落	desolate; unfrequented; to treat sb coldly; to snub; to cold shoulder
丑恶	ugly; repulsive
提示	to point out; to remind (sb of sth); to suggest; suggestion; tip; reminder; notice
敷衍	to elaborate (on a theme); to expound (the classics); perfunctory; to skimp; to botch; to do sth half-heartedly or just for show; barely enough to get by
外行	layman; amateur
振奋	to stir oneself up; to raise one's spirits; to inspire
蹬	to step on; to tread on; to put on; to wear (shoes, trousers etc); (slang) to dump (sb)
逼迫	to force; to compel; to coerce
简要	concise; brief
喘气	to breathe deeply; to pant; to gasp; to take a breather; to catch one's breath
投降	to surrender
卓越	outstanding; surpassing; distinguished; splendid
补救	to remedy
阵容	troop arrangement; battle formation; lineup (of a sports team etc)
倔强	stubborn; obstinate; unbending
平庸	mediocre; indifferent; commonplace
挑拨	to incite disharmony; to instigate
上游	upper reaches (of a river); upper level; upper echelon; upstream
心血	heart's blood; expenditure (for some project); meticulous care
抚摸	to gently caress and stroke; to pet; to fondle
埋伏	to ambush; to lie in wait for; to lie low; to ambush; ambush
崇高	majestic; sublime
荤	strong-smelling vegetable (garlic etc); non-vegetarian food (meat, fish etc); vulgar; obscene
丛	cluster; collection; collection of books; thicket
官方	government; official (approved or issued by an authority)
屏障	barrier
局部	part; local
珍稀	rare; precious and uncommon
播种	to grow (maize etc) from seed; to plant (maize etc) by sowing seed; to sow seeds||to grow (maize etc) from seed
里程碑	milestone
终究	in the end; after all is said and done
借助	to draw support from; with the help of
签署	to sign (an agreement)
档次	grade; class; quality; level
生疏	unfamiliar; strange; out of practice; not accustomed
酒精	alcohol; ethanol ch3CH2OH; ethyl alcohol; also written 乙醇; grain alcohol
嘲笑	to jeer at; to deride; to ridicule; mockery; derision
次序	sequence; order
连锁	to interlock; to be linked; chain (store etc)
步伐	pace; (measured) step; march
安宁	peaceful; tranquil; calm; composed; free from worry; Anning District of Lanzhou City 兰州市[lán zhōu shì], Gansu; Anning City, to the west of Kunming 昆明[kūn míng], Yunnan
操练	drill; practice
折磨	to torment; to torture
衰老	to age; to deteriorate with age; old and weak
挖掘	to excavate; to dig; to unearth
花瓣	petal; CL:片[piàn]
耀眼	to dazzle; dazzling
磋商	to consult; to discuss seriously; to negotiate; to confer; negotiations; consultations
诚挚	sincere; cordial
索性	you might as well (do it); simply; just
火药	gunpowder
诱惑	to entice; to lure; to induce; to attract
侦探	detective; to do detective work
镇静	calm; cool
地步	stage; degree (to which a situation has evolved); a (usu. bad) situation; leeway
孤立	to isolate; isolated; unrelated; irrelevant
耐用	durable
沾光	to bask in the light; fig. to benefit from association with sb or sth; reflected glory
慈善	benevolent; charitable
审理	to hear (a case)
无偿	free; no charge; at no cost
黄昏	dusk; evening; nightfall
磁带	magnetic tape; CL:盘[pán],盒[hé]
公道	fair; equitable; justice; fairness; public highway||fair
摇滚	rock 'n' roll (music); to rock; to fall off
推翻	to overthrow
攻克	to capture; to take; to overcome; to solve
响应	to respond to; answer; CL:个[gè]
啃	to gnaw; to nibble; to bite
周折	twists and turns; vicissitude; complication; difficulty; effort; CL:番[fān]
零星	fragmentary; random; bits and pieces; sporadic
联欢	to have a get-together; celebration; party
窜	to flee; to scuttle; to exile or banish; to amend or edit
贬低	to belittle; to disparage; to play down; to demean; to degrade; to devalue
检讨	to examine or inspect; self-criticism; review
统治	to rule (a country); to govern; rule; regime
谢绝	to refuse politely
反感	to be disgusted with; to dislike; bad reaction; antipathy
火焰	blaze; flame
直播	(TV, radio) to broadcast live; live broadcast; (Internet) to livestream; (agriculture) direct seeding
柔和	gentle; soft
捧	to hold or offer with both hands; to sing the praises of; classifier for what can be held in both hands
赞叹	to exclaim in admiration
土壤	soil
镶嵌	to inlay; to embed; to set (e.g. a jewel in a ring); tiling; tesselation
预料	to forecast; to anticipate; expectation
狠心	callous; heartless; to resolve (to do sth); firm resolve (as in 下狠心[xià hěn xīn])
宏伟	grand; imposing; magnificent
功劳	contribution; meritorious service; credit
阐述	to expound (a position); to elaborate (on a topic); to treat (a subject)
重心	center of gravity; central core; main part
陈旧	old-fashioned
哄	tumult; uproar; commotion; disturbance; roar of laughter (onom.); hubbub; to roar (as a crowd)||to deceive; to coax; to amuse (a child)||tumult
辜负	to fail to live up (to expectations); unworthy (of trust); to let down; to betray (hopes); to disappoint
私自	private; personal; secretly; without explicit approval
麻醉	anesthesia; to anesthetize; (fig.) to corrupt (sb's mind); to enervate; to numb the mind (to escape from harsh reality)
宁肯	would rather...; it would be better...; would prefer
潜水	to dive; to go under water; (in an online forum) to lurk
端正	upright; regular; proper; correct
蚂蚁	ant
茫然	blankly; vacantly; at a loss
当事人	persons involved or implicated; party (to an affair)
视野	field of view; (fig.) outlook; perspective
下属	subordinate; underling
福气	good fortune; a blessing
客户	client; customer
贪婪	avaricious; greedy; rapacious; insatiable; avid
话筒	microphone; (telephone) receiver; handset; megaphone; (fig.) mouthpiece; spokesperson
逢	to meet by chance; to come across; (of a calendar event) to come along; (of an event) to fall on (a particular day); to fawn upon
周边	periphery; rim; surroundings; all around; perimeter; peripheral (computing); spin-offs
美满	happy; blissful
分歧	divergent; difference (of opinion, position); disagreement; (math.) bifurcation
伯母	wife of father's elder brother; aunt; (polite form of address for a woman who is about the age of one's mother); CL:个[gè]
吩咐	to tell; to instruct; to command
掩盖	to conceal; to hide behind; to cover up
涮火锅	see 涮锅子[shuàn guō zi]
旗帜	ensign; flag
馅儿	erhua variant of 馅[xiàn]; stuffing; forcemeat; filling
鞭策	to spur on; to urge on; to encourage sb (e.g. to make progress)
笨拙	clumsy; awkward; stupid
挥霍	to squander money; extravagant; prodigal; free and easy; agile
谅解	to understand; to make allowances for; understanding
铜	copper (chemistry); see also 红铜[hóng tóng]; CL:块[kuài]
昼夜	day and night; period of 24 hours; continuously, without stop
缓和	to ease (tension); to alleviate; to moderate; to allay; to make more mild
卡通	cartoon (loanword)
烘	to bake; to heat by fire; to set off by contrast
精华	best feature; most important part of an object; quintessence; essence; soul
枕头	pillow
本钱	capital; (fig.) asset; advantage; the means (to do sth)
恶化	to worsen
灵感	inspiration; insight; a burst of creativity in scientific or artistic endeavor
赋予	to assign; to entrust (a task); to give; to bestow
威望	prestige
虐待	to mistreat; to maltreat; to abuse; mistreatment; maltreatment
跳跃	to jump; to leap; to bound; to skip
罪犯	criminal
乞丐	beggar
趴	to lie on one's stomach; to lean forward, resting one's upper body (on a desktop etc); (Tw) percent
致辞	to express in words or writing; to make a speech (esp. short introduction, vote of thanks, afterword, funeral homily etc); to address (an audience); same as 致词
迟缓	slow; sluggish
物资	goods; supplies
明智	sensible; wise; judicious; sagacious
绑架	to kidnap; to abduct; to hijack; a kidnapping; abduction; staking
僵硬	stiff; rigid
纳闷儿	erhua variant of 纳闷[nà mèn]; puzzled; bewildered
耸	to excite; to raise up; to shrug; high; lofty; towering
参照	to consult a reference; to refer to (another document)
布局	arrangement; composition; layout; opening (chess jargon)
取缔	to suppress; to crack down on; to prohibit
委员	committee member
荒谬	absurd; ridiculous
俗话	common saying; proverb
生机	opportunity to live; hope of success; vigor; vitality
招标	to invite bids
诈骗	to defraud; to swindle; to blackmail
玩意儿	erhua variant of 玩意[wán yì]; toy; plaything; thing; act; trick (in a performance, stage show, acrobatics etc)
悬挂	to suspend; to hang; (vehicle) suspension
充沛	abundant; plentiful
飞跃	to leap
呻吟	to moan; to groan
爱戴	to love and respect; to love and respect; love and respect
品德	moral character
茫茫	boundless; vast and obscure
幼稚	young; childish; puerile
支柱	mainstay; pillar; prop; backbone
伶俐	clever; witty; intelligent
自满	complacent; self-satisfied
捆绑	to bind
窍门	a trick; an ingenious method; know-how; the knack (of doing sth)
衰退	to decline; to fall; to drop; to falter; a decline; recession (in economics)
指望	to count on; to hope for; prospect; hope
炎热	blistering hot; sizzling hot (weather)
宰	to slaughter; to butcher; to kill (animals etc); (coll.) to fleece; to rip off; to overcharge; (bound form) to govern; to rule; (bound form) (a title for certain government officials in ancient China)
社区	community; neighborhood
攒	to collect; to hoard; to accumulate; to save; to bring together||to collect
涂抹	to paint; to smear; to apply (makeup etc); to doodle; to erase; to obliterate
吼	to roar; to howl; to shriek; roar or howl of an animal; bellow of rage
人为	artificial; man-made; having human cause or origin; human attempt or effort
摸索	to feel about; to grope about; to fumble; to do things slowly
解剖	to dissect (an animal); to analyze; anatomy
幢	classifier for buildings; carriage curtain (old); banner||classifier for buildings
偶像	idol
骨干	diaphysis (long segment of a bone); fig. backbone
屡次	repeatedly; time and again
颠簸	to be jolted around (car on a bumpy road, boat on a rough sea, aircraft experiencing turbulence); (fig.) to undergo a rough experience
苏醒	to come to; to awaken; to regain consciousness
勤俭	hardworking and frugal
婴儿	infant; baby; CL:个[gè]; lead (Pb)
惊奇	to be amazed; to be surprised; to wonder
对联	rhyming couplet; pair of lines of verse written vertically down the sides of a doorway; CL:副[fù],幅[fú]
辩证	to investigate; dialectical
备忘录	memorandum; aide-memoire; memorandum book
无非	only; nothing else
边疆	border area; borderland; frontier; frontier region
搏斗	to wrestle; to fight; to struggle
统统	totally
投掷	to throw sth a long distance; to hurl; to throw at; to throw (dice etc); to flip (a coin)
而已	that's all; nothing more
滋味	taste; flavor; feeling
辉煌	splendid; glorious
犬	dog; Kangxi radical 94
胸怀	one's bosom (the seat of emotions); breast; broad-minded and open; to think about; to cherish
脉搏	pulse (both medical and figurative)
废墟	ruins
导向	to be oriented towards; orientation
音响	sound; acoustics; audio; hi-fi system; stereo sound system; abbr. for 组合音响[zǔ hé yīn xiǎng]
敏捷	nimble; quick; shrewd
进而	and then (what follows next)
削弱	to weaken; to impair; to cripple
和睦	peaceful relations; harmonious
伪造	to forge; to fake; to counterfeit
挺拔	tall and straight
蔑视	to loathe; to despise; contempt
书记	secretary (chief official of a branch of a socialist or communist party); clerk; scribe
肖像	portrait (painting, photo etc); (in a general sense) representation of a person; likeness
副	secondary; auxiliary; deputy; assistant; vice-; abbr. for 副词 adverb; classifier for pairs, sets of things & facial expressions
寓言	fable; CL:则[zé]
毁灭	to perish; to ruin; to destroy
公关	public relations
塌	to collapse; to droop; to settle down
哆嗦	to tremble; to shiver; uncontrolled shaking of the body
踪迹	tracks; trail; footprint; trace; vestige
情理	reason; sense
悔恨	remorse; repentance
使命	mission; long-term task to which one devotes oneself; a calling
投机	congenial; agreeable; to speculate; to profiteer
渣	slag (in mining or smelting); dregs
查获	to track down and seize (a criminal suspect, contraband etc)
疙瘩	swelling or lump on skin; pimple; knot; lump; preoccupation; problem
论证	to prove a point; to expound on; to demonstrate or prove (through argument); proof
自卑	to have low self-esteem; to abase oneself
轮廓	outline; silhouette
荣誉	honor; credit; glory; (honorable) reputation; honorary
晾	to dry in the air; (fig.) to cold-shoulder
服气	to be convinced; to accept
神圣	divine; hallow; holy; sacred
生效	to take effect; to go into effect
理睬	to heed; to pay attention to
美观	pleasing to the eye; beautiful; artistic
冻结	to freeze (water etc); (fig.) to freeze (assets, prices etc)
反思	to think back over sth; to review; to revisit; to rethink; reflection; reassessment
忠实	faithful
储备	to store up; reserves
告诫	to warn; to admonish
反之	on the other hand...; conversely...
局限	to limit; to confine; to restrict sth within set boundaries
指南针	compass
处境	situation (of a person)
棍棒	club; staff; stick
挑剔	picky; fussy
秤	steelyard; Roman balance; CL:台[tái]
阻挠	to thwart; to obstruct (sth)
梢	tip of branch
威风	might; awe-inspiring authority; impressive
识别	to distinguish; to discern; to identify; to recognize
总和	sum
惩罚	penalty; punishment; to punish
排斥	to reject; to exclude; to eliminate; to remove; to repel
神经	nerve; mental state; (coll.) unhinged; nutjob
着重	to put emphasis on; to stress
登陆	to land; to come ashore; to make landfall (of typhoon etc); to log in (frequently used erroneous variant of 登录[dēng lù])
筐	basket; CL:只[zhī]
参谋	staff officer; to give advice
据悉	according to reports; it is reported (that)
条款	clause (of contract or law); CL:项[xiàng]
慈祥	kindly; benevolent (often of older person)
高明	brilliant; superior; wise; Gaoming, a district of Foshan 佛山市[Fo2shān Shì], Guangdong
书籍	books; works
悬念	suspense in a movie, play etc; concern for sb's welfare
流浪	to drift about; to wander; to roam; nomadic; homeless; unsettled (e.g. population); vagrant
加剧	to intensify
拳头	fist; clenched fist; CL:个[gè]; competitive (product)
把手	handle; grip; knob; to shake hands||handle
拧	stubborn; to pinch; wring||mistake; to twist||stubborn
动脉	artery
反面	reverse side; backside; the other side (of a problem etc); negative; bad
戒备	to take precautions; to guard against (emergency)
尖端	sharp pointed end; the tip; the cusp; tip-top; most advanced and sophisticated; highest peak; the best
连年	successive years; over many years
胡须	beard; CL:根[gēn],绺[liǔ]
狭隘	narrow; tight; narrow minded; lacking in experience
亲热	affectionate; intimate; warmhearted; to show affection for; (coll.) to get intimate with sb
非法	illegal
丸	ball; pellet; pill
疏忽	to neglect; to overlook; negligence; carelessness
扩充	to expand
凄凉	desolate (place); mournful; miserable
咀嚼	to chew; to think over
开采	to extract (ore or other resource from a mine); to exploit; to mine
表态	to declare one's position; to say where one stands
压制	to suppress; to inhibit; to stifle
盖章	to affix a seal; to stamp (a document); to sign off on sth
破例	to make an exception
传记	biography; CL:篇[piān],部[bù]
创业	to begin an undertaking; to start an enterprise; entrepreneurship
衣裳	(coll.) clothes
过滤	to filter; to filter; filter
作弊	to practice fraud; to cheat; to engage in corrupt practices
华侨	overseas Chinese; (in a restricted sense) Chinese emigrant who still retains Chinese nationality; CL:个[gè],位[wèi],名[míng]
亏损	deficit; (financial) loss
皆	all; each and every; in all cases
共和国	republic
充实	rich; full; substantial; to enrich; to augment; to substantiate (an argument)
逐年	year after year; with each passing year; over the years
救济	emergency relief; to help the needy with cash or goods
泄露	to leak (information); to divulge
过奖	to overpraise; to flatter
纪要	minutes; written summary of a meeting
捕捉	to catch; to seize; to capture
触犯	to violate; to offend
得力	able; capable; competent; efficient
陶瓷	pottery and porcelain; ceramics
腹泻	diarrhea; to have the runs
大体	in general; more or less; in rough terms; basically; on the whole; overall situation; the big picture; cadaver for dissection in training medical students
熏陶	to seep in; to influence; to nurture; to influence; training; influence
盛	flourishing; vigorous; magnificent; extensively; to contain; to ladle; to pick up with a utensil||flourishing; surname Sheng||to hold
淘汰	to wash out; (fig.) to cull; to weed out; to eliminate; to die out; to phase out
吹牛	to talk big; to shoot off one's mouth; to chat (dialect)
信誉	prestige; distinction; reputation; trust
工艺品	handicraft article; handiwork; CL:个[gè]
鉴别	to differentiate; to distinguish
格局	structure; pattern; layout
不愧	to be worthy of; to deserve to be called; to prove oneself to be
夕阳	sunset; the setting sun
苍白	pale; wan
封建	system of enfeoffment; feudalism; feudal; feudalistic
舱	cabin; the hold of a ship or airplane
结晶	to crystallize; crystallization; crystal; crystalline; (fig.) the fruit (of labor etc)
鸽子	pigeon; dove; various birds of the family Columbidae
昏迷	to lose consciousness; to be in a coma; stupor; coma; stunned; disoriented
果断	firm; decisive
部署	to dispose; to deploy; deployment
弊病	malady; evil; malpractice; drawback; disadvantage
拄	to lean on; to prop on
唠叨	to prattle; to chatter away; to nag; garrulous; nagging
视线	line of sight
呼啸	to whistle; to scream; to whiz
捞	to fish up; to dredge up
通俗	common; everyday; average
探望	to visit; to call on sb; to look around
油漆	oil paints; lacquer; to paint; CL:层[céng]
家伙	household dish, implement or furniture; domestic animal; (coll.) guy; chap; weapon
散发	to distribute; to emit; to issue
可恶	repulsive; vile; hateful; abominable
变质	to degenerate; to deteriorate; (of food) to go bad; to go off; (geology) metamorphism
应邀	at sb's invitation; on invitation
提拔	to promote to a higher job; to select for promotion
花蕾	bud; flower bud
意向	intention; purpose; intent; inclination; disposition
倘若	if; supposing; in case
谦逊	humble; modest; unpretentious; modesty
闪烁	flickering; twinkling; evasive; vague (of speech)
喜悦	happy; joyous
晋升	to promote to a higher position
黎明	dawn; daybreak
抢劫	to rob; looting
挪	to shift; to move
斑	spot; colored patch; stripe; spotted; striped; variegated
高超	excellent; superlative
授予	to award; to confer
摊	to spread out; vendor's stand
威力	might; formidable power
不妨	there is no harm in; might as well
对策	countermeasure for dealing with a situation
蹦	to jump; to bounce; to hop
支流	tributary (river)
竖	to erect; vertical; vertical stroke (in Chinese characters)
钩子	hook
憋	to choke; to stifle; to restrain; to hold back; to hold in (urine); to hold (one's breath)
知觉	perception; consciousness
逮捕	to arrest; to apprehend; an arrest
平面	plane (flat surface); print media
斯文	refined; educate; cultured; intellectual; polite; gentle
岩石	rock
口腔	oral cavity
机密	secret; classified (information)
宫殿	palace; CL:座[zuò]
耍	to play with; to wield; to act (cool etc); to display (a skill, one's temper etc); surname Shua
敌视	hostile; malevolence; antagonism; to view as enemy; to stand against
束缚	to bind; to tie up; to fetter; to shackle
开拓	to break new ground (for agriculture); to open up (a new seam); to develop (border regions); fig. to open up (new horizons)
展望	outlook; prospect; to look ahead; to look forward to
表决	to decide by vote; to vote
贩卖	to sell; to peddle; to traffic
遮挡	to shelter; to shelter from
牵扯	to involve; to implicate; to be interrelated
得罪	to offend sb; to make a faux pas; a faux pas; see also 得罪[dé zuì]; to commit an offense; to violate the law; excuse me! (formal); see also 得罪[dé zui]||to offend sb
扰乱	to disturb; to perturb; to harass
家常	the daily life of a family
媳妇	daughter-in-law; wife (of a younger man); young married woman; young woman
腐蚀	corrosion; to corrode (degrade chemically); to rot; corruption
伤脑筋	to be a real headache; to find sth a real headache; to beat one's brains
提议	proposal; suggestion; to propose; to suggest
刊登	to carry a story; to publish (in a newspaper or magazine)
高涨	to surge up; to rise; (of tensions etc) to run high
性感	sex appeal; eroticism; sexuality; sexy
追悼	to mourn; to pay last respects
启程	to set out on a journey
辐射	radiation
颠倒	to turn upside down; to reverse; back to front; confused; deranged; crazy
转折	shift in the trend of events; turnaround; plot shift in a book; turn in the conversation
领事馆	consulate
奥秘	secret; mystery
事务	(political, economic etc) affairs; work; transaction (as in a computer database)
雌雄	male and female
片断	section; fragment; segment
演绎	(of a story etc) to unfold; to play out; to develop (a technique etc); to enact; (logic) to deduce; to infer
要点	main point; essential
阻拦	to stop; to obstruct
熨	an iron; to iron; reconciled; smooth||an iron
分寸	propriety; appropriate behavior; proper speech or action; within the norms
盈利	profit; gain; to make profits
命名	to give a name to; to dub; to christen; to designate; named after; naming
渺小	minute; tiny; negligible; insignificant
慷慨	vehement; fervent; generous; magnanimous
踊跃	to leap; to jump; eager; enthusiastically
埋没	to engulf; to bury; to overlook; to stifle; to neglect; to fall into oblivion
季军	third in a race; bronze medalist
急切	eager; impatient
疲倦	to tire; tired
尚且	(not) even; yet; still
运算	to perform calculations; (mathematical) operation
世代	for many generations; generation; era; age
庸俗	vulgar; tacky; tawdry
歪曲	to distort; to misrepresent
粒	grain; granule; classifier for small round things (peas, bullets, peanuts, pills, grains etc)
威信	prestige; reputation; trust; credit with the people; Weixin county in Zhaotong 昭通[zhāo tōng], Yunnan
沉思	to contemplate; to ponder; contemplation; meditation
监视	to monitor; to keep a close watch over; surveillance
容貌	one's appearance; one's aspect; looks; features
勾结	to collude with; to collaborate with; to gang up with
封锁	to blockade; to seal off; to lock down
贫乏	impoverished; lacking; deficient; limited; meager; impoverishment; lack; deficiency
后勤	logistics
坚硬	hard; solid
思索	to think deeply; to ponder
涌现	to emerge in large numbers; to spring up; to emerge prominently
沸腾	(of a liquid) to boil; (of sentiments etc) to boil over; to flare up; to be impassioned
就近	nearby; in a close neighborhood
屑	bits; fragments; crumbs; filings; trifling; trivial; to condescend to
畔	(bound form) side; edge; boundary
仓促	all of a sudden; hurriedly
草案	draft (legislation, proposal etc)
后代	descendant; progeny; posterity; later ages; later generations
在意	to care about; to mind
让步	to concede; to give in; to yield; a concession; (linguistics) concessive
嫉妒	to be jealous of; to envy
灵敏	smart; clever; sensitive; keen; quick; sharp
曲折	winding; (fig.) complicated
雇佣	to employ; to hire
制止	to curb; to put a stop to; to stop; to check; to limit
着手	to put one's hand to it; to start out on a task; to set out
制服	to subdue; to check; to bring under control; (in former times) what one is allowed to wear depending on social status; uniform (army, party, school etc); livery (for company employees); CL:套[tào]
信赖	to trust; to have confidence in; to have faith in; to rely on
掠夺	to plunder; to rob
资深	veteran (journalist etc); senior; highly experienced
镇定	calm; unperturbed; cool
拜年	to pay a New Year call; to wish sb a Happy New Year
气势	imposing manner; loftiness; grandeur; energetic looks; vigor
把关	to guard a pass; to check on sth
地质	geology
国防	national defense
港湾	bay serving as a harbor
城堡	castle; rook (chess piece)
片刻	short period of time; a moment
嗅觉	sense of smell
纯洁	pure; clean and honest; to purify
更正	to correct; to make a correction
中立	neutral; neutrality
节制	to control; to restrict; to moderate; to temper; moderation; sobriety; to administer
改良	to improve (sth); to reform (a system)
溅	to splash
立方	cube (math.); abbr. for 立方体[lì fāng tǐ]; abbr. for 立方米[lì fāng mǐ]
内涵	meaningful content; implication; (semantics) connotation; inner qualities (of a person)
垂直	perpendicular; vertical
完毕	to finish; to end; to complete
以免	in order to avoid; so as not to
暂且	for now; for the time being; temporarily
严密	strict; tight (organization, surveillance etc)
割	to cut; to cut apart
旗袍	Chinese-style dress; cheongsam
动荡	unrest (social or political); turmoil; upheaval; commotion
四肢	the four limbs of the body
炉灶	stove
倾斜	to incline; to lean; to slant; to slope; to tilt
魔鬼	devil
编织	to weave; to knit; to plait; to braid; (fig.) to create (sth abstract, e.g. a dream, a lie etc)
作息	to work and rest
就职	to take office; to assume a post
实质	substance; essence
兴隆	prosperous; thriving; flourishing; Xinglong county in Chengde 承德[chéng dé], Hebei
疑惑	to doubt; to distrust; unconvincing; to puzzle over; misgivings; suspicions
之际	during; at the time of
机动	locomotive; motorized; power-driven; adaptable; flexible (use, treatment, timing etc)
欲望	desire; longing; appetite; craving
领会	to understand; to comprehend; to grasp
施展	to use fully; to put to use
恩怨	gratitude and grudges; resentment; grudges; grievances
剧烈	violent; acute; severe; fierce
颁布	to issue; to proclaim; to enact (laws, decrees etc)
情节	circumstances; plot; storyline
践踏	to trample
免疫	immunity (to disease)
狼狈	in a difficult situation; to cut a sorry figure; scoundrel! (derog.)
饱和	saturated; filled to capacity
监狱	prison
利害	terrible; formidable; serious; devastating; tough; capable; sharp; severe; fierce; pros and cons; advantages and disadvantages; gains and losses||terrible
体裁	genre; style; form of writing
公证	notarization; notarized; acknowledgement
淋	to filter; to strain; to drain; gonorrhea; (TCM) strangury; to sprinkle; to drip; to pour; to drench||to filter
宽容	lenient; tolerant; indulgent; charitable; to forgive
大肆	wantonly; without restraint (of enemy or malefactor); unbridled
穿越	to pass through; to traverse; to cross
确切	definite; exact; precise
推测	speculation; to conjecture; to surmise; to speculate
波涛	great waves; billows
发财	to get rich
潇洒	confident and at ease; free and easy
逆行	to go the wrong way; to go against one-way traffic regulation
疲惫	beaten; exhausted; tired
排放	to arrange in order; to emit; to discharge (exhaust gas, waste water etc); (of animals) to ovulate; to discharge semen
公安局	public security bureau (government office similar in function to a police station)
轰动	to cause a sensation; to create a stir in (a place); commotion; controversy
殴打	to beat up; to come to blows; battery (law)
发誓	to vow; to pledge; to swear
正气	healthy atmosphere; moral spirit; unyielding integrity; probity; (TCM) vital energy (resistance to diseases)
迫害	to persecute
辫子	plait; braid; pigtail; a mistake or shortcoming that may be exploited by an opponent; handle; CL:根[gēn],条[tiáo]
旷课	to play truant; to cut classes
气味	odor; scent
徘徊	to pace back and forth; to dither; to hesitate; (of sales figures etc) to fluctuate
断绝	to sever; to break off
贪污	to be corrupt; corruption; to embezzle
酗酒	heavy drinking; to get drunk; to drink to excess
坑	variant of 坑[kēng]; pit; depression; hollow; tunnel; hole in the ground; (archaic) to bury alive; to hoodwink; to cheat (sb)
视力	vision; eyesight
宏观	macro-; macroscopic; holistic
停泊	to anchor; anchorage; mooring (of a ship)
充当	to serve as; to act as; to play the role of
须知	key information; instructions; it must be borne in mind
司法	judicial; (administration of) justice
揉	to knead; to massage; to rub
要命	to cause sb's death; extremely; terribly; (used in complaining about sth) to be a nuisance
方圆	perimeter; range; (within) a radius of ...
严禁	to strictly prohibit
锋利	sharp (e.g. knife blade); incisive; to the point
泰斗	(abbr. for 泰山北斗[tài Shān Běi dǒu]) distinguished figure; doyen; revered authority
纤维	fiber; CL:种[zhǒng]
财政	finances (public); financial
灭亡	to be destroyed; to become extinct; to perish; to die out; to destroy; to exterminate
奢侈	luxurious; extravagant
臂	arm
偿还	to repay; to reimburse
留恋	reluctant to leave; to hate to have to go; to recall fondly
筛选	to filter
示意	to hint; to indicate (an idea to sb)
化妆	to put on makeup
标记	sign; mark; symbol; to mark up; (computing) token
武装	arms; equipment; to arm; military; armed (forces)
挣扎	to struggle
钙	calcium (chemistry)
隔阂	misunderstanding; estrangement; (language etc) barrier
砖	brick; CL:块[kuài]
捍卫	to defend; to uphold; to safeguard
纺织	spinning and weaving
精简	to simplify; to reduce
杂交	to hybridize; to crossbreed; promiscuity
共鸣	(physics) to resonate; resonance; sympathetic response
别扭	awkward; difficult; uncomfortable; not agreeing; at loggerheads; gauche
地势	terrain; topography relief
结算	to settle a bill; to close an account
立交桥	overpass; flyover
丢人	to lose face
姿态	attitude; posture; stance
侮辱	to insult; to humiliate; dishonor
断定	to conclude; to determine; to come to a judgment
凑合	to bring together; to make do in a bad situation; to just get by; to improvise; passable; not too bad
锤	variant of 锤[chuí]; hammer; to hammer into shape; weight (e.g. of a steelyard or balance); to strike with a hammer
财务	financial affairs
次品	substandard products; defective; seconds
灾难	disaster; catastrophe
容纳	to hold; to contain; to accommodate; to tolerate (different opinions)
考古	archaeology
辽阔	vast; extensive
迁就	to yield to; to adapt to; to accommodate oneself to (sth)
丰满	ample; well developed; fully rounded; Fengman district of Jilin city 吉林市, Jilin province
忙碌	busy; bustling
颈椎	cervical vertebra; the seven cervical vertebrae in the neck of humans and most mammals
背诵	to recite; to repeat from memory
打仗	to fight a battle; to go to war
漂浮	to float; to hover; to drift (also fig., to lead a wandering life); to rove; showy; superficial
手势	gesture; sign; signal
冒犯	to offend
遥控	to direct operations from a remote location; to remotely control
掐	to pick (flowers); to pinch; to nip; to pinch off; to clutch; (slang) to fight
东道主	host; official host (e.g. venue for games or a conference)
饶恕	to forgive; to pardon; to spare
兜	old variant of 兜[dōu]; pocket; bag; to wrap up or hold in a bag; to move in a circle; to canvas or solicit; to take responsibility for; to disclose in detail; combat armor (old)
连同	together with; along with
事态	situation; existing state of affairs
寒暄	to exchange conventional greetings; to exchange pleasantries
圈套	trap; snare; trick
陶醉	to be infatuated with; to be drunk with; to be enchanted with; to revel in
保障	to ensure; to guarantee; to safeguard
以致	to such an extent as to; down to; up to
钞票	paper money; a bill (e.g. 100 yuan); CL:张[zhāng],扎[zā]
皮革	leather; CL:张[zhāng]
颁发	to issue; to promulgate; to award
应酬	to engage in social activities; to socialize; dinner party; banquet; social engagement
警惕	to be on the alert; vigilant; alert; on guard; to warn
开除	to expel (a member of an organization); to fire (an employee)
叼	to hold with one's mouth (as a smoker with a cigarette or a dog with a bone)
督促	to supervise and urge completion of a task; to urge on
未免	unavoidably; can't help; really; rather
海滨	shore; seaside
衷心	heartfelt; wholehearted; cordial
声势	fame and power; prestige; influence; impetus; momentum
放射	to radiate; radioactive
缺席	to be absent
优越	superior; superiority
候选	candidate (attributive)
指令	order; command; instruction
清澈	clear; limpid
嗨	oh alas; hey!; hi! (loanword); a high (natural or drug-induced) (loanword)
损坏	to damage; to injure
不堪	cannot bear; cannot stand; utterly; extremely
留念	to keep as a souvenir; to recall fondly
橙	orange tree; orange (color)
捣乱	to disturb; to look for trouble; to stir up a row; to bother sb intentionally
租赁	to rent; to lease; to hire
泄气	to leak (gas); to be discouraged; to despair; (disparaging) pathetic; to vent one's anger; (of a tire) to be flat
坚韧	tough and durable; tenacious
特长	personal strength; one's special ability or strong points
解体	to break up into components; to disintegrate; to collapse; to crumble
繁忙	busy; bustling
生存	to exist; to survive
过瘾	to satisfy a craving; to get a kick out of sth; gratifying; immensely enjoyable; satisfying; fulfilling
留神	to take care; to be careful
导弹	(guided) missile; CL:枚[méi]
模型	model; mold; matrix; pattern
雕塑	a statue; a Buddhist image; sculpture; to carve
教养	to educate; to bring up; to nurture; upbringing; breeding; culture
奖励	to reward; reward (as encouragement)
制裁	to punish; punishment; sanctions (incl. economic)
搂	to hug; to embrace; to hold in one's arms; to draw towards oneself; to gather; to gather up (one's gown, sleeves etc); to grab (money); to extort||to hug
挽救	to save; to remedy; to rescue
罐	variant of 罐[guàn]; can; jar; pot
偏差	bias; deviation
武侠	martial arts chivalry (Chinese literary, theatrical and cinema genre); knight-errant
精确	accurate; precise
开支	expenditures; expenses (CL:笔[bǐ], 项[xiàng]); to spend money; (coll.) to pay wages
固执	obstinate; stubborn; to fixate on; to cling to
无赖	hoodlum; rascal; rogue; rascally; scoundrelly
机智	quick-witted; resourceful
别墅	villa; CL:幢[zhuàng],座[zuò]
布告	posting on a bulletin board; notice; bulletin; to announce
勘探	to explore; to survey; to prospect (for oil etc); prospecting
拽	to pull; to tug at (sth); to drag; to haul||to throw; to fling||alternate writing of 跩[zhuǎi]||to pull
唾弃	to spurn; to disdain
鼻涕	nasal mucus; snivel; snot
迎面	directly; head-on (collision); in one's face (of wind)
曝光	to expose (photography); (fig.) to expose (a scandal); (advertising) exposure
着想	to give thought (to others); to consider (other people's needs)
摇摆	to sway; to wobble; to waver
埋葬	to bury
开阔	wide; open (spaces); to open up
停滞	stagnation; at a standstill; bogged down
性命	life
覆盖	to cover
纽扣儿	button
航行	to sail; to fly; to navigate
隔离	to separate; to isolate
搀	to take by the arm and assist; to mix; to blend; to dilute; to adulterate
公然	openly; publicly; undisguised
岳母	wife's mother, mother-in-law
纲领	program (i.e. plan of action); guiding principle
混浊	turbid; muddy; dirty
飞翔	to circle in the air; to soar
屈服	to surrender; to succumb; to yield; (as a transitive verb) to defeat; to prevail over
以至	down to; up to; to such an extent as to ...; also written 以至于[yǐ zhì yú]
昔日	former days; in the past
裁缝	tailor; dressmaker; to make an item of clothing; to tailor||tailor
亦	also
激发	to arouse; to stimulate; (physics) to excite
衔接	to link up; to connect; to join
惋惜	to regret; to feel that it is a great pity; to feel sorry for sb
惊动	to alarm; to startle; to disturb
省会	provincial capital
任性	willful; headstrong; unruly
向来	always (previously)
瞪	to open (one's eyes) wide; to stare at; to glare at
背叛	to betray
趣味	fun; interest; delight; taste; liking; preference
精心	with utmost care; fine; meticulous; detailed
主义	-ism; ideology
垫	pad; cushion; mat; to pad out; to fill a gap; to pay for sb; to advance (money)
转达	to pass on; to convey; to communicate
立足	to stand; to have a footing; to be established; to base oneself on
斟酌	to consider; to deliberate; to fill up a cup to the brim
泛滥	to be in flood; to overflow (the banks); to inundate; to spread unchecked
数额	amount; sum of money; fixed number
颇	rather; quite; considerably; oblique; inclined; slanting; surname Po
翼	wing; area surrounding the bullseye of a target; to assist; one of the 28 constellations of Chinese astronomy; old variant of 翌; alternative name for 绛[jiàng] capital of the Jin State during the Spring and Autumn Period (770-475 BC); surname Yi
事项	matter; item
神态	appearance; manner; bearing; deportment; look; expression; mien
凶恶	variant of 凶恶, fierce; ferocious; fiendish; frightening; fierce
即便	even if; even though; right away; immediately
栋	classifier for houses or buildings; ridgepole (old)
航天	space flight
蜡烛	candle; CL:根[gēn],支[zhī]
失事	(of a plane, ship etc) to have an accident (plane crash, shipwreck, vehicle collision etc); to mess things up
依托	to rely on; to depend on; support
振兴	to revive; to revitalize; to invigorate; to re-energize; Zhengxing district of Dandong city 丹东市[dān dōng shì], Liaoning
歌颂	to sing the praises of; to extol; to eulogize
忠诚	devoted; loyal; fidelity; loyalty
并列	to stand side by side; to be juxtaposed
粉色	pink; white; erotic; beautiful woman; powdered (with make-up)
庞大	huge; enormous; tremendous
稠密	dense
岔	fork in road; bifurcation; branch in road, river, mountain range etc; to branch off; to turn off; to diverge; to stray (from the path); to change the subject; to interrupt; to stagger (times)
答辩	to reply (to an accusation); to defend one's dissertation
杂技	acrobatics; CL:场[chǎng]
申报	to report (to the authorities); to declare (to customs)
致使	to cause; to result in
不由得	can't help; cannot but
不惜	not stint; not spare; not hesitate (to do sth); not scruple (to do sth)
闲话	casual conversation; chat; gossip; to talk about (whatever comes to mind)
凹凸	concave or convex; bumps and holes; uneven (surface); rugged
出息	future prospects; profit; to mature; to grow up; to yield interest, profit etc; to exhale (Buddhism)||future prospects
拣	to choose; to pick; to sort out; to pick up
挫折	setback; reverse; check; defeat; frustration; disappointment; to frustrate; to discourage; to set sb back; to blunt; to subdue
椭圆	oval; ellipse; elliptic
分红	dividend; to award a bonus
归还	to return sth; to revert
声誉	reputation; fame
学说	theory; doctrine
派别	group; sect; clique; faction; school
恭敬	deferential; respectful
喉咙	the throat
风气	general mood; atmosphere; common practice
主权	sovereignty
出神	spellbound; entranced; lost in thought
气色	complexion
包庇	to shield; to harbor; to cover up
当面	to sb's face; in sb's presence
讥笑	to sneer
精通	to be proficient in; to master (a subject)
扩张	expansion; dilation; to expand (e.g. one's power or influence); to broaden
麻木	numb; insensitive; apathetic
哺乳	breastfeeding; to suckle; to nurse
体系	system; setup; CL:个[gè]
恨不得	wishing one could do sth; to hate to be unable; itching to do sth
冰雹	hail; hailstone; CL:场[cháng],粒[lì]
防御	defense; to defend
功效	efficacy
凝视	to gaze at; to fix one's eyes on
请帖	invitation card; written invitation
志气	ambition; resolve; backbone; drive; spirit
迟疑	to hesitate
事迹	deed; past achievement; important event of the past
玩弄	to play with; to toy with; to dally with; to engage in; to resort to
树立	to set up; to establish
言论	expression of opinion; views; remarks; arguments
畜牧	to raise animals
预算	budget
勉强	to do with difficulty; to force sb to do sth; reluctant; barely enough
拼命	to do one's utmost; with all one's might; at all costs; (to work or fight) as if one's life depends on it
打猎	to go hunting
起源	origin; to originate; to come from
历代	successive generations; successive dynasties; past dynasties
人性	human nature; humanity; human; the totality of human attributes
智商	IQ (intelligence quotient)
包袱	wrapping cloth; a bundle wrapped in cloth; load; weight; burden; funny part; punchline
妥善	appropriate; proper
遗失	to lose; to leave behind (inadvertently)
奔驰	to run quickly; to speed; to gallop; Benz (name); Mercedes-Benz, German car maker
夹杂	to mix together (disparate substances); to mingle; a mix; to be tangled up with
贬义	derogatory sense; negative connotation
瞄准	to take aim at; to target
磅	scale (instrument for weighing); to weigh; (loanword) pound (unit of weight, about 454 grams); (printing) point (unit used to measure the size of type)||used in 磅礴[páng bó]
剪彩	to cut the ribbon (at a launching or opening ceremony)
角落	nook; corner
内幕	inside story; non-public information; behind the scenes; internal
衬托	to serve to highlight; to serve as a backdrop or contrasting element
洽谈	to discuss
弹性	flexibility; elasticity
淡季	off season; slow business season; see also 旺季[wàng jì]
呈现	to appear; to emerge; to present (a certain appearance); to demonstrate
历来	always; throughout (a period of time); (of) all-time
歹徒	evildoer; malefactor; gangster; hoodlum
茂盛	lush
野心	ambition; wild schemes; careerism
坚实	firm and substantial; solid
若干	a certain number or amount; how many?; how much?
生态	ecology
感染	to infect; infection; (fig.) to influence
坟墓	grave; tomb
捏	variant of 捏[niē]; to hold between the thumb and fingers; to pinch; to mold (using the fingers); to hold (lit. in one's hand and fig.); to join together; to fabricate (a story, a report, etc)
缠绕	twisting; to twine; to wind; to pester; to bother
华丽	gorgeous
变故	an unforeseen event; accident; misfortune
液体	liquid
巴结	to fawn on; to curry favor with; to make up to
心得	what one has learned (through experience, reading etc); knowledge; insight; understanding; tips; CL:项[xiàng],个[gè]
峡谷	canyon; gill; ravine
挑衅	to provoke; provocation
船舶	shipping; boats
可口	tasty; to taste good
极限	limit; extreme boundary
额外	extra; added; additional
直径	diameter
魔术	magic
迷惑	to puzzle; to confuse; to baffle
急躁	irritable; irascible; impetuous
空隙	crack; gap between two objects; gap in time between two events
权衡	to consider; to weigh (a matter); to balance (pros and cons)
啥	dialectal equivalent of 什么[shén me]
感慨	to sigh with sorrow, regret etc; rueful; deeply moved
枯萎	to wilt; to wither; wilted; withered; drained; enervated; exhausted
劈	to split in two; to divide; to hack; to chop; to split open; (of lightning) to strike||to split in two
口头	oral; verbal
领土	territory
盛产	to produce in abundance; to be rich in
浸泡	to steep; to soak; to immerse
提炼	to extract (ore, minerals etc); to refine; to purify; to process
周转	to rotate; to circulate (cash, stock etc); turnover; circulation; cash flow
管辖	to administer; to have jurisdiction (over)
剥削	to exploit; exploitation
动静	(detectable) movement; (sign of) activity; movement and stillness
馋	gluttonous; greedy; to have a craving
描绘	to describe; to depict; to portray
油腻	greasy food; oily food; (of food) greasy; oily; fatty; (neologism c. 2017) (of a middle-aged man) obnoxious; pretentious; vulgar
遭殃	to suffer a calamity
文雅	elegant; refined
谋求	to seek; to strive for
风趣	charm; humor; wit; humorous; witty
顾虑	misgivings; apprehensions; to worry about; to be concerned about
明明	obviously; plainly; undoubtedly; definitely
正经	decent; honorable; proper; serious; according to standards
敬礼	to salute; to salute; salute
浓厚	dense; thick (fog, clouds etc); to have a strong interest in; deep; fully saturated (color)
文物	cultural relic; historical relic; CL:件[jiàn],个[gè]
遗留	to leave behind; to hand down
权威	authority; authoritative; power and prestige
钻石	diamond; CL:颗[kē]
佳肴	fine food; delicacies; delicious food
方位	direction; points of the compass; bearing; position; azimuth
框架	(construction) frame; (fig.) framework
恐怖	terrible; frightful; frightening; terror; terrorist
刊物	publication
秃	bald (lacking hair or feathers); barren; bare; denuded; blunt (lacking a point); (of a piece of writing) unsatisfactory; lacking something
空想	daydream; fantasy; to fantasize
妄想	to attempt vainly; a vain attempt; delusion
流露	to reveal (indirectly, implicitly); to show (interest, contempt etc) by means of one's actions, tone of voice etc
可观	considerable; impressive; significant
诉讼	lawsuit
豪迈	bold; open-minded; heroic
正负	positive and negative
