领先	keep ahead; to lead; to be in front
时光	time; era; period of time
卫星	satellite; moon; CL:颗[kē]
非得	Must; (followed by a verb phrase, then – optionally – 不可, or 不行 etc) must
气体	gas; gas (i.e. gaseous substance)
玉	jade
盗版	piracy; illegal copy; pirated; illegal; see also 正版[zhèng bǎn]
票价	ticket price; fare; ticket price; fare; admission fee
时而	from time to time; now … now …; occasionally; from time to time
上演	perform; staged; put on the stage; to screen (a movie); to stage (a play); a screening; a staging
约	appointment; agreement; arrange; restrict; to weigh in a balance or on a scale||to make an appointment; to invite; approximately; pact; treaty; to economize; to restrict; to reduce (a fraction); concise
家园	home; homeland; homestead; home; homeland
峰会	summit; summit meeting; summit meeting
高手	master; past master; master hand; ace; expert; past master; dab hand
乌云	dark clouds; black clouds; black cloud
特有	peculiar; characteristic; specific (to)/characteristic (of)/distinctive
敲 	knock on the door, or type; 
哪里	where; where?; somewhere; anywhere; wherever; nowhere (negative answer to question); humble expression denying compliment; also written 哪裡|哪里; where?; somewhere; anywhere; wherever; nowhere (negative answer to question); humble expression denying compliment
没错	that’s right; that's right; sure!; rest assured!; that's good; can't go wrong
网友	net friend; online friend/Internet user
仓库	depot; storehouse; warehouse
踏实	earnest, steady and sure; firmly-based; steady; steadfast; to have peace of mind; free from anxiety
酸奶	yogurt
个儿	height; size; stature; size; height; stature
常	always; ever; often; frequently; common; general; constant; surname Chang
高峰	peak; summit; height
南部	south; southern part
上周	last week
建造	construct; build; put up; to construct; to build
局面	aspect; phase; situation
高等	higher; advanced; high; of a higher level; high-level; higher (animals, education etc); advanced (math etc)
照样	all the same; as before; as before; (same) as usual; in the same manner; still; nevertheless
乐曲	music; musical composition; musical composition
潮流	tide; current; trend
配备	Equipment; to allocate; to provide; to outfit with
品质	quality; character; intrinsic quality (of a person); quality (of a product or service, or as in "quality of life", "air quality" etc)
操作	operation; to work; to operate; to manipulate
前头	front; thereinbefore; in front; at the head; ahead; above
名牌儿	famous brand; nameplate; name tag
科技	science and technology
改装	repack; refit; reequip; to change one's costume; to repackage; to remodel; to refit; to modify; to convert
瓜	melon; gourd; squash
薯条	french fries; french fried potatoes; chips
教师	teacher; teacher/CL:个[gè]
创意	creative; creativity
之下	under; beneath; less than
冰	ice; to chill sth; (of an object or substance) to feel cold; (of a person) cold; unfriendly; (slang) methamphetamine; CL:块[kuài]
暂停	pause; suspend; time out; to suspend; time-out (e.g. in sports); stoppage; pause (media player)
追究	Investigate; to investigate; to look into
打败	defeat; beat; be defeated; to defeat; to overpower; to beat; to be defeated
晚安	good night; Good night!/Good evening!
快要	be about to; be going to; nearly at the point of (doing sth); about to (do sth)
阻碍	hinder; to obstruct; to hinder; to block; obstruction; hindrance
昏	faint; lose consciousness; dusk; twilight; dull; muddle-headed; muddle-headed; twilight; to faint; to lose consciousness
不久	not long (after); before too long; soon; soon after
常规	conventional; common; routine; code of conduct; conventions; common practice; routine (medical procedure etc)
延续	continue; to continue; to go on; to last
指头	finger; toe; finger; toe; CL:个[gè]
率领	Lead; to lead; to command; to head
面向	turn in the direction of; face; turn towards; to face; to turn towards; to incline to; geared towards; catering for; -oriented; facial feature; appearance; aspect; facet
左	left; the Left (politics); east; unorthodox; queer; wrong; differing; opposite; variant of 佐[zuǒ]; surname Zuo
大巴	bus; (coll.) large bus; coach; (abbr. for 大型巴士)
中学	middle school; middle school/CL:个[gè]
航空	aviation
叹气	Sigh; to sigh; to heave a sigh
回顾	review; look back; to look back; to review
洗衣机	washing machine; washer/CL:台[tái]
围	enclose; surround; circle; to encircle; to surround; all around; to wear by wrapping around (scarf, shawl); surname Wei
早已	long ago; for a long time; for a long time; long since/(dialect) in the past
试验	experiment; test; to experiment; experimental; CL:次[cì],个[gè]
示范	lead the way; demonstrate; to demonstrate; to show how to do sth; demonstration; a model example
礼	ceremony; rite; courtesy; manners; gift; abbr. for 禮記|礼记[lǐ jì], Classic of Rites; gift; rite; ceremony; propriety; etiquette; courtesy; surname Li; CL:份[fèn]
束	beam; to bind; bunch; bundle; classifier for bunches, bundles, beams of light etc; to control; surname Shu
区域	area; region; district
繁殖	Reproduction; to breed; to reproduce; to propagate
窗口	window; wicket; window; opening providing restricted access (e.g. customer service window); computer operating system window; fig. medium; intermediary; showpiece; testing ground
吉祥	lucky; auspicious; lucky; auspicious; propitious
线路	line; route; circuit; (electricity) line; circuit; wire/(traffic) road; track; route
农产品	produce; farm produce; agricultural products; agricultural produce
名称	name; designation; name (of a thing)/name (of an organization)
旅馆	hotel; hotel/CL:家[jiā]
保卫	Defend; to defend; to safeguard
出院	discharged; leave hospital; to leave hospital; to be discharged from hospital
大爷	uncle; father’s elder brother; arrogant idler; self-centered show-off||(coll.) father's older brother; uncle; term of respect for older man
决不	never; not at all; definitely not; not at all; simply (can) not
美女	belle ; beauty; beautiful woman; beautiful woman
扣	to fasten; to button; button; buckle; knot; to arrest; to confiscate; to deduct (money); discount; to knock; to smash, spike or dunk (a ball); to cover (with a bowl etc); (fig.) to tag a label on sb; (Tw) (loanword) code; button
个体	individual
回信	reply; write in reply; letter in reply; to reply; to write back; letter written in reply; CL:封[fēng]
抄写	copy; transcribe; to copy; to transcribe
酷	cool; cruel; brutal; oppressive; very; extremely; ruthless; strong (e.g. of wine); (loanword) cool; hip
对付	deal with; to handle; to deal with; to tackle; to get by with; to make do; (dialect) (usu. used in the negative) to get along with (sb)
女孩儿	girl; lass
紧	tight; close; urgent; strict; tight; strict; close at hand; near; urgent; tense; hard up; short of money; to tighten
方针	policy; guidelines; CL:个[gè]
大多	mostly; for the most part; for the most part; many; most; the greater part; mostly
齐全	complete; all ready; complete; comprehensive
一下儿	a little bit; (used after a verb) give it a go; to do (sth for a bit to give it a try); one time; once; in a while; all of a sudden; all at once
省钱	save money; to save money
东部	east; the east; eastern part
实惠	substantial; tangible benefit; material advantages; cheap; economical; advantageous (deal); substantial (discount)
祝愿	wish; to wish
大街	avenue; street; main street; street; main street; CL:条[tiáo]
收购	purchase; acquisition; buy; to buy; to purchase; to procure
跟前	In front of; the front (of); (in) front; (in) sb's presence; just before (a date)||(of children, parents etc) at one's side; living with one
大都	for the most part; mostly; on the whole; on the whole; metropolitan; Dadu, capital of China during the Yuan Dynasty (1280-1368), modern day Beijing||for the most part
激情	passion; fervor; enthusiasm; strong emotion
出来	come; to come out; to appear; to arise||(after a verb, indicates coming out, completion of an action, or ability to discern or detect)
这边	this side; here
新兴	new; emerging; newly-developing; (of markets, industries, infectious diseases etc) rising; emerging; in the ascendant; Xinxing county in Yunfu 雲浮|云浮[yún fú], Guangdong; Xinxing or Hsinhsing district of Kaohsiung city 高雄市[gāo xióng shì], south Taiwan
以后	after; later on; afterwards; later; after; later; afterwards; following; later on; in the future
斤	a unit of weight (=1/2 kilogram); catty/(PRC) weight equal to 500 g/(Tw) weight equal to 600 g/(HK, Malaysia, Singapore) slightly over 604 g
报答	reciprocate; pay back; repay; to repay; to requite
打包	Pack; to wrap; to pack; to put leftovers in a doggy bag for take-out; (computing) to package (i.e. create an archive file)
黑暗	dark; darkness; murk; dark; darkly; darkness
企图	to attempt; to try; attempt; CL:种[zhǒng]
升级	upgrade; be stepped up; escalate; to go up by one grade; to be promoted; to escalate (in intensity); (computing) to upgrade
氧气	oxygen
集	gather; collect; collection; anthology; country fair; part; to gather; to collect; collected works; classifier for sections of a TV series etc: episode
获取	gain; obtain; to gain; to get; to acquire
资本	capital; capital (economics)
不顾	disregard; in spite of; regardless of
悲伤	sad; sorrowful; sad; sorrowful
高价	high price
旋转	rotate; to rotate; to revolve; to spin; to whirl
电子版	electronic edition; digital version
难看	ugly; unsightly
胜	win; defeat; beat; can bear; be superior; victory; success; to beat; to defeat; to surpass; victorious; superior to; to get the better of; better than; surpassing; superb (of vista); beautiful (scenery); wonderful (view); equal to (a task)
园	garden; an area of land for growing plants; a place for public recreation; land used for growing plants; site used for public recreation; abbr. for a place ending in 園|园, such as a botanical garden 植物園|植物园, kindergarten 幼兒園|幼儿园 etc; surname Yuan
配套	form a complete set; to form a complete set; compatible; matching; complementary
场面	scene; spectacle; occasion; situation
平方米	square metre; square meter
上边	above; on; the top; above; overhead; upwards; the top margin; above-mentioned; those higher up
户	household; family; door; a household; door; family
同一	same; identical; identical; the same
采购	Purchase; to procure (for an enterprise etc)/to purchase
正版	genuine; legal copy; genuine; legal; see also 盜版|盗版[dào bǎn]
投	throw; fling; hurl; cast; drop; put in; send; go to; to throw (sth in a specific direction: ball, javelin, grenade etc)/to cast (a ballot)/to cast (a glance, a shadow etc)/to put in (money for investment, a coin to operate a slot machine)/to send (a letter, a manuscript etc)/to throw oneself into (a river, a well etc to commit suicide)/to go to; to seek refuge; to place oneself into the hands of/(coll.) to rinse (clothes) in water
构造	structure; construction; structure; composition; tectonic (geology); CL:个[gè]
泪水	tear; teardrop; teardrop; tears
用来	be used for; used to; to be used for
战士	warrior; soldier; fighter; fighter; soldier; warrior; CL:个[gè]
有毒	poisonous; venomous; poisonous
大量	a lot of; lots of; great amount; large quantity; bulk; numerous; generous; magnanimous
虽	though; although; even if; although; even though
升值	appreciation; appreciate; increase in value; to rise in value; to appreciate
不许	not allow; must not; can’t; not to allow; must not; can't
有事	engaged; occupied; busy; something; to be occupied with sth; to have sth on one's mind; there is something the matter
上衣	upper outer garment; jacket; coat; jacket; upper outer garment; CL:件[jiàn]
变动	change; alteration; variation; to change; to fluctuate; change; fluctuation
动态	dynamic; movement; motion; development; trend; dynamic (science)
楼道	corridor; passageway (in storied building)
正义	justice; righteousness; just; righteous
同	same; similar; alike; like; together; like; same; similar; together; alike; with||see 衚衕|胡同[hú tòng]
主流	Main stream; main stream (of a river); fig. the essential point; main viewpoint of a matter; mainstream (culture etc)
通用	currency; to use anywhere, anytime (card, ticket etc)/to be used by everyone (language, textbook etc)/(of two or more things) interchangeable
店	shop; store; inn; old-style hotel (CL:家[jiā])/(bound form) shop; store
提出	put forward; propose; raise; to raise (an issue); to propose; to put forward; to suggest; to post (on a website); to withdraw (cash)
新郎	bridegroom; groom
典礼	ceremony; celebration
轨道	track; track (for trains etc); orbit (of a satellite); (fig.) a person's established path in life; desired trajectory (of a business or other endeavor); (audio engineering) track; (quantum mechanics) orbital
微博	Weibo (a Chinese social media app); microblogging; microblog
预备	prepare; get ready; preparation; to prepare; to make ready; preparation; preparatory
发送	send; transmit; dispatch; ship; forward; to transmit; to dispatch; to issue (an official document or credential)
适用	be applicable; be suitable; to be applicable
男子	man; male; a man; a male
通讯	communication; communications; news story; dispatch; CL:个[gè]
宽阔	broad; wide; expanse; spacious; expansive; wide; width; thickness
污水	sewage; slops; foul water; polluted water; sewage
真相	fact; truth; the truth about sth; the actual facts
生成	generate; produce; to generate; to produce; to form; to be formed; to come into being; to be born with; to be blessed with
立	stand; erect; stand; found; set up; upright; vertical; to stand; to set up; to establish; to lay down; to draw up; at once; immediately; surname Li
面对面	face to face; surface-to-surface; face to face
出汗	sweat; sweating; to perspire; to sweat
期限	term; time limit; deadline; allotted time
急	fast; anxious; urgent; annoyed; urgent; pressing; rapid; hurried; worried; to make (sb) anxious
签字	sign; affix one’s signature; sign a signature; to sign (one's name)/signature
录音机	recorder; sound recorder; transcription machine; (tape) recording machine; tape recorder; CL:台[tái]
不太	not too; not very much; 
要不然	otherwise; or else; or
上台	appear on the stage; come into power; to rise to power (in politics)/to go on stage (in the theater)
隐藏	hide; hiding; conceal; put out of sight; to hide; to conceal; to mask; to shelter; to harbor (i.e. keep sth hidden); to hide oneself; to lie low; to nestle; hidden; implicit; private; covert; recessed (lighting)
民间	nongovernmental; among the people; popular; folk; non-governmental; involving people rather than governments
塑料	plastic; plastics/CL:种[zhǒng]
面前	in front of; before; in front of; facing; (in the) presence (of)
加热	heat; heating; calefaction; to heat
景象	scene; sight; scene; sight (to behold)
心灵	bright; smart; quick-witted; heart; thoughts; spirit
要么	or; either … or …; or; either one or the other
国民	national; nationals; citizens; people of a nation
气象	Meteorological; meteorological feature; meteorology; atmosphere; ambience; scene; CL:个[gè]
城里	inside the city; in town; 
会见	meet with; pay a visit; to meet with (sb who is paying a visit)/CL:次[cì]
一代	generation
团结	Unite; to unite; unity; solidarity; united
派出	send; dispatch; to send; to dispatch
模特儿	model; (fashion) model (loanword)
本事	source material; original story||ability; skill
样	appearance; shape; sample; model; pattern; kind; type; manner; pattern; way; appearance; shape; classifier: kind, type
诸位	every one; (pron) everyone/Ladies and Gentlemen/Sirs
事后	after the event; afterwards; after the event; in hindsight; in retrospect
声明	to state; to declare; statement; declaration; CL:项[xiàng],份[fèn]
股东	shareholder; stockholder
政权	regime; political power
商场	mall; shopping mall; shopping mall; shopping center; department store; emporium; the business world; CL:家[jiā]
快活	happy; cheerful
西北	northwest; Northwest China (Shaanxi, Gansu, Qinghai, Ningxia, Xinjiang)
有人	someone; there’s someone; someone; people; anyone; there is someone there; occupied (as in restroom)
两边	either side; both sides
视为	treat; regard as; to view as; to see as; to consider to be; to deem
丧失	lose; to lose; to forfeit
不停	without stop; non-stop; incessant
手里	in one’s hands; in hand/(a situation is) in sb's hands
总监	director; chief inspector; head; director (of an organizational unit); (police) commissioner; inspector-general; rank of local governor in Tang dynasty administration
过道 	corridor; 
怨	blame ; complain; resentment; enmity; to blame/(bound form) resentment; hatred; grudge
记	remember; to record; to note; to memorize; to remember; mark; sign; classifier for blows, kicks, shots
碰到	meet; run into; bump into; to come across; to run into; to meet; to hit
代价	price; cost; consideration (in share dealing)
短语 	phrase; 
笔记	note; notes; to take down (in writing); notes; a type of literature consisting mainly of short sketches; CL:本[běn]
闹	noisy; make a noise; suffer; be troubled; noisy; cacophonous; to make noise; to disturb; to vent (feelings); to fall ill; to have an attack (of sickness); to go in (for some activity); to joke
跳远	long jump; broad jump; long jump (athletics)
融入	assimilate into; blend in; to blend into; to integrate; to assimilate; to merge
消防	firefighting; fire control
摩擦	rub; scrape; friction; rubbing; chafing; fig. disharmony; conflict; also written 磨擦
下去	go down; descend; go on; continue; to go down; to descend; to go on; to continue; (of a servant) to withdraw
突破	Breach; to break through; to make a breakthrough; to surmount (an obstacle); (sports) to break through the opponent's defense
远离	away; aloof; removed; to be far from; to keep away from
分组	grouping; to divide into groups; group (formed from a larger group); subgroup; (computer networking) packet
一带	area; surroundings; region; district; region; area
面貌	face; features; appearance; look; CL:个[gè]
深深	deeply; profoundly; deep; deep; profound
战胜	defeat; conquer; to prevail over; to defeat; to surmount
减轻	lighten; ease; alleviate; mitigate; mitigation; to lighten; to ease; to alleviate
前往	go to; leave for; proceed; to leave for; to proceed towards; to go to
搭档	to cooperate; partner
课题	topic; task; problem; issue
协助	assist; to provide assistance; to aid
为难	Embarrassed; to feel embarrassed or awkward; to make things difficult (for someone); to find things difficult (to do or manage)
小偷儿	thief
依次	in proper order; successively; in order; in succession
牌	brand; cards; plate; tablet; mahjong tile; playing card; game pieces; signboard; plate; tablet; medal; CL:片[piàn],个[gè],块[kuài]
外币	foreign currency
推销	promote sales; to market; to sell
彩色	multicolour; colour; color; multicolored; CL:种[zhǒng]
定期	regular; at set dates; at regular intervals; periodic; limited to a fixed period of time; fixed term
村	village; hamlet; village
测量	measure; survey; to measure; to gauge; to determine
费	fee; cost; to cost; to spend; fee; wasteful; expenses; surname Fei
古	ancient; old; ancient; old; paleo-; surname Gu
摄影师	photographer; cameraman; photographer; cameraman
故乡	Hometown; home; homeland; native place; CL:个[gè]
过度	excessive; over-; excess; going too far; extravagant; intemperate; overdue
fu	fu; 
留下	stay; remain; to leave behind; to stay behind; to remain; to keep; not to let (sb) go
穿上	put on; to put on (clothes etc)
起到	play; act as; (in an expression of the form 起到…作用[qǐ dào xx zuò yòng]) to have (a (motivating etc) effect); to play (a (stabilizing etc) role)
传达	Convey; to pass on; to convey; to relay; to transmit; transmission
查看	look over; examine; check; to look over; to examine; to check up; to ferret out
争夺	Fight for; to fight over; to contest; to vie over
点头	nod; to nod
级	level; rank; grade; degree; step; level; grade; rank; step (of stairs); classifier: step, level; CL:个[gè]
采纳	accept; to accept; to adopt
只顾	merely; simply; only care for; be absorbed to; solely preoccupied (with one thing); engrossed; focusing (on sth); to look after only one aspect
手续费	handling fee; commission charges; service charge; processing fee; commission
因	cause; reason; because; cause; reason; because
岁月	years; time
价	price; value; price; value; (chemistry) valence||great; good; middleman; servant
圆珠笔	ball point pen; ballpoint pen/CL:支[zhī],枝[zhī]
路人甲	a passerby/ an unimportant person; ordinary person A; generic person; some random person
酒	alcohol; liqueur; wine (esp. rice wine); liquor; spirits; alcoholic beverage; CL:杯[bēi],瓶[píng],罐[guàn],桶[tǒng],缸[gāng]
股	thigh; portion; share; strand; thigh; part of a whole; portion of a sum; (stock) share; strand of a thread; low-level administrative unit, translated as "section" or "department" etc, ranked below 科[kē]; classifier for long winding things like ropes, rivers etc; classifier for smoke, smells etc: thread, puff, whiff; classifier for bands of people, gangs etc; classifier for sudden forceful actions
肥	fat; fertile; fat; fertile; loose-fitting or large; to fertilize; to become rich by illegal means; fertilizer; manure
全力	full force; all-out; sparing no effort; with all one's strength; full strength; all-out (effort); fully (support)
母	mother; female; mother; elderly female relative; origin; source; (of animals) female
一路	all the way; take the same route; the whole journey; all the way; going the same way; going in the same direction; of the same kind
摆动	swing; sway; oscillate;vibrate; to sway; to swing; to move back and forth; to oscillate
下降	decline; drop; decrease; fall; go down; to decline; to drop; to fall; to go down; to decrease
运动会	sports meeting; sports competition/CL:个[gè]
病情	state of an illness; patient’s condition; state of an illness; patient's condition
总体	overall; total; entire; totality; completely; totally; total; entire; overall; population (statistics)
弹	shoot; catapult; fluff; flick; flip; play; leap; crossball; bullet; shot; shell; ball||to pluck (a string); to play (a string instrument); to spring or leap; to shoot (e.g. with a catapult); (of cotton) to fluff or tease; to flick; to flip; to accuse; to impeach; elastic (of materials)
强壮	strong; sturdy; robust; strong; sturdy; robust
摄像机	video camera; video camera/CL:部[bù]
带领	lead; to guide; to lead
替代	replace; substitute; to substitute for; to replace; to supersede
监测	monitor; to monitor
流动	flow; run; mobile; to flow; to circulate; to go from place to place; to be mobile; (of assets) liquid
特大	especially big; most; exceptionally big
春季	spring; springtime; springtime
凉	cool; the five Liang of the Sixteen Kingdoms, namely: Former Liang 前涼|前凉 (314-376), Later Liang 後涼|后凉 (386-403), Northern Liang 北涼|北凉 (398-439), Southern Liang 南涼|南凉[nán Liáng] (397-414), Western Liang 西涼|西凉 (400-421)||cool; cold||to let sth cool down
会谈	talks; conversation; talks; discussions; CL:次[cì]
执行	implement; to implement; to carry out; to execute; to run
右	right; (bound form) right; right-hand side/(bound form) (politics) right of center/(bound form) (old) west/(literary) the right side as the side of precedence
坐下	sit down; to sit down
军人	soldier; serviceman; serviceman; soldier; military personnel
免得	lest; so as not to; so as to avoid
车辆	car; vehicle; vehicle
老太太	old lady; elderly lady (respectful)/esteemed mother/CL:位[wèi]
闭幕	close; conclude; lower the curtain; the curtain falls; lower the curtain; to come to an end (of a meeting)
掌声	applause; applause/CL:阵[zhèn]
工程	engineering; project; engineering; an engineering project; project; undertaking; CL:个[gè],项[xiàng]
自在	free; comfortable; unrestrained; comfortable; at ease
刮	scratch; shave; fleece; extort; blow; shaving; to scrape; to blow; to shave; to plunder; to extort; to blow (of the wind)
陆军	army; ground force; land force; army; ground forces
信念	faith; belief; conviction
清明节	Tomb-Sweeping Day; Ching Ming Festival; Qingming or Pure Brightness Festival or Tomb Sweeping Day, celebration for the dead (in early April)
茄子	eggplant; eggplant (Solanum melongena L.); aubergine; brinjal; phonetic "cheese" (when being photographed); equivalent of "say cheese"; Guinea squash
发怒	get angry; fly into a rage; flare up; huff; to get angry
街头	street
代表团	delegation; mission; deputation; delegation/CL:个[gè]
艺人	actor; artist; artisan; handicraftsman; performing artist; actor
冷气	air conditioning; cool air; air conditioning (Tw)
天堂	paradise; heaven
关上	close;shut to; turn off; to close (a door)/to turn off (light, electrical equipment etc)
午睡	nap; to take a nap; siesta
动	move; (of sth) to move; to set in movement; to displace; to touch; to make use of; to stir (emotions); to alter; abbr. for 動詞|动词[dòng cí], verb
经费	funds; expenditure; CL:笔[bǐ]
下楼	go downstairs; come downstairs; to go downstairs
球	ball; sphere; globe; ball game; match; CL:个[gè]; CL:场[chǎng]
英勇	heroic; gallant; valiant
狠	ruthless; relentless; firm; resolute; suppress; harden; ruthless; fierce; ferocious; determined; resolute; to harden (one's heart); old variant of 很[hěn]
时常	often; frequently
两岸	both sides; both coasts; cross-strait; bilateral; both shores; both sides; both coasts; Taiwan and mainland
金	gold; chemical element Au; generic term for lustrous and ductile metals; money; golden; highly respected; one of the eight categories of ancient musical instruments 八音[bā yīn]; surname Jin; surname Kim (Korean); Jurchen Jin dynasty (1115-1234)
神	god; deity; divinity; spirit; expression; look; supernatural; magical; god; deity; supernatural; magical; mysterious; spirit; mind; energy; lively; expressive; look; expression; (coll.) awesome; amazing; God
大学	the Great Learning, one of the Four Books 四書|四书[sì shū] in Confucianism; university; college; CL:所[suǒ]
大学生	university student; college student
染	dye; to dye; to catch (a disease); to acquire (bad habits etc); to contaminate; to add color washes to a painting
干涉	to interfere; to meddle; interference
刚刚	just; only; just a moment ago; just recently; just a moment ago
掏	Dig; to fish out (from pocket); to scoop
超越	Transcend; to surpass; to exceed; to transcend
脸色	complexion; look; color; facial expression; complexion; look
损害	harm; damage; injure; hurt; harm; to damage; to impair
母鸡	hen; don't know (humorous slang mimicking Cantonese 唔知, Jyutping: m4 zi1)
职工	staff; worker; workers; staff/CL:个[gè]
露	reveal; expose; show; betray; dew; reveal; show; to reveal; to betray; to expose||dew; syrup; nectar; outdoors (not under cover); to show; to reveal; to betray; to expose; surname Lu||to show
一些	some; a few; a little; (following an adjective) slightly ...er
这些	these
阴影	shadow; shade; (lit. and fig.) shadow
新人	newcomer; new personality; new talent; newcomer; fresh talent; newlywed, esp. new bride; bride and groom; (paleoanthropology) Homo sapiens
他们	they; them
公民	citizen
晚报	evening paper; evening news; evening newspaper/(in a newspaper's name) Evening News
凡是	each and every; every; all; any
舞台	stage; arena; (lit. and fig.) stage; arena
下车	get off; to get off or out of (a bus, train, car etc)
海报	poster; playbill; poster; playbill; notice
早饭	breakfast; breakfast/CL:份[fèn],顿[dùn],次[cì],餐[cān]
尖脸 	sharp face; 
安	quiet; safe; secure; install; fix; fit; (bound form) calm; peaceful; to calm; to set at ease; safe; secure; in good health; content; satisfied (as in 安於|安于[ān yú]); to place (sb) in a suitable position (job); to install; to fix; to fit; to bring (a charge against sb); to harbor (certain intentions); ampere (abbr. for 安培[ān péi]); surname An
部位	part; section; part (esp. of the body, but also of a vegetable, e.g. the root, or a garment, e.g. the sleeve, etc)
止	stop; only; just; till; to; to stop; to prohibit; until; only
抓住	catch; catch hold of; grip; capture; to grab hold of; to capture
东边	east; east side; eastern part; to the east of
心脏病	heart disease
以往	Past; in the past; formerly
双手	both hands; pair of hands; both hands
暴力	violence; force; violent
见	see; meet; to see; to meet; to appear (to be sth); to interview; opinion; view||to appear; also written 现[xiàn]
协议书	agreement; protocol; written agreement; contract; protocol
看病	see a doctor; to visit a doctor; to see a patient
显著	outstanding; notable; remarkable; statistically significant
看作	see; regard as; look upon; to look upon as; to regard as
靠谱	reliable; reasonable; probable
侧	side; incline; lean; the side; to incline towards; to lean; inclined; lateral; side||lean on one side
录	record; write down; copy; to carve wood; diary; record; to hit; to copy; surname Lu
里面	inside; interior; inside; interior
增长	increase; grow; to grow; to increase
存款	deposit; bank savings; to deposit money (in a bank etc); bank savings; bank deposit
基地	base; base (of operations); industrial or military base; al-Qaeda
文艺	literature; literature and art
笑容	smiling expression; smile; smile; smiling expression; CL:副[fù]
网	net; network; net; network
有害	harmful; pernicious; detrimental; destructive; harmful; damaging
情感	feeling; emotion; feeling; emotion; to move (emotionally)
相互	mutual; reciprocal; each other; each other; mutual
母子	mother and son; mother and child; mother and child; parent and subsidiary (companies); principal and interest
篮球	basketball; basketball/CL:个[gè],只[zhī]
亲	dear; close; intimate; relative; parent; one's own (flesh and blood); relative; related; marriage; bride; close; intimate; in person; first-hand; in favor of; pro-; to kiss; (Internet slang) dear||parents-in-law of one's offspring
网球馆	tennis hall; 
季度	quarter (of a year); quarter of a year; season (sports)
灭	destroy; extinguish; exterminate; drown; put out; to extinguish or put out; to go out (of a fire etc); to exterminate or wipe out; to drown
利	sharp; favourable; advantage; benefit; profit; interest; sharp; favorable; advantage; benefit; profit; interest; to do good to; to benefit; surname Li
外界	outside; the outside world; external
想到	think of; call to mind; have at heart; to think of; to call to mind; to anticipate
变成	become; change into; to change into; to turn into; to become
聊天儿	chat; to chat; to gossip
终止	termination; to stop; to terminate
课本	textbook; textbook/CL:本[běn]
西边	west; west side; west; west side; western part; to the west of
原	primary; original; former; raw; pardon; level; (Japanese surname) Hara; former; original; primary; raw; level; cause; source; surname Yuan
只得	have to; have no alternative but to; be obliged; to have no alternative but to; to be obliged to
最终	final; ultimate; final; ultimate
来往	contact; dealing; intercourse; come and go; to come and go; to have dealings with; to be in relation with
带来	bring; to bring/(fig.) to bring about; to produce
开机	starting up; to start an engine; to boot up (a computer); to press Ctrl-Alt-Delete; to begin shooting a film or TV show
应	answer; respond; agree; should; ought to; should; ought to; answer; respond; promise; should; ought to; must; (legal) shall||to answer; to respond; to comply with; to deal or cope with; surname Ying
解	separate; divide; untie; allay; explain; understand; to break up; to split; to separate; to dissolve; to solve; to melt; to remove; to untie; to loosen; to open; to emancipate; to explain; to understand; to know; a solution; a dissection||to transport under guard||acrobatic display (esp. on horseback) (old); variant of 懈[xiè] and 邂[xiè] (old); surname Xie||to divide
人家	household; dwelling; family; sb else's house; household business; house of woman's husband-to-be; sb else; he, she or they; I, me (referring to oneself as "one" or "people"); CL:户[hù],家[jiā]||other people
通报	circulate a notice; circular; bulletin; journal; to inform; to notify; to announce; circular; bulletin; (scientific) journal
办	do; to do; to manage; to handle; to go about; to run; to set up; to deal with
实施	Implementation; to implement; to carry out
乘	ride; to mount; to make use of; to avail oneself of; to take advantage of; to multiply (math.); (archaic) four; generic term for history books; surname Cheng||to ride; Buddhist sect or creed||(archaic) four horse military chariot
西餐	western food; Western-style food/CL:份[fèn],顿[dùn]
全年	annual; yearly; the whole year; all year long
发行	issue; to publish; to issue; to release; to distribute
遭受	Suffer; to suffer; to sustain (loss, misfortune)
等级	grade; rank; grade; rank; status
中外	at home and abroad; Chinese and foreign; home and abroad; Sino-foreign; Chinese-foreign
餐馆	restaurant; restaurant/CL:家[jiā]
会长	president; chairman; president of an organization; president of a club, committee etc
看到	see; to see
消毒	Disinfection; to disinfect; to sterilize
收回	withdraw; regain; call in; countermand; to regain; to retake; to take back; to withdraw; to revoke
关机	shutdown; to turn off (a machine or device)/to finish shooting a film
试图	Try; to attempt; to try
赏	award; appreciate; reward; to bestow (a reward); to give (to an inferior); to hand down; a reward (bestowed by a superior); to appreciate (beauty)
平台	platform; terrace; platform; terrace; flat-roofed building
仍	still; remain; yet; still; yet; to remain; (literary) frequently; often
缩小	reduce; lessen; narrow; shrink; zoom out; to reduce; to decrease; to shrink
书店	bookstore; bookstore/CL:家[jiā]
支撑	to prop up; to support; strut; brace
心里	in the heart; at heart; chest; heart; mind
跑	run; (of an animal) to paw (the ground)||to run; to run away; to escape; to run around (on errands etc); (of a gas or liquid) to leak or evaporate; (verb complement) away; off
侵犯	Violation; to infringe on; to encroach on; to violate; to assault
进攻	to attack; to assault; to go on the offensive; attack; assault; offense (sports)
认	recognize; know; make out; identify; adopt; admit; to recognize; to know; to admit
捐赠	contribute; donate; present; to contribute (as a gift); to donate; benefaction
中餐	Chinese food; lunch/Chinese meal; Chinese food/CL:份[fèn],顿[dùn]
意味着	Signify; to signify; to mean; to imply
中等	medium; moderate; medium
脚印	footprint; footmark; track; footprint
安乐死	euthanasia
为主	mainly; give priority; to rely mainly on; to attach most importance to
觉	sleep; a nap; a sleep; to find that; thinking; awake; aware; CL:场[cháng]||to feel
收听	listen to; listen in; to listen to (a radio broadcast)
吉利	lucky; auspicious; propitious; auspicious; lucky; propitious; Geely, Chinese car make
健全	robust; sound
救灾	disaster relief; to relieve disaster; to help disaster victims
靠近	near; close to; by; to be close to; to approach; to draw near
暗示	suggest secretly; to hint; to suggest; hint; suggestion
名义	name; titular; name; titular; nominal; in name; ostensible purpose
债	debt; loan; owing; debt/CL:笔[bǐ]
电话	phone; telephone/CL:部[bù]/phone call/CL:通[tōng]/phone number
织	knit; weave; to weave
涉及	Involve; to involve; to relate to; to concern; to touch upon
接到	receive; to receive (letter etc)
眼里	within one’s vision; in one’s eyes; 
辞典	dictionary; dictionary (variant of 詞典|词典[cí diǎn])/CL:本[běn],部[bù]
报警	call the police; to sound an alarm; to report sth to the police
眼看	see; soon; in a moment; watch helplessly; soon; in a moment; to look on as sth happens
宝	treasure; precious; treasured; jewel; gem; treasure; precious
扩展	expand; extend; spread; develop; to extend; to expand; extension; expansion
装置	device; equipment; to install; installation; equipment; system; unit; device
本子	book; notebook; edition; Japanese-style self-published comic (esp. an erotic one), aka "dōjinshi"; CL:本[běn]
辈	generation; lifetime; lifetime; generation; group of people; class; classifier for generations; (literary) classifier for people
读音	pronunciation; literary (rather than colloquial) pronunciation of a Chinese character
识字	learn to read; literacy; to learn to read
道教	Taoism; Taoism/Daoism (Chinese system of beliefs)
入	enter; join; income; to enter; to go into; to join; to become a member of; to confirm or agree with; abbr. for 入聲|入声[rù shēng]
汇款	remittance; remit money; to remit money; remittance
逃走	escape; flee; to escape; to flee; to run away
大奖赛	grand prix
舌头	Tongue; tongue/CL:个[gè]/enemy soldier captured for the purpose of extracting information
兵	arms; soldier; force; weapon; military; soldiers; a force; an army; weapons; arms; military; warlike; CL:个[gè]
外头	outside; out
游玩	amuse; play; stroll; playing; to amuse oneself; to have fun; to go sightseeing; to take a stroll
焦点	focus; focal point; focus (lit. and fig.)
前方	ahead; the front; ahead; the front
遇见	meet; come across; to meet
补习	take lessons after school or work; to take extra lessons in a cram school or with a private tutor
大门	door; gate; the Doors, US rock band; entrance; door; gate; large and influential family
惨	miserable; wretched; tragic; cruel; badly; miserable; wretched; cruel; inhuman; disastrous; tragic; dim; gloomy
散	fall apart; scattered; break up; disperse; distribute; disseminate; give out; scattered; loose; to come loose; to fall apart; leisurely; powdered medicine||to scatter; to break up (a meeting etc); to disperse; to disseminate; to dispel; (coll.) to sack
关联	relevance; relevancy; be related; be connected; be linked; to be related; to be connected; relationship; connection
制成	make into; be made from; to manufacture; to turn out (a product)
出门	go out; to go out; to leave home; to go on a journey; away from home; (of a woman) to get married
货	goods; commodity; money; goods; money; commodity; CL:个[gè]
来源	source; source (of information etc)/origin
应急	meet an urgent need; meet an emergency; meet a contingency; to respond to an emergency; to meet a contingency; (attributive) emergency
悬	hang; suspend; feel anxious; outstanding; dangerous; to hang or suspend; to worry; public announcement; unresolved; baseless; without foundation
幅度	range; extent; width; extent; range; scope
举动	act; action; activity; move; movement
父女	father and daughter
罪	sin; crime; guilt; fault; blame; guilt; crime; fault; blame; sin
所长	superintendent; what one is good at||head of an institute etc
做饭	cook; to prepare a meal; to cook
依法	according to the law; legal; legal (proceedings)/according to law
不成	won’t do; fail; won't do; unable to; (at the end of a rhetorical question) can that be?
排行榜	leaderboard; ranking list; the charts (of best-sellers)/table of ranking
亏	deficit; deficiency; luckily; deficiency; deficit; luckily; it's lucky that...; (often ironically) fancy that...
拿走	take away; to take away
期望	Expect; to have expectations; to earnestly hope; expectation; hope
当选	be elected; come in; to be elected; to be selected
商标	trademark; logo
海外	overseas; abroad; overseas; abroad
造	make; build; create; produce; to make; to build; to manufacture; to invent; to fabricate; to go to; party (in a lawsuit or legal agreement); crop; classifier for crops
院子	courtyard; yard; courtyard; garden; yard; patio; (old) servant; CL:个[gè]
一行	delegation; a group travelling together; party; party; delegation
严厉	severe; strict
太空	Space; outer space
前	front; forward; ahead; first; top (followed by a number); future; ago; before; former; formerly; BC (e.g. 前293年)
清理	Clear; to clear up; to tidy up; to dispose of
作战	fight; war; do battle; combat; combat; to fight
中奖	win a lottery; to win a prize (in a lottery etc)
熟	ripe; cooked; familiar; skilled; cooked; ripe; mature; thoroughly cooked; done; familiar; acquainted; experienced; skilled; (of sleep etc) deep; profound
银行卡	bank card; bank card/ATM card
途径	way; means; channel
到期	mature; expire; become due; maturity; to fall due (loan etc)/to expire (visa etc)/to mature (investment bond etc)
查询	inquire; demand; to check; to inquire; to consult (a document etc); inquiry; query
盒	box; case; small box; case
大脑	cerebrum; brain; brain; cerebrum
一下子	all of a sudden; all at once; for a while; in a short while; all at once; all of a sudden
交警	traffic police; traffic police (abbr. for 交通警察[jiāo tōng jǐng chá])
印	seal; stamp; mark; print; impress; abbr. for 印度[yìn dù]; to print; to mark; to engrave; a seal; a print; a stamp; a mark; a trace; image; surname Yin
肯	agree; consent; be willing to; be ready to; to agree; to consent; to be willing to
线	thread; string; wire; line; route; thread; string; wire; line; (after a number) tier (unofficial ranking of a Chinese city); CL:条[tiáo],股[gǔ],根[gēn]
长假	long holiday; long leave; long vacation
沙子	sand; grit; sand; grit; CL:粒[lì],把[bǎ]
作	rise; compose; pretend; affect; feel; become; writing; work; (bound form) worker; (bound form) workshop; (slang) troublesome; high-maintenance (person)||to do; to engage in; to write; to compose; to pretend; to feign; to regard as; to consider to be; to be; to act the part of; to feel (itchy, nauseous etc); writings; works
得到	get; to get; to obtain; to receive
起点	starting point; outset; starting point
就是	precisely; exactly; just like; exactly; precisely; only; simply; just; (used correlatively with 也[yě]) even; even if
大道	main road; avenue; main street; avenue
生	to be born; to give birth; life; to grow; raw; uncooked; student
舞	dance; dancing; flourish; wield; to dance; to wield; to brandish
杆	pole; staff; pole; pole; lever; classifier for long objects such as guns; CL:条[tiáo],根[gēn]||stick
胆小	timid; cowardly; cowardice; timid
半决赛	semifinal; semifinals
打发	send; dispatch; dismiss; to dispatch sb to do sth; to make sb leave; to pass (the time); (old) to make arrangements; (old) to bestow (alms etc)
曾	once; already; at some time in the past; already; ever (in the past); former; previously; (past tense marker used before verb or clause)||great- (grandfather, grandchild etc); surname Zeng||once
好似	seem; be like; to seem; to be like
对外	foreign; external; external; foreign; pertaining to external or foreign (affairs)
停留	remain; stay; to stay somewhere temporarily; to stop over
重建	rebuild; reconstruct; reestablish; rehabilitate; reconstruction; to rebuild; to reestablish; reconstruction; rebuilding
上课	attend class; have a class; to go to class; to attend class; to go to teach a class
戒毒	detoxification; to kick a drug habit; to abstain from drugs
好久	for a long time; long; quite a while
饼	cake; cookie; pastry; round flat cake; round flat cake; cookie; cake; pastry; CL:张[zhāng]
兴旺	prosperous; thriving; to prosper; to flourish
发布	Release; to release; to issue; to announce; to distribute; also written 發布|发布[fā bù]; to release; to issue; to announce; to distribute
间	between; measure word for rooms; between; among; within a definite time or space; room; section of a room or lateral space between two pairs of pillars; classifier for rooms||gap; to separate; to thin out (seedlings); to sow discontent
新娘	bride
福利	welfare; material benefit; benefit in kind; (social) welfare
伙	partner; partnership; meals (abbr. for 伙食[huǒ shí]); variant of 伙[huǒ]; companion; partner; group; classifier for groups of people; to combine; together
住房	housing; lodging; housing
市长	mayor
必将	will certainly; surely will; inevitably
情形	circumstances; situation; CL:个[gè]
贪钱 	greedy; 
暖	warm; genial; warm up; warm; to warm
埋	cover; bury; to bury||used in 埋怨[mán yuàn]
发动	Launch; to start; to launch; to unleash; to mobilize; to arouse
男士	man; gentleman
口袋	pocket; bag; sack
用不着	no need; have no use for; not need; have no use for
认出	recognize; identify; make out; recognition; to recognize
公众	public
卧铺	sleeper; sleeping berth; a bed (on a train)/a couchette
干预	intervene; to meddle; to intervene; intervention
有用	useful
酒鬼	drunkard
等候	Wait; to wait; to wait for
今后	from now on; in the future; hereafter; henceforth; in the future; from now on
背着	behind one’s back; carrying on one's back||turning one's back to (sth or sb); keeping sth secret from (sb); keeping (one's hands) behind one's back
早期	early phase; early stage; early period; early phase; early stage
仅仅	only; merely; barely; barely; only; merely; only (this and nothing more)
水泥	cement; cement/CL:袋[dài]
拾	pick up, collect; to ascend in light steps||to pick up; to collate or arrange; ten (banker's anti-fraud numeral)
活力	energy; vigor; energy; vitality; vigor; vital force
支援	support; to provide assistance; to support; to back
不幸	misfortune; unfortunat; unfortunately; misfortune; adversity; unfortunate; sad; unfortunately; CL:个[gè]
各位	everybody; all (guests, colleagues etc); all of you
放下	put down; lay down; drop; to lay down; to put down; to let go of; to relinquish; to set aside; to lower (the blinds etc)
成品	end product; finish product; finished goods; a finished product
交给	hand over; to give; to deliver; to hand over
车票	ticket; ticket (for a bus or train)
看得见	visible; noticeable; can see; visible
背后	behind; at the back; in the rear; behind; at the back; in the rear; behind sb's back
想不到	unexpected; hard to imagine; it had not occurred to me; who could have thought that
集团	group; bloc; corporation; conglomerate
夺	seize; snatch; rob; contend for; deprive; decide; to seize; to take away forcibly; to wrest control of; to compete or strive for; to force one's way through; to leave out; to lose
牙刷	toothbrush; toothbrush/CL:把[bǎ]
游行	parade; march; demonstration; procession; to march; to parade; to demonstrate; procession; march; demonstration; to travel around; to roam
回来	come back; return; to return; to come back
梅花	plum blossom; plum flower; plum blossom; clubs ♣ (a suit in card games); wintersweet (dialect)
英文	English; English (language)
盒饭	box lunch; meal in a partitioned box
请教	Consult; to ask for guidance; to consult
当初	Original; at that time; originally
热量	calories; heat; quantity of heat; heat; quantity of heat; calorific value
多方面	multifaceted; in many aspects; many-sided; many-sided; in many aspects
消灭	eliminate; to put an end to; to annihilate; to cause to perish; to perish; annihilation (in quantum field theory)
拼	spell; go all out; join together; spelling; to piece together; to join together; to stake all; adventurous; at the risk of one's life; to spell
尖	pointed; shrill; sharp; acute; point; tip; top; pointed; tapering; sharp; (of a sound) shrill; piercing; (of one's hearing, sight etc) sharp; acute; keen; to make (one's voice) shrill; sharp point; tip; the best of sth; the cream of the crop
打	strike; hit; break; fight; build; beat; dozen (loanword)||to beat; to strike; to hit; to break; to type; to mix up; to build; to fight; to fetch; to make; to tie up; to issue; to shoot; to calculate; to play (a game); since; from
解说	explain orally; comment; definition; narrate; to explain (verbally); to give a running commentary
食欲	appetite
下面	below; under; next; below; under; next; the following; to boil noodles
监督	supervise; to control; to supervise; to inspect
练	practice; train; to practice; to train; to drill; to perfect (one's skill); exercise; (literary) white silk; to boil and scour raw silk
后头	back; behind; the back; the rear; later; afterwards; (in) the future
参展	take part in an exhibition; participate in an exhibition; to exhibit at or take part in a trade show etc
瓶	bottle; vase; pitcher; classifier for wine and liquids; CL:个[gè]
随意	random; casual; as one wishes; according to one's wishes; at will; voluntary; conscious
公正	just; fair; equitable
山区	mountain area; mountain area/CL:个[gè]
摆脱	cast off; to break away from; to cast off (old ideas etc); to get rid of; to break away (from); to break out (of); to free oneself from; to extricate oneself
为此	to this end; for this reason; for this purpose; for this reason; with regards to this; in this respect; in order to do this; to this end
考生	examinee; exam candidate; student whose name has been put forward for an exam
乐	happy; laugh; cheerful; cheerful; to laugh||music; surname Le||surname Yue||happy
下来	come down; get down; to come down/(completed action marker)/(after verb of motion, indicates motion down and towards us, also fig.)/(indicates continuation from the past towards us)/to be harvested (of crops)/to be over (of a period of time)/to go among the masses (said of leaders)
阔	wide; broad; rich; vast; wealthy; rich; wide; broad
看上去	seem; it would appear; it seems (that)
中	middle; in; among; in; middle; center; while (doing sth); during; (dialect) OK; all right||to hit (the mark); to be hit by; to suffer; to win (a prize, a lottery); surname Zhong||within; China; Chinese
雨	rain; (of rain, snow etc) to fall; to precipitate; to wet; CL:阵[zhèn],场[cháng]||(literary) to rain
今年	this year
不能不	have to; cannot but; have to; cannot but
账	account; debt; account; bill; debt; CL:本[běn],笔[bǐ]
愿	will; wish; desire; hope; willing; honest and prudent; variant of 愿[yuàn]; (bound form) wish; hope; desire; to be willing; to wish (that sth may happen); may ...; vow; pledge
挨打	take a beating; get a thrashing; come under attack; to take a beating; to get thrashed; to come under attack
午饭	lunch; lunch/CL:份[fèn],顿[dùn],次[cì],餐[cān]
一点点	a little bit
便利	facilitate; convenient; easy; to facilitate
睡	sleep; to sleep; to lie down
到来	arrival; advent; to arrive; arrival; advent
年前	before the New Year; years ago; by the end of the year; at the end of the year; shortly before New Year
冬季	winter
剩下	be left over; remain; to remain; to be left over
骑车	cycle; to ride a bike (motorbike or bicycle)
马路	road; street; street; road; CL:条[tiáo]
主持人	host; presenter; host; anchor; TV or radio presenter
定然	certainly; of course
分行	Branch; branch of bank or store; subsidiary bank
端	end; extremity; item; port; to hold sth level with both hands; to carry; regular
听讲	attend a lecture; listen to a talk; to attend a lecture; to listen to a talk
不值	not worth
沉重	heavy; hard; serious; critical
团长	regimental commander; head of a delegation; regimental command; head of a delegation; group buy organizer; group-buying coordinator
大伙儿	you all; everybody; everybody; everyone; we all
加	add; increase; put in; to add; plus; (used after an adverb such as 不, 大, 稍 etc, and before a disyllabic verb, to indicate that the action of the verb is applied to sth or sb previously mentioned); to apply (restrictions etc) to (sb); to give (support, consideration etc) to (sth); surname Jia; Canada (abbr. for 加拿大[jiā ná dà])
迷	fan; confused; be crazy about; to bewilder; crazy about; fan; enthusiast; lost; confused
专用	special; dedicated; special; dedicated
值班	Be on duty; to work a shift; on duty
松	pine; loose; slack; loosen; relax; slacken; pine; loose; to loosen; to relax; floss (dry, fluffy food product made from shredded, seasoned meat or fish, used as a topping or filling); surname Song; CL:棵[kē]
就要	be going to; be about to; will; shall; to be going to
过来	come; come over; to come over; to manage; to handle; to be able to take care of||see 過來|过来[guò lái]
景点	attractions; scenic spot; tourist attraction; scenic spot
防守	Defense; to defend; to protect (against)
同行	peer; of the same trade or occupation; person of the same occupation; person of the same profession; of the same trade, occupation or industry||to journey together
皮包	purse; briefcase; portfolio; handbag; briefcase
都市	metropolis; city; city; metropolis
打雷	thunder; to rumble with thunder; clap of thunder
花费	spend; expend; cost; spending; expense; cost; to spend (time or money); expenditure
倡导	Advocate; to advocate; to initiate; to propose; to be a proponent of (an idea or school of thought)
机构	mechanism; structure; organization; agency; institution; CL:所[suǒ]
顾	look at; look after; attend; turn around and look at; to look after; to take into consideration; to attend to; surname Gu
聘请	hire; engage; invite; to engage; to hire (a lawyer etc)
今日	today
灰色	gray; pessimistic; gray; ash gray; grizzly; pessimistic; gloomy; dispirited; ambiguous
现有	existing; now available; existence; currently existing; currently available
上线	to launch online; to go online; to put sth online
邮票	postage stamp; stamp; (postage) stamp/CL:枚[méi],张[zhāng]
海浪	sea wave
必修	obligatory; compulsory; required; (of an academic course) required; compulsory
权	power; authority; right; tentatively; authority; power; right; (literary) to weigh; expedient; temporary; surname Quan
宫	palace; temple; uterus; place for recreation; palace; temple; castration (as corporal punishment); first note in pentatonic scale; surname Gong
进来	come in; to come in
加工	machining; to process; processing; working (of machinery)
袖珍	pocket-size; pocket; pocket-sized; pocket (book etc)
承办	Undertake; to undertake; to accept a contract
办学	run a school; to run a school
栏目	column; regular column or segment (in a publication or broadcast program)/program (TV or radio)
以内	within; less than
民警	people’s police; people’s policeman; civil police; abbr. for 人民警察; PRC police
括号	brackets; parentheses; parentheses; brackets
调动	transfer; to transfer; to maneuver (troops etc); movement of personnel; to mobilize; to bring into play
不少	not a few; a lot; many; a lot; not few
犯	commit; offend; violate; work against; criminal; to violate; to offend; to assault; criminal; crime; to make a mistake; recurrence (of mistake or sth bad)
为期	by a definite date; (to be done) by (a certain date)/lasting (a certain time)
停车场	parking lot; car park
排名	rank; to rank (1st, 2nd etc)/ranking
处罚	punish; penalize; punishment; to penalize; to punish
打击	strike; to hit; to strike; to attack; to crack down on sth; blow; (psychological) shock; percussion (music)
将	be going to; will; would; will; shall; to use; to take; to checkmate; just a short while ago; (introduces object of main verb, used in the same way as 把[bǎ])||(bound form) a general; (literary) to command; to lead; (Chinese chess) general (on the black side, equivalent to a king in Western chess)||to desire; to invite; to request
相声	comic dialogue; sketch; crosstalk
如此	so; such; in this way; like that; like this; so; such
日语	Japanese language
外衣	coat; jacket; outer clothing; garb; overclothes; semblance; outer clothing; semblance; appearance
网页	web page
…极了	extremely; exceedingly; 
远方	distance; far away; a distant location
队	squadron; team; group; CL:个[gè]
运	transport; luck; fortune; carry; move; wield; to move; to transport; to use; to apply; fortune; luck; fate
模式	mode; style; mode; method; pattern
前来	come; to come (formal); before; previously
全家	whole family; FamilyMart (convenience store chain)
先锋	pioneer; vanguard; vanguard; pioneer; avant-garde
剑	sword; double-edged sword; classifier for blows of a sword; CL:口[kǒu],把[bǎ]
起诉	prosecute; sue; bring a lawsuit; to sue; to bring a lawsuit against; to prosecute
单打	singles; singles (in sports)/CL:场[chǎng]
毕业生	graduate
原有	original; former
少年	juvenile; young person; early youth; youngster; (literary) youth; young man
乘客	passenger
比方	Example; analogy; instance; for instance
岛	island; CL:个[gè],座[zuò]
体检	physical examination; abbr. for 體格檢查|体格检查[tǐ gé jiǎn chá]
顺	along; with; obey; yield to; listen to; incidentally; in passin; to obey; to follow; to arrange; to make reasonable; along; favorable
宝宝	baby; darling; darling; baby
指责	Accuse; to criticize; to find fault with; to denounce
开学	school opens; term begins; (of a student) to start school; (of a semester) to begin; (old) to found a school; the start of a new term
毒	poison; toxin; narcotics; poisonous; poison; to poison; poisonous; malicious; cruel; fierce; narcotics
安置	put; arrange for; to find a place for; to help settle down; to arrange for; to get into bed; placement
血管	blood vessel; artery; vein; vein; artery; CL:根[gēn]
过年	celebrate the New Year; to celebrate the Chinese New Year
半天	half day; half of the day; a long time; quite a while; midair; CL:个[gè]
排水	drain; to drain
烤肉	barbecue; roast meat; grill; barbecue (lit. roast meat)
餐饮	catering; repast; food and beverage; catering; repast
胶带	tape; adhesive plaster; adhesive tape; magnetic tape
之内	in; within; inside; within
对立	Opposition; to oppose; to set sth against; to be antagonistic to; antithetical; relative opposite; opposing; diametrical
一齐	all together; simultaneously; in unison; at the same time; simultaneously
签名	signature; sign one’s name; autograph; to sign (one's name with a pen etc); to autograph; signature
被迫	be compelled; be forced; be constrained; to be compelled; to be forced
增多	increase; grow in number; to increase; to grow in number
多年	many years; for many years; longstanding
小组	group
量	measure; estimate; amount; to measure||capacity; quantity; amount; to estimate; abbr. for 量詞|量词[liàng cí], classifier (in Chinese grammar); measure word
发病	onset; morbidity; pathogenesis; outbreak; fall ill; (of an illness) to occur; (of a person) to get sick; to fall ill; onset (of a medical condition)
不通	be blocked up; be impassable; not make sense; be illogical; to be obstructed; to be blocked up; to be impassable; to make no sense; to be illogical
工夫	time; (old) laborer||period of time (may be months, or mere seconds); spare time; skill; labor; effort
罢工	Strike; a strike; to go on strike
晕车	carsickness; motion sickness; to be carsick
一半	half
客气	polite; courteous; modest; polite; courteous; formal; modest
小型	small-size; small-scale; small scale; small size
侄子	brother's son; nephew
王	king; monarch; head; chief; best or strongest of its type; grand; great||to rule; to reign over; surname Wang||king or monarch
热水器	water heater; hot-water heater; water heater
月份	month
有效	effective; valid; effective; in effect; valid
著作	Work; to write; literary work; book; article; writings; CL:部[bù]
深处	deep; depths; recess; profundity; abyss; depths; deepest or most distant part
雨水	rainwater; rainfall; rain; rainwater; rainfall; rain; Yushui or Rain Water, 2nd of the 24 solar terms 二十四節氣|二十四节气 19th February-5th March
进入	enter; go in; join; to enter; to join; to go into
树林	wood; grove; forest; woods; grove; forest; Shulin city in New Taipei City 新北市[xīn běi shì], Taiwan
增大	enlargement; magnify; increase; to enlarge; to amplify; to magnify
结	bear; form; knit; knot; (of a plant) to produce (fruit or seeds); sturdy; bond; to tie; to bind; to check out (of a hotel)
无关	have nothing to do; unrelated; irrelevant; unrelated; having nothing to do (with sth else)
搞好	do well; make a good job of; to do well at; to do a good job
人数	number of people
影迷	movie fan; film fan; film enthusiast; movie fan; CL:个[gè]
铁路	railway; railroad; railroad; railway; CL:条[tiáo]
差异	difference; divergence; discrepancy; diversity; difference; discrepancy
发电	generate electricity; power generation; to generate electricity; to send a telegram
调料	condiment; seasoning; flavoring
保安	security guard; public security; ensure safety; to ensure public security; to ensure safety (for workers engaged in production); public security; security guard
安检	security check; security check (abbr. for 安全檢查|安全检查[ān quán jiǎn chá])/to do a security check
智能	Intelligence; intelligent; able; smart (phone, system, bomb etc)
扑	Flutter; to throw oneself at; to pounce on; to devote one's energies; to flap; to flutter; to dab; to pat; to bend over
强迫	Force; to compel; to force
波动	undulate; fluctuate; surge; undulation; fluctuation; wave motion; to undulate; to fluctuate; wave motion; rise and fall
巴士	bus; bus (loanword)/motor coach
残疾	A disability; disabled; handicapped; deformity on a person or animal
文娱	cultural recreation; entertainment; cultural recreation; entertainment
如	as; if; according to; as; as if; such as
柜子	cupboard; cabinet; chest; cupboard; cabinet
采用	put to use; adopt; use; employ; to adopt; to employ; to use
发射	launch; to shoot (a projectile); to fire (a rocket); to launch; to emit (a particle); to discharge; emanation; emission
特性	characteristic; property; feature; peculiarity; quality; property; characteristic
一番	some; one time; 
楼房	building; storied building; a building of two or more stories/CL:栋[dòng],幢[zhuàng],座[zuò]
由此	from this; therefrom; thus; hereby; from this
环	ring; loop; link; annulus; ring; hoop; loop; (chain) link; classifier for scores in archery etc; to surround; to encircle; to hem in; surname Huan
层次	gradation; arrangement; layer; level; gradation; arrangement of ideas; (a person's) standing
医药	medicine; curative; medical care and medicines; medicine (drug); medical; pharmaceutical
糟	dregs; waste; spoil; bad; in a mess; dregs; draff; pickled in wine; rotten; messy; ruined
书包	school bag; schoolbag; satchel; bookbag; CL:个[gè],只[zhī]
险	danger; risk; danger; dangerous; sinister; nearly; danger; dangerous; rugged
有力	strong; powerful; forceful; energetic; vigorous; powerful; forceful; vigorous
规划	Plan; to draw up a plan; to map out a program; a plan; a program
电饭锅	rice cooker; electric rice cooker
学员	student; trainee; student; member of an institution of learning; officer cadet
看待	To view; to look upon; to regard
收藏	Collection; favorite (a video); to collect (works of art, dolls, antiques etc); to put away for safekeeping; (Internet) to bookmark; a collection
归主	Return to the Lord (die?); 
乱象 	Chaotic; 
西医	a doctor trained in Western medicine; Western medicine
金钱	money; currency
只	single; lonely; only; just; simply; merely; only; merely; just; but||grain that has begun to ripen||classifier for birds and certain animals, one of a pair, some utensils, vessels etc
治病	treat a disease; treat an illness; to treat an illness
一块儿	one block; one piece; one (unit of money); together; in the same place; in company
部	unit; ministry; department;  part; section; ministry; department; section; part; division; troops; board; classifier for works of literature, films, machines etc
毫升	milliliter
落	be missing; leave behind; forget to bring; fall; drop; go down; set; decline; drop behind; to leave out; to be missing; to leave behind or forget to bring; to lag or fall behind||colloquial reading for 落[luò] in certain compounds||to fall or drop; (of the sun) to set; (of a tide) to go out; to lower; to decline or sink; to lag or fall behind; to fall onto; to rest with; to get or receive; to write down; whereabouts; settlement
租金	rent; rental; rent
圆满	Satisfactorily; satisfactory; consummate; perfect
投诉	complaint; to complain; to register a complaint (esp. as a customer)
表	watch; exterior surface; family relationship via females; to show (one's opinion); a model; a table (listing information); a form; a meter (measuring sth); watch (timepiece); meter; gauge
场合	situation; occasion; context; setting; location; venue
美金	USD; dollar; US dollar/USD
四处	around; all over the place; in all directions; all over the place; everywhere and all directions
红酒	red wine
将近	almost; nearly; close to
薄弱	weak; frail
职位	position; post; job
快车	express train; express bus; express (train, bus etc)
皮	skin; leather; fur; cover; sheet; leather; skin; fur; pico- (one trillionth); naughty; surname Pi; CL:张[zhāng]
田	field; farm; field; farm; surname Tian; CL:片[piàn]
少数	small number; few; minority; small number; few; minority
调研	research; investigation; to investigate and research; research; investigation
实际上	actually; in fact; in reality; as a matter of fact; in practice
抽样	sampling (e.g. sampling bias); sample; sampling
请坐	please have a seat; please, have a seat
普及	to spread extensively; to generalize; widespread; popular; universal; ubiquitous; pervasive
出名	famous; well-known; well-known for sth; to become well known; to make one's mark; to lend one's name (to an event, endeavor etc)
外地	other places; nonlocal; parts of the country other than where one is
剧场	theater; theater/CL:个[gè]
各地	various regions; everywhere; in all parts of (a country)/various regions
联赛	league; (sports) league; league tournament
当天	that day; on that day||the same day
向上	upward; up; upward; up; to advance; to try to improve oneself; to make progress
百分点	percentage point
此致	regards; sincerely; with the best wishes; (used at the end of a letter to introduce a polite salutation)
市民	citizen; city resident; city resident
绿色	green
时事	current affairs; current trends; the present situation; how things are going
体育馆	stadium; gymnasium; gym; gym; gymnasium; stadium; CL:个[gè]
这里	here
职能	function; role
计算机	computer; computer/(Tw) calculator/CL:台[tái]
往后	from now on; later; in the future; backward; from now on; in the future; time to come
转动	turn; run; twirl; roll; revolve; turn; move; turn round; to turn sth around; to swivel||to rotate (about an axis); to revolve; to turn; to move in a circle; to gyrate
力	power; force; power; force; strength; ability; strenuously; surname Li
自学	self-study; to study on one's own
生火 	Make a fire; 
出访	visit a foreign country; to go and visit in an official capacity or for investigation
球队	team; sports team (basketball, soccer, football etc)
汉字	Chinese character; Chinese character/CL:个[gè]/Japanese: kanji/Korean: hanja/Vietnamese: hán tự
特快	express; express (train, delivery etc)
卷	volume; file; roll, curly, reel; to roll up; roll; classifier for small rolled things (wad of paper money, movie reel etc)||scroll; book; volume; chapter; examination paper; classifier for books, paintings: volume, scroll||to roll up; to sweep up; to carry along; a roll; classifier for rolls, spools etc
落实	put into effect; practical; workable; to implement; to carry out; to decide
送行	see off; give a send-off party; to see someone off; to throw someone a send-off party
国内	domestic; internal; domestic; internal (to a country); civil
路上	on the road; on the way; en route
收养	adoption; adopt; to take in and care for (an elderly person, a dog etc)/to adopt (a child)/adoption
地板	floor
刚好	just; exactly; happen to; just; exactly; to happen to be
只能	can only; obliged to do sth; to have no other choice
于	(preposition); to go; to take; sentence-final interrogative particle; variant of 于[yú]; (of time or place) in; at; on; (indicating any indirect relation) to; toward; vis-à-vis; with regard to; for; (indicating a source) from; out of; (used in comparison) than; (used in the passive voice) by; surname Yu
迟	late; delayed; slow; late; delayed; slow; surname Chi
老家	hometown; home state; native place; place of origin; home state or region
见到	see; to see
唱	sing; to sing; to call loudly; to chant
慌	panic; flurried; confused; flustered; awfully; to get panicky; to lose one's head/(coll.) (after 得[dé]) unbearably; terribly
被动	passive
美好	fine; happy; glorious; beautiful; fine
物价	(commodity) prices; (commodity) prices/CL:个[gè]
遭到	suffer; suffered; meet with; to suffer; to meet with (sth unfortunate)
列入	included in; to include on a list
此后	after that; hereafter; henceforth; after this; afterwards; hereafter
水灾	flood; inundation; flood; flood damage
冒	give off; risk; bold; boldly; to emit; to give off; to send out (or up, forth); to brave; to face; (bound form) reckless; to falsely adopt (sb's identity etc); to feign; (literary) to cover; surname Mao
烧	burn; cook; bake; roast; run a fever; to burn; to cook; to stew; to bake; to roast; to heat; to boil (tea, water etc); fever; to run a temperature; (coll.) to let things go to one's head
体积	volume; bulk; CL:个[gè]
违规	violation; get out of line; to violate the rules
截至	By (time）; up to (a time)/by (a time)
深入	go deep into; thorough; to penetrate deeply; thorough
直线	straight line; sharply (rise or fall)
正如	just as; exactly as; just as; precisely as
塔	pagoda; tower; minaret; stupa (abbr. loanword from Sanskrit tapo); CL:座[zuò]
先进	advanced; sophisticated; advanced (technology etc)/meritorious; exemplary (deeds etc)
内地	inland; interior; mainland; mainland China (PRC excluding Hong Kong and Macau, but including islands such as Hainan); inland; interior; hinterland; Japan (used in Taiwan during Japanese colonization)
扎	Tie; to prick; to run or stick (a needle etc) into; mug or jug used for serving beer (loanword from "jar")||used in 掙扎|挣扎[zhēng zhá]||to tie; to bind; classifier for flowers, banknotes etc: bundle
尺	rule; ruler; one of the characters used to represent a musical note in gongche notation, 工尺譜|工尺谱[gōng chě pǔ]||a Chinese foot; one-third of a meter; a ruler; a tape-measure; one of the three acupoints for measuring pulse in Chinese medicine; CL:支[zhī],把[bǎ]
演奏	Play; to perform on a musical instrument
认定	cognizance; to maintain (that sth is true); to determine (a fact); determination (of an amount); of the firm opinion; to believe firmly; to set one's mind on; to identify with
头脑	mind; brain; brains; mind; skull; (fig.) gist (of a matter); leader; boss
年底	end of the year; the end of the year; year-end
上级	Superior; higher authorities; superiors; CL:个[gè]
行程	travel; itinerary; journey; travel route; distance of travel; course (of history); stroke (of a piston); (Tw) (computing) process
嘴巴	mouth; mouth (CL:张[zhāng])/slap in the face (CL:个[gè])
杯	cup; trophy cup; classifier for certain containers of liquids: glass, cup
清醒	clear-headed; sober; awake
盲人	blind; blindman; blind person
用户	user; consumer; subscriber; customer
不利	unfavourable; disadvantageous; harmful; detrimental; unfavorable; disadvantageous; harmful; detrimental
晚点	late; behind schedule; (of trains etc) late; delayed; behind schedule; light dinner
交费	pay; to pay a fee
从不	never; never ever; never
难以	difficult; hard; hard to (predict, imagine etc)
评估	evaluate; to evaluate; to assess; assessment; evaluation
保	defend; protect; keep; guarantee; ensure; to defend; to protect; to keep; to guarantee; to ensure; civil administration unit in the baojia 保甲[bǎo jiǎ] system (old); Bulgaria (abbr. for 保加利亞|保加利亚[bǎo jiā lì yà])
外科	surgery; surgical department; surgery (branch of medicine)
再说	besides; put off until some time later; say; to say again; to put off a discussion until later; moreover; what's more; besides
那儿	there
公认	Accepted; publicly known (to be)/accepted (as)
日夜	day and night; round the clock; day and night; around the clock
模范	model; fine example
全世界	worldwide; entire world; worldwide; entire world
不够	not enough; insufficient; inadequate
船长	captain; skipper; captain (of a boat)/skipper
风光	Scenery; scene; view; sight; landscape; to be well-regarded; to be well-off; grand (dialect); impressive (dialect)
修复	repair; to restore; to renovate/(computing) to repair (a corrupted file etc)
法语	French language; French (language)
发言人	spokesman; spokesperson; addressor; prolocutor; spokesperson
风	wind; news; style; custom; manner; CL:阵[zhèn],丝[sī]
从中	from; therefrom; from within; therefrom
此刻	now; at the moment; this moment; now; at present
提交	submit; refer; to submit (a report etc)/to refer (a problem) to sb
时	time; times; hour; season; tense; o'clock; time; when; hour; season; period; surname Shi
银牌	silver medal; silver medal/CL:枚[méi]
老年	elderly; old age; autumn of one's years
出场	come on the stage; enter the arena; (of a performer) to come onto the stage to perform/(of an athlete) to enter the arena to compete/(fig.) to enter the scene (e.g. a new product)/(of an examinee etc) to leave the venue
套餐	set meal; set meal/(fig.) product or service package (e.g. for a cell phone subscription)
照耀	Shine; to shine; to illuminate
队长	team leader; captain; captain; team leader; CL:个[gè]
截止	due; to close; to stop; to put a stop to sth; cut-off point; stopping point; deadline
神奇	magical; mystical; miraculous
便是	that’s it; (emphasizes that sth is precisely or exactly as stated); precisely; exactly; even; if; just like; in the same way as
隔开	separate; space out; separation; partition; to separate
认得	know; recognize; to recognize; to remember sth (or sb) on seeing it; to know
课堂	classroom; classroom/CL:间[jiān]
四周	all around
高大	tall; lofty; tall; lofty; towering
内在	inherent; inner; internal; intrinsic; innate
设想	imagine， conceive; to imagine; to assume; to envisage; tentative plan; to have consideration for
扮演	Play the role; to play the role of; to act
国歌	national anthem
收看	watch; to watch (a TV program)
治安	law and order; public security
沿着	along; to go along; to follow
煤	coal; coal/CL:块[kuài]
协议	agreement; pact; protocol; CL:项[xiàng]
奶粉	milk powder; dried milk; powdered milk
知名	famous; well-known; well-known; famous
绿化	greening; afforest; to make green with plants; to reforest; (Internet slang) Islamization
你们	you; you (plural)
分成	divide into; separate into; to divide (into); to split a bonus; to break into; tenths; percentage allotment
没事儿	It’s okay; to have spare time; free from work; it's not important; it's nothing; never mind
脸盆	washbasin; washbowl; basin for washing hands and face; CL:个[gè]
顽强	tenacious; hard to defeat
充足	adequate; sufficient; abundant
食品	food; foodstuff; foodstuff; food; provisions/CL:种[zhǒng]
处在	at; be in; to be situated at; to find oneself at
毛笔	writing brush; Chinese brush; writing brush/CL:枝[zhī],管[guǎn]
旁	side; other; else; one side; other; different; lateral component of a Chinese character (such as 刂[dāo], 亻[rén] etc)
产业	industry; estate; property; industrial
多样	diverse; diversity; manifold
眼光	Eye; gaze; insight; foresight; vision; way of looking at things
动员	to mobilize; mobilization; CL:次[cì]
处长	the head of a department; section chief; department head; section chief
室	room; work unit; grave; scabbard; family or clan; one of the 28 constellations of Chinese astronomy; surname Shi
侄女	brother's daughter; niece
奶	breast; milk; to breastfeed; mother; variant of 奶[nǎi]
里边	inside
定	decide; fix; book; order; calm; stable; to fix; to set; to make definite; to subscribe to (a newspaper etc); to book (tickets etc); to order (goods etc); to congeal; to coagulate; (literary) definitely
交易	to deal; to trade; to transact; transaction; deal; CL:笔[bǐ]
炸药	explosive; dynamite; explosive (material)
别的	else; other
亚运会	Asian Games
研究生	postgraduate; graduate student; graduate student; postgraduate student; research student
工作日	workday; working day; workday; working day; weekday
音像	audiovisual; audio-video; audio and video; audiovisual
仅	only; merely; barely; barely; only; merely
灾	disaster; calamity; adversity; personal misfortune; disaster; calamity
车站	station; rail station; bus stop; CL:处[chù],个[gè]
花园	garden; garden/CL:座[zuò],个[gè]
花瓶	vase; jardiniere; flower vase/(fig.) female employee considered to be just a pretty face (attractive but not very competent)
usb	USB; 
深度	depth; deepness; depth; (of a speech etc) profundity; advanced stage of development
排除	eliminate; remove; debar; to eliminate; to remove; to exclude; to rule out
美容	beauty; cosmetology; to improve one's appearance (using cosmetics or cosmetic surgery); to make oneself more attractive; to beautify
识	knowledge; know; remember; to know; knowledge; to write a footnote
好学	studious; fond of learning; easy to learn||eager to study; studious; erudite
相应	to correspond; answering (one another); to agree (among the part); corresponding; relevant; appropriate; (modify) accordingly
统计	statistics; to count; to add up
有局限	There are limitations; 
分数	score; mark; fraction; (exam) grade; mark; score; fraction
事	matter; thing; item; work; affair; CL:件[jiàn],桩[zhuāng],回[huí]
直到	until
志愿	volunteer; aspiration; wish; aspiration; ambition; to volunteer
太阳能	solar energy
内心	heart; inner centre; heart; innermost being/(math.) incenter
平稳	smooth; steady; smooth; steady
气温	air temperature; air temperature/CL:个[gè]
绝	cut off; exhausted; desperate; unique; extremely; most; absolutely; to cut short; extinct; to disappear; to vanish; absolutely; by no means
融合	fuse; merge; mix; a mixture; an amalgam; fusion; welding together; to be in harmony with (nature); to harmonize with; to fit in
炮	cannon; gun; firecracker; artillery piece; to sauté; to fry; to dry by heating||to prepare herbal medicine by roasting or parching (in a pan)||cannon; firecracker; CL:座[zuò]
正规	regular; according to standards
处分	prescription; to discipline sb; to punish; disciplinary action; to deal with (a matter); CL:个[gè]
畅通	unimpeded; unblocked; unimpeded; free-flowing; straight path; unclogged; move without obstruction
偏	partial; prejudiced; inclined to one side; lean; to lean; to slant; oblique; prejudiced; to deviate from average; to stray from the intended line; stubbornly; contrary to expectations
诗人	bard; poet
列为	be classified as; listed as; to be classified as
色	colour; look; expression; scene; quality; color; look; appearance; sex||(coll.) color; used in 色子[shǎi zi]; CL:种[zhǒng]
半夜	midnight; in the middle of the night
播	broadcast; spread; seed; sow; move about; to sow; to scatter; to spread; to broadcast
整天	all day long; whole day
泡	bubble; steep; soak; puffed; swollen; spongy; small lake (esp. in place names); classifier for urine or feces||bubble; foam; blister; to soak; to steep; to infuse; to dawdle; to loiter; to pick up (a girl); to get off with (a sexual partner); classifier for occurrences of an action; classifier for number of infusions
值	value; be worth; value; (to be) worth; to happen to; to be on duty
很难说	hard to say; 
佛	Buddha; Buddhism; variant of 佛[fú]; Buddha; Buddhism (abbr. for 佛陀[fó tuó])||seemingly||(female) head ornament
王后	queen; queen/CL:个[gè],位[wèi]
汇	remit; converge; collection; collected things; to remit; to converge (of rivers); to exchange; class; collection
依靠	rely on; depend on; to rely on sth (for support etc); to depend on
迷信	superstition; to have a superstitious belief (in sth)
更新	renovate; renew; to replace the old with new; to renew; to renovate; to upgrade; to update; to regenerate
座谈会	foum; symposium; informal discussion; conference; symposium; rap session
互动	interactive; interaction; to interact; interactive
下课	finish class; to finish class; to get out of class; (fig.) (esp. of a sports coach) to be dismissed; to be fired
救命	help; save life; to save sb's life/(interj.) Help!/Save me!
吃饭	have meal; to have a meal; to eat; to make a living
小声	in a low voice; in whispers; in a low voice/(speak) in whispers
不在乎	not mind; not care; not to care
招呼	call; hail; greet; glad-hand; to call out to; to greet; to say hello to; to inform; to take care of; to take care that one does not
放到	put to; put into; 
夜间	nighttime; at night; nighttime; evening or night (e.g. classes)
紧紧	closely; tightly; closely; tightly
日报	daily, journal; daily newspaper
各个	each; every; various; separately, one by one
街区 	neighborhood; 
开车	drive; drive a car; to drive a car
低于	below; under; to be lower than
类	class; category; kind; type; kind; type; class; category; similar; like; to resemble
舍得	be willing to part with; not begrudge; to be willing to part with sth
清洁工	dustman; cleaner; cleaner; janitor; garbage collector
管	control; be in charge of; manage; run; to take care (of); to control; to manage; to be in charge of; to look after; to run; to care about; tube; pipe; woodwind; classifier for tube-shaped objects; particle similar to 把[bǎ] in 管...叫 constructions; writing brush; (coll.) to; towards; surname Guan
低头	head down; lower one’s head; submit; to bow the head; to yield; to give in
牢	fold; pen; prison; jail; durable; firm; sturdy; fold (for animals); sacrifice; prison
公告	Notice; post; announcement
捐款	donate; donation; donate money; contribute funds; to donate money; to contribute funds; donation; contribution (of money)
为何	why; for what reason; why
这样	so; such; like this; this way; this kind of; so; this way; like this; such
地名	place name; toponym
获奖	win a prize; receive an award; to win an award
保密	secrecy; to keep sth confidential; to maintain secrecy
船只	ship; vessel; craft; ship; boat; vessel
山峰	mountain peak; (mountain) peak
怎样	how; what kind
杰出	outstanding; distinguished; remarkable; prominent; illustrious
歌词	lyric; lyrics; libretto; song lyric; lyrics
患者	patient; sufferer
一身	the whole body; all over the body; whole body; from head to toe; single person; a suit of clothes
做法	practice; behavior; way of doing a thing; way of handling sth; method for making; work method; recipe; practice; CL:个[gè]
打官司	To engage in a lawsuit; to file a lawsuit; to sue; to dispute
野	open space; field; wild; uncultivated; rude; rough; out of office; field; plain; open space; limit; boundary; rude; feral
来历	history; antecedents; origin
学院	college; academy; college; educational institute; school; faculty; CL:所[suǒ]
球场	court; field; stadium; sports ground; court; pitch; field; golf course; CL:个[gè],处[chù]
那边	there; over there; yonder
长久	for a long time; muchly; (for a) long time
车上	in the car; 
忽略	ignore; to neglect; to overlook; to ignore
涨价	rise in price; inflation of prices; mark up; to appreciate (in value)/to increase in price
大赛	contest; grand contest
针	needle; injection; needle; pin; injection; stitch; CL:根[gēn],支[zhī]
阴谋	conspiracy; to conspire; to plot; a conspiracy; a plot
中毒	poisoning; be poisoned; to be poisoned
指着	point; pointing; 
男孩儿	boy; boy/CL:个[gè]
歌曲	song
胆	courage; gut; bravery; gallbladder; gall bladder; courage; guts; gall; inner container (e.g. bladder of a football, inner container of a thermos)
寸	very short; a unit of length (=1/3 decimetre); a unit of length; inch; thumb
挑	lift up; raise; prick; incite; choose; pick; select; to carry on a shoulder pole; to choose; to pick; to nitpick||to raise; to dig up; to poke; to prick; to incite; to stir up
收到	receive; obtain; to receive
回应	response; respond; to respond; response
一生	lifetime; all one’s life; all one's life; throughout one's life
弯曲	winding; meandering; zigzag; crook; curved; bending; bend; to bend; to curve around; curved; crooked; to wind; to warp
程度 	degree; 
游泳池	swimming pool; swimming pool/CL:场[chǎng]
挺好	very good; not half bad; very good
开头	begin; start; beginning; beginning; to start
种植	plant; to plant; to grow (a crop); to cultivate
咳	cough; sound of sighing; (interjection expressing surprise, sorrow, regret, disappointment etc) oh; damn; wow||cough
她们	they; them (females)
族	clan; race; nationality; race; nationality; ethnicity; clan; by extension, social group (e.g. office workers 上班族)
礼拜	week; day of the week; religious service; to attend a religious service/(coll.) week/(coll.) Sunday
喷	spout; gush; spray; sprinkle; spraying; spew; to spout; to spurt; to spray; to puff; (slang) to criticize scathingly (esp. online)||(of a smell) strong; peak season (of a crop); (classifier for the ordinal number of a crop, in the context of multiple harvests)
一口气	one breath; in one breath; one breath; in one breath; at a stretch
园地	garden; field; garden area
回收	recovery; to recycle; to reclaim; to retrieve; to recover; to recall (a defective product)
顾问	adviser; consultant
意愿	wish; desire; aspiration; volitional; aspiration; wish (for); desire
没什么	It’s nothing; it doesn't matter; it's nothing; never mind; think nothing of it; it's my pleasure; you're welcome
明日	tomorrow
愁	worry; be anxious; to worry about
挨	Next to; in order; in sequence; close to; adjacent to||to suffer; to endure; to pull through (hard times); to delay; to stall; to play for time; to dawdle
棉	generic term for cotton or kapok; cotton; padded or quilted with cotton
天然气	natural gas
增值	value-added; appreciation; increase in value; to appreciate (financially); to increase in value; value-added (accountancy)
南边	south; south side; south; south side; southern part; to the south of
加以	moreover; in addition; in addition; moreover; (used before a disyllabic verb to indicate that the action of the verb is applied to sth or sb previously mentioned); to apply (restrictions etc) to (sb); to give (support, consideration etc) to (sth)
小孩儿	child; kid; child/CL:个[gè]
挨着	next to; close to; near
老乡	fellow-villager; fellow-townsma; fellow townsman; fellow villager; sb from the same hometown
大米	rice; (husked) rice
戏	play; sport; joke; make fun of; drama; play; trick; drama; play; show; CL:出[chū],场[chǎng],台[tái]
底下	under; below; beneath; the location below sth; afterwards
虎	tiger; tiger/CL:只[zhī]
预计	expected; estimate; to forecast; to predict; to estimate
球拍	racket; racquet; racket
同期	corresponding time period; the same period; the corresponding time period (in a different year etc); concurrent; synchronous
大致	more or less; roughly; approximately
手段	means; measure; trick; artifice; method; way; means (of doing sth); skill; ability; trick; wile
医学	medical science; medicine; medicine; medical science; study of medicine
其	his; her; its; their; he; she; it; they; such; that; his; her; its; their; that; such; it (refers to sth preceding it)
清洗	wash; clean; rinse; purge; comb out; to wash; to clean; to purge
扇	fan; leaf; (measure word); fan; slap; flap; flutter; fan up; to fan; to slap sb on the face||fan; sliding, hinged or detachable flat part of sth; classifier for doors, windows etc
宏大	grand; great; great; grand
号召	call; to call; to appeal
莫言	Mo Yan; Mo Yan (1955-), Chinese novelist, winner of 2012 Nobel Prize in Literature
缺陷	defect; flaw
深厚	deep; profound; solid; deep-seated; deep; profound
架	frame; rack; shelf; stand; to support; frame; rack; framework; classifier for planes, large vehicles, radios etc
调节	adjust; to adjust; to regulate; to harmonize; to reconcile (accountancy etc)
讲话	speak; talk; a speech; to speak; to talk; to address; CL:个[gè]
特价	special offer; bargain price; special price
开花	flower; bloom; blossom; to bloom; to blossom; to flower/(fig.) to burst; to split open/(fig.) to burst with joy/(fig.) to spring up everywhere; to flourish
咱	we; us; see 咱[zán]||I or me; we (including both the speaker and the person spoken to)
秋季	autumn; fall; autumn; fall
会员	membership; member
打牌	play cards; play mah-jong; to play mahjong or cards
后年	the year after next
雄伟	grand; imposing; magnificent; majestic
考场	examination hall; examination room; exam room
海水	seawater; brine; sea; seawater
完了	come to an end; be over; completion of a term; to be finished; to be done for; ruined; gone to the dogs; oh no
再次	once more; once again; one more time; once more; once again
服从	Obey; to obey (an order); to comply; to defer
敢于	dare to; be bold in; have the courage to; venture; to have the courage to do sth; to dare to; bold in
枝	branch; classifier for sticks, rods, pencils etc
走过	walk through; pass by; to walk past; to pass by
避	avoid; evade; dodge; keep away; repel; to avoid; to shun; to flee; to escape; to keep away from; to leave; to hide from
灾区	disaster area; stricken region
看出	see; find out; perceive; espy; to make out; to see
公交车	bus; public transport vehicle; town bus; CL:辆[liàng]
两手	two hands; dual tactics; one's two hands; two prongs (of a strategy); both aspects, eventualities etc; skills; expertise
宝石	gemstone; gem; cameo; precious stone; precious stone; gem/CL:枚[méi],颗[kē]
垃圾	rubbish; garbage; refuse; waste; trash; refuse; garbage; (coll.) of poor quality
饭	rice; meal; cooked rice; meal; (loanword) fan; devotee; CL:碗[wǎn]; CL:顿[dùn]
得出	obtain results; reach conclusion; to obtain (a result); to arrive at (a conclusion)
关怀	care; solicitude; to show care for; concerned about; attentive to
配置	configuration; deploy; to deploy; to allocate; configuration; allocation
跳高	high jump; high jump (athletics)
全国	nationwide; entire country; whole nation; nationwide; countrywide; national
许可	Permit; to allow; to permit
钻	diamond; jewel; drill; to drill; to bore; to get into; to make one's way into; to enter (a hole); to thread one's way through; to study intensively; to dig into; to curry favor for personal gain||an auger; diamond
不满	resentful; discontented; dissatisfied
上去	go up; to go up
道	road; way; path; road; path (CL:条[tiáo],股[gǔ]); (bound form) way; reason; principle; (bound form) a skill; an art; a specialization; (Daoism) the Way; the Dao; to say (introducing a direct quotation, as in a novel); (bound form) to express; to extend (polite words); classifier for long thin things (rivers, cracks etc), barriers (walls, doors etc), questions (in an exam etc), commands, courses in a meal, steps in a process; (old) circuit (administrative division)
直升机	helicopter; helicopter/CL:架[jià]
温和	mild; gentle; moderate||lukewarm
通信	communicate; correspond; to correspond (by letter etc); to communicate; communication
晴天	clear sky; sunny day
一时	for a short while; temporary; momentary; a period of time; a while; for a short while; temporary; momentary; at the same time
测试	test; examination; to test (machinery etc)/to test (a person's skill in a particular area)/a test/(computing) beta (version of software)
胡子	mustache; beard; beard; mustache or whiskers; facial hair; (coll.) bandit; CL:撮[zuǒ],根[gēn]
童话	fairy tale; children's fairy tales
变为	become; turn into; change into; to change into
房屋	houses; buildings; tenement; house; building; CL:所[suǒ],套[tào]
忍受	bear; to bear; to endure
证实	Confirm; to confirm (sth to be true)/to verify
算	count; calculate; to regard as; to figure; to calculate; to compute
据	according to; seize; depend on; evidence; used in 拮据[jié jū]||according to; to act in accordance with; to depend on; to seize; to occupy
升学	enter a higher school; to enter the next grade school
强盗	robber; bandit; to rob (with force); bandit; robber; CL:个[gè]
闭幕式	closing ceremony
沉	sink; keep down; lower; deep; profound; heavy; to submerge; to immerse; to sink; to keep down; to lower; to drop; deep; profound; heavy
男朋友	boyfriend
黄	yellow; pornographic; to fall through; surname Huang or Hwang
轮椅	wheelchair
厅	office; hall; (reception) hall; living room; office; provincial government department
技能	technical ability; skill; technical ability; skill
部长	minister; head of a department; head of a (government etc) department; section chief; section head; secretary; minister; CL:个[gè],位[wèi],名[míng]
大胆	bold; daring; audacious; audacity; brazen; audacious; outrageous; bold; daring; fearless
用得着	useful; need; to be able to use; useable; to have a use for/(in a question) to be necessary to
电影院	cinema; movie theater; cinema; movie theater/CL:家[jiā],座[zuò]
生活费	living expenses; cost of living; alimony; cost of living; living expenses; alimony
电力	electricity; electric power; electrical power; electricity
高考	college entrance examination; college entrance exam (especially as abbr. for 普通高等學校招生全國統一考試|普通高等学校招生全国统一考试[pǔ tōng gāo děng xué xiào zhāo shēng quán guó tǒng yī kǎo shì])/(Tw) entrance exam for senior government service posts (abbr. for 公務人員高等考試|公务人员高等考试)
委托	Entrust; to entrust; to trust; to commission
公路	highway; highroad; highway; road; CL:条[tiáo]
走路	walk; to walk; to go on foot
干吗	Why; see 幹嘛|干嘛[gàn má]
绿茶	green tea; (slang) (of a girl) seemingly innocent and charming but actually calculating and manipulative; a girl who has these qualities
查出	trace; find out; discover; find out; to find out; to discover
取得	acquire; gain; obtain; to acquire; to get; to obtain
不同	different; distinct; not the same; not alike
金融	banking; finance; financial
小学	primary school; elementary schoo; elementary school; primary school
混合	blend; to mix; to blend; hybrid; composite
夺剑	Seize the sword; 
前进	advance; go forward; march; to go forward; to forge ahead; to advance; onward
只不过	only; just; merely; only; merely; nothing but; no more than; it's just that ...
供给	supply; to furnish; to provide; supply (as in supply and demand)
全新	new; brand new; all new; completely new
蓝色	blue; blue (color)
题材	theme; subject matter
隔	partition; separate; divide; to separate; to partition; to stand or lie between; at a distance from; after or at an interval of
提起	mention; speak of; raise; lift; to mention; to speak of; to lift; to pick up; to arouse; to raise (a topic, a heavy weight, one's fist, one's spirits etc)
分为	divide into; to divide sth into (parts); to subdivide
决策	make policy; strategic decision; decision-making; policy decision; to determine policy
相机	camera; camera (abbr. for 照相機|照相机[zhào xiàng jī]); at the opportune moment; as the circumstances allow
名单	list; list of names
短片	short film; video clip
构建	structure; construct; to construct (sth abstract)
不再	no longer; no more; no more; no longer
品牌	brand; brand name; trademark
外文	foreign language; foreign language (written)
长处	strength; forte; strong point; good aspects; strong points
彩票	lottery; lottery ticket
知足 	contented; 
现状	Present situation; current situation
求	request; beg; entreat; beseech; to seek; to look for; to request; to demand; to beseech
珍贵	precious
儿女	sons and daughters; children; children; sons and daughters; a young man and a young woman (in love)
猛	fierce; violent; abrupt; suddenly; with a rush; ferocious; fierce; violent; brave; suddenly; abrupt; (slang) awesome
评	comment; review; criticize; judge; to discuss; to comment; to criticize; to judge; to choose (by public appraisal)
前边	in front; front; the front side; in front of
无边	boundless; without boundary; not bordered
节假日	holidays; festival and holiday; public holiday
读书	reading; study; to read a book; to study; to attend school
残疾人	handicapped; disabled person; disabled person
之一	one of; one of (sth); one out of a multitude; one (third, quarter, percent etc)
漫长	very long; endless
边缘	edge; fringe; verge; brink; periphery; marginal; borderline
转向	turn to; sheer off; change direction; to change direction; fig. to change one's stance||to get lost; to lose one's way
连接	link; joint; relate, unite, connect, attach; connection; to link; to join; to connect
蒙	cover; encounter; come under; receive; cheat; deceive; make a wild guess; unconscious; drizzle; mist||to deceive; to cheat; to hoodwink; to make a wild guess||blind; dim-sighted||surname Meng||Mongol ethnic group; abbr. for Mongolia 蒙古國|蒙古国[měng gǔ guó]; dazed; stunned||to cover; ignorant; to suffer (misfortune); to receive (a favor); to cheat
之外	outside; except; outside; excluding
总部	headquarters; general headquarters; general headquarters
缘故	reason; cause
病房	ward of a hospital; sickroom; ward (of a hospital)/sickroom/CL:间[jiān]
设置	Set up; to set up; to install
里头	inside; interior
好友	friend; close friend; pal; (social networking website) friend; CL:个[gè]
无法	unable; incapable; unable to; incapable of
好事	good deed; good thing; good action, deed, thing or work (also sarcastic, "a fine thing indeed"); charity; happy occasion; Daoist or Buddhist ceremony for the souls of the dead||to be meddlesome
拨打	dial; to call; to dial
开关	switch; power switch; power switch; gas valve; to open the city (or frontier) gate; to open and close; to switch on and off
国庆	National Day
预测	forecast; prognosis; predict; to forecast; to predict
小朋友	child; kid; child/CL:个[gè]
制订	formulate; work out; map out; to work out; to formulate
修建	build; to build; to construct
特	particular; special; exceptional; unusual; especially; very; special; unique; distinguished; especially; unusual; very; abbr. for 特克斯[tè kè sī], tex
专辑	album; record (music); special collection of printed or broadcast material
点名	rollcall; mention sb. by name; roll call; to mention sb by name; (to call or praise or criticize sb) by name
作废	cancel, blank out; to become invalid; to cancel; to delete; to nullify
多媒体	multimedia
去掉	get rid of; do away with; take out; to get rid of; to exclude; to eliminate; to remove; to delete; to strip out; to extract
美	beautiful; pretty; (bound form) the Americas (abbr. for 美洲[měi zhōu]); (bound form) USA (abbr. for 美國|美国[měi guó]); beautiful; very satisfactory; good; to beautify; to be pleased with oneself
传输	transmission; transport; to transmit; transmission
池子	pond; pool; pond; bathhouse pool; dance floor of a ballroom; (old) stalls (front rows in a theater)
井	well; a well; neat; orderly; surname Jing; Jing, one of the 28 constellations of Chinese astronomy; CL:口[kǒu]
轮子	wheel; wheel/(derog.) Falun Gong practitioner/CL:个[gè]
加盟	join; to become a member of an alliance or union; to align; to join; participate
药片	pill; a (medicine) pill or tablet/CL:片[piàn]
没用	useless
夺取	seize; wrest; strive for; snatch; taking; to seize; to capture; to wrest control of
带动	drive; spur; to spur; to provide impetus; to drive
外汇	foreign exchange; foreign currency; foreign (currency) exchange
教学楼	teaching building; school building; academic building
单	single; odd; unlined; thin; weak; only; alone; list; form; single; only; sole; odd number; surname Shan||bill; CL:个[gè]
旅店	inn; hostel; hotel; inn; small hotel
答	answer; reply; respond; return; bound form having the same meaning as the free word 答[dá], used in 答應|答应[dā ying], 答理[dā li] etc||to answer; to reply; to respond
华语	the Chinese language; Chinese; Chinese language
饭馆	restaurant; restaurant/CL:家[jiā]
领袖	leader
跳	jump; leap; skip; bounce; to jump; to hop; to skip over; to bounce; to palpitate
考	test; examine; to beat; to hit; variant of 考[kǎo]; to inspect; to test; to take an exam; to check; to verify; to test; to examine; to take an exam; to take an entrance exam for; deceased father
紧密	close; inseparable; inseparably close
网址	Internet site; website; URL; website; web address; URL
脚步	footstep; step; pace; footstep; step
黄瓜	cucumber; cuke; cucumber/CL:条[tiáo]
难得	seldom; rare; hard to come by
近视	myopia; short sight; shortsighted; nearsighted; myopia
占据	Occupy; to occupy; to hold
空军	air force; air service; air force
负担	burden; to bear (an expense, a responsibility etc)/burden
递给	hand over; pass on; to hand it (i.e. the aforementioned item) to (sb)
开幕	open; inaugurate; rising of a curtain; to open (a conference)/to inaugurate
再生	regeneration; regenerate; revive; to be reborn; to regenerate; to be a second so-and-so (famous dead person); recycling; regeneration
赶到	arrived; get to; to hurry (to some place)
句	sentence; clause; phrase; classifier for phrases or lines of verse
楼上	upstairs; upstairs/(Internet slang) previous poster in a forum thread
走进	walk in; to enter
心疼	Distressed; to love dearly; to feel sorry for sb; to regret; to grudge; to be distressed
闭	close; shut; obstruct; stop up; to close; to stop up; to shut; to obstruct
往年	in previous years; in former years; in former years; in previous years
好听	pleasant to hear
拔	pluck; pull out; draw; select; choose; extract; to pull up; to pull out; to draw out by suction; to select; to pick; to stand out (above level); to surpass; to seize
鸭子	duck; male prostitute (slang)
罪恶	sin; crime; evil; crime; evil; sin
政党	political party; political party/CL:个[gè]
特地	for a special purpose; specially; specially; for a special purpose
发炎	to become inflamed; inflammation
车号	car number; wagon number; vehicle number (license plate number, taxi number, bus number, train car number)
定价	fix a price; set price; fixed price; pricing; to set a price; to fix a price
若	like; seem; as; if; to seem; like; as; if
指标	(production) target; quota; index; indicator; sign; signpost; (computing) pointer
得以	be able to; able to; so that sb can; enabling; in order to; finally in a position to; with sth in view
开展	Develop; to launch; to develop; to unfold; (of an exhibition etc) to open
首脑	head; leader; headman; head (of state)/summit (meeting)/leader
踢	kick; to kick; to play (e.g. soccer); (slang) butch (in a lesbian relationship)
竞赛	to compete; to race; contest; competition; match; race
犯规	foul; to break the rules; an illegality; a foul
动机	motive; motivation
天才	talent; gift; genius; talented; gifted
当作	regard as; treat as; to treat as; to regard as
赛场	arena; competition terrain; racetrack; field (for athletics competition)
担忧	worry; be anxious; trepidation; to worry; to be concerned
在场	be on the scene; be on the spot; to be present; to be on the scene
性能	function; performance; behavior
保守	conservative; to guard; to keep
柱子	post; pillar; pillar/CL:根[gēn]
测	survey; fathom; measure; conjecture; infer; to survey; to measure; to conjecture
眼	eye; small hole; crux (of a matter); classifier for big hollow things (wells, stoves, pots etc); CL:只[zhī],双[shuāng]
睡眠	sleep; slumber; sleep; to sleep; (computing) to enter sleep mode
可乐	coke; cola; amusing; entertaining; (loanword) cola
空儿	spare time; free time
没想到	didn’t expect; didn't expect
震惊	shock; to shock; to astonish
简介	brief introduction; synopsis; summary; summary; brief introduction
孙女	son's daughter; granddaughter
修养	training, mastery; accomplishment; training; self-cultivation
自身	oneself; self; itself; oneself; one's own
毁	destroy; ruin; damage; defame; to destroy; to ruin; to defame; to slander; to destroy by fire
外面	outside; outdoors; outward appearance; surface; exterior; external appearance
书房	study; study (room)/studio/CL:间[jiān]
对应	Corresponding; to correspond (to); to be equivalent to; to be a counterpart to
歌星	singer; singing star; singing star; famous singer
动摇	shake; vacillate; waver; be indecisive; to sway; to waver; to rock; to rattle; to destabilize; to pose a challenge to
赌	gamble; bet; to bet; to gamble
刺	thorn; (onom.) whoosh||thorn; sting; thrust; to prick; to pierce; to stab; to assassinate; to murder
智力	intelligence; intellect
推动	promote; push forward; give impetus to; to push (e.g. for acceptance of a plan); to promote; to give impetus to
剪子	scissors; shears; clippers; clippers; scissors; shears; CL:把[bǎ]
上帝	God
丰收	Have bumper harvest; bumper harvest
延伸	extend; to extend; to spread
刷子	brush; scrub; brush; scrub; CL:把[bǎ]
啦	auxiliary word; (onom.) sound of singing, cheering etc; (phonetic); (dialect) to chat||sentence-final particle, contraction of 了啊, indicating exclamation; particle placed after each item in a list of examples
岗位	post; a post; a job
车牌	licence plate; plate number; license plate
受灾	disaster; the afflicted; disaster-stricken; to be hit by a natural calamity
复苏	resuscitate; recovery; come to; revive; to recover (health, economic); to resuscitate; anabiosis
走私	smuggle; to smuggle; to have an illicit affair
自我	oneself; self; self-/ego (psychology)
出租	rent; to rent
心中	in the heart; at heart; in mind; central point; in one's thoughts; in one's heart
全球	global; the whole world; the whole world; worldwide; global
等到	wait until; by the time; to wait until; by the time when (sth is ready etc)
城区	the city proper; urban area; city subdivision; city district; urban area
教学	teach; to teach (as a professor)||teaching; instruction; CL:次[cì]
当场	at the scene; on the spot
播出	broadcast; on the air; to broadcast; to air (a TV program etc)
歌手	singer; vocalist; singer
指示	to point out; to indicate; to instruct; directives; instructions; CL:个[gè]
慌忙	hurried; hurry; hurry-scurry; in a great rush; in a flurry
率先	lead; take the lead; to take the lead; to show initiative
托	support from under; set off; entrust; plead; rely; to hold up in one's hand; to support with one's palm; sth serving as a support: a prop, a rest (e.g. arm rest); (bound form) a shill; to ask; to beg; to entrust (variant of 托[tuō]); torr (unit of pressure); to trust; to entrust; to be entrusted with; to act as trustee
乐趣	delight; pleasure; joy
摔	fall; break; throw; fling; lose one’s balance; to throw down; to fall; to drop and break
品	savour; taste; judge; blow; species; grade; (bound form) article; commodity; product; goods; (bound form) grade; rank; kind; type; variety; character; disposition; nature; temperament; to taste sth; to sample; to criticize; to comment; to judge; to size up; fret (on a guitar or lute)
转化	change; transform; to change; to turn; to convert/(genetics) to transform/(chemistry) isomerization
原告	accuser; complainant; plaintiff
请客	stand treat; entertain; to give a dinner party; to entertain guests; to invite to dinner
纯	pure; unmixed; simple; skilful; practised; pure; simple; unmixed; genuine
工艺	technology; craft; arts and crafts; industrial arts
电车	tram; tramcar; streetcar; trolleybus; trolley; trolleybus/CL:辆[liàng]
吸烟	smoke; to smoke
扎实	strong; solid; sturdy; firm; practical
让座	offer one’s seat to sb.; to give up one's seat for sb
血液	blood
强势	strong; mighty; strong; powerful; (linguistics) emphatic; intensive
反抗	Resistance; to resist; to rebel
实验室	laboratory; laboratory/CL:间[jiān]
平坦	level; even; smooth; flat
领取	draw; receive; pull down; to receive; to draw; to get
是不是	isn’t it?; is or isn't; yes or no; whether or not
鉴定	Appraisal; to appraise; to identify; to evaluate
