好的	OK
假如	if
儿子	son
果酱	jam
王一然	Eva
天空	sky
艺术	art
取款机	ATM
上帝	God
为何	why
间谍	spy
蚂蚁	ant
犹太人	Jew
总和	sum
挨着	near
波浪	wave
女人	wife
东方	east
家里	home
歌曲	song
泄漏秘密	Leak
基金	fund
海军	navy
胶水	glue
王莉莎	Lisa
一半	half
数据	data
现金	cash
这里	here
这儿	here
偶像	idol
墙壁	wall
燃料	fuel
钩子	hook
性爱派对	orgy
温暖	warm
羽衣甘蓝	kale
湖泊	lake
团队	team
灰尘	dust
煤炭	coal
