它	tā
的	de
好	hǎo
好的	hǎo de
假如	jiǎrú
如	rú
假	jiǎ
她	tā
子	zǐzi
儿子	érzi
儿	érr
臂	bì
酱	jiàng
果酱	guǒjiàng
果	guǒ
王	wángwángwàng
王一然	wáng yīrán
然	rán
一	yī
天	tiān
空	kōng
天空	tiānkōng
艺	yì
术	shùzhú
艺术	yìshù
款	kuǎn
机	jī
取	qǔ
取款机	qǔkuǎnjī
上	shàng
上帝	shàngdì
帝	dì
嘿	hēi
为	wèi
为何	wèihé
何	hé
间谍	jiàndié
谍	dié
间	jiānjiàn
蚂蚁	mǎyǐ
蚂	māmǎmà
蚁	yǐ
犹	yóu
犹太人	yóutàirén
人	rén
太	tài
总	zǒng
和	hé
总和	zǒnghé
挨	ái
挨着	āizhe
着	zhe
波浪	bōlàng
浪	làng
波	bō
女	nǚ
女人	nǚrén
东方	dōngfāng
方	fāng
东	dōng
慢	màn
冷	lěng
里	lǐmiàn
家	jiā
家里	jiālǐ
懒	lǎn
西	xī
歌	gē
曲	qūqūqǔqū
歌曲	gēqǔ
漏	lòu
泄漏秘密	xièlòu mìmì
秘	bìmì
泄	xiè
密	mì
基	jī
基金	jījīn
金	jīn
军	jūn
海	hǎi
海军	hǎijūn
胶水	jiāoshuǐ
胶	jiāo
水	shuǐ
莎	shāsuō
王莉莎	wáng lìshā
莉	lì
一半	yībàn
半	bàn
数据	shùjù
据	jūjù
数	shǔ
现金	xiànjīn
现	xiàn
这里	zhèlǐ
这	zhè
这儿	zhèr
偶像	ǒuxiàng
偶	ǒu
像	xiàng
壁	bì
墙	qiáng
墙壁	qiángbì
燃	rán
燃料	ránliào
料	liào
钩	gōu
钩子	gōuzi
爱	ài
性	xìng
派	pài
性爱派对	xìngài pàiduì
对	duì
暖	nuǎn
温暖	wēnnuǎn
温	wēn
衣	yīyì
甘	gān
蓝	lán
羽衣甘蓝	yǔyī gānlán
羽	yǔ
湖	hú
湖泊	húpō
泊	bópō
团	tuán
团队	tuánduì
队	duì
尘	chén
灰尘	huīchén
灰	huī
玉	yù
煤炭	méitàn
炭	tàn
煤	méi
租金	zūjīn
租	zū
茂	mào
茂盛	màoshèng
盛	chéng
骑着	qízhe
骑	qí
词	cí
名	míng
名词	míngcí
瘸	qué
代码	dàimǎ
码	mǎ
代	dài
爱玩	àiwán
玩	wán
花	huā
瑰	guī
玫瑰花	méiguīhuā
玫	méi
箱	xiāng
烤	kǎo
烤箱	kǎoxiāng
土	tǔ
壤	rǎng
土壤	tǔrǎng
性命	xìngmìng
命	mìng
岩	yán
岩石	yánshí
石	shídànshí
亦	yì
舟	zhōu
比	bǐ
比分	bǐfēn
分	fēn
毒	dú
病毒	bìngdú
病	bìng
中国	Zhōngguò
中	zhōngzhōngzhòng
国	guó
孩子	háizi
孩	hái
地	de
当地	dāngdì
当	dāng
少	shǎo
传	chuánzhuàn
传媒	chuánméi
媒	méi
南	nán
从不	cóngbù
从	cóng
不	bù
年	nián
轻	qīng
年轻	niánqīng
自	zì
独	dú
独自	dúzì
板	bǎnbǎnpàn
地板	dìbǎn
甜	tián
色	sèshǎi
黑	hēi
黑色	hēisè
西班牙	xībānyá
牙	yá
班	bān
格	gé
风格	fēnggé
风	fēng
那	nānuónànuó
那儿	nàr
些	xiē
那些	nàxiē
支	zhī
笔	bǐ
一支笔	yīzhī bǐ
妇女	fùnǚ
妇	fù
稠密	chóumì
稠	chóu
葡萄	pútao
葡	pú
萄	táo
价	jiàjie
价钱	jiàqian
钱	qián
绿	lǜ
绿色	lǜsè
黑夜	hēiyè
夜	yè
今	jīn
今日	jīnrì
日	rì
励	lì
曹	cáo
曹励嘉	cáo lìjiā
嘉	jiā
？	？
楠	nán
雅	yǎ
裳	chángshang
裳雅楠	cháng yǎnán
美	měi
龚美丽	gōng měilì
龚	gōng
丽	lílì
广萝丽	guǎng luólì
萝	luó
广	yǎnguǎngguǎng
婷	tíng
奶	nǎi
王奶婷	wáng nǎitíng
叶子华	yè zihuá
华	huáhuàhuá
叶	xiéyèyè
爱师克	àishīkè
师	shī
克	kè
乐	lèyuèlèyuè
咳	hāiké
宽	kuān
宽度	kuāndù
度	dùduó
泪	lèi
这些	zhèxiē
市	shì
市长	shìzhǎng
长	cháng
大腿	dàtuǐ
腿	tuǐ
大	dà
手肘	shǒuzhǒu
手	shǒu
肘	zhǒu
墟	xū
废墟	fèixū
废	fèi
小偷	xiǎotōu
偷	tōu
小	xiǎo
视	shì
视频	shìpín
频	pín
人群	rénqún
群	qún
小组	xiǎozǔ
组	zǔ
扫	sǎo
大堂	dàtáng
堂	táng
固	gù
固体	gùtǐ
体	tǐ
份	fèn
月	yuè
月份	yuèfèn
寿司	shòusī
司	sī
寿	shòu
少儿	shàoér
桃	táo
味儿	wèir
味	wèi
钢	gāng
钢铁	gāngtiě
铁	tiě
娘	niáng
新	xīn
新娘	xīnniáng
向导	xiàngdǎo
向	xiàng
导	dǎo
静	jìng
寂	jì
寂静	jìjìng
响声	xiǎngshēng
响	xiǎng
声	shēng
到	dào
直到	zhídào
直	zhí
使	shǐ
天使	tiānshǐ
茴	huí
籽	zǐ
土茴香籽	tǔ huíxiāng zǐ
香	xiāng
液	yè
血液	xuèyè
血	xuè
法	fǎ
用	yòng
用法	yòngfǎ
湿	shī
润	rùn
湿润	shīrùn
实	shí
实话	shíhuà
话	huà
埃及	āijí
埃	āi
及	jí
炉	lú
灶	zào
炉灶	lúzào
亚	yà
洲	zhōu
亚洲人	yàzhōu rén
鬼	guǐ
魔	mó
魔鬼	móguǐ
魔术	móshù
奴隶	núlì
隶	lì
奴	nú
丘	qiū
陵	líng
丘陵	qiūlíng
棕色	zōngsè
棕	zōng
言	yán
谣	yáo
谣言	yáoyán
面团	miàntuán
面	miàn
伊	yī
斯	sī
兰	lán
教	jiào
伊斯兰教	yīsīlánjiào
围	wéi
围裙	wéiqún
裙	qún
膛	táng
胸	xiōng
胸膛	xiōngtáng
瘤	liú
肿瘤	zhǒngliú
肿	zhǒng
癌	ái
症	zhèngzhēng
癌症	áizhèng
把	bǎ
安详	ānxiáng
详	xiáng
安	ān
六	liù
物	wù
博物馆	bówùguǎn
馆	guǎn
博	bó
跑	páopǎo
奔跑	bēnpǎo
奔	bēnbèn
诚	chéng
诚实	chéngshí
车库	chēkù
车	chēchējū
库	kù
钟	zhōng
分钟	fēnzhōng
备	bèi
备份	bèifèn
长度	chángdù
成员	chéngyuán
员	yuán
成	chéng
产	chǎn
产量	chǎnliàng
量	liángliàng
扣	kòu
飞	fēi
橙子	chéngzi
橙	chéng
窗	chuāng
窗子	chuāngzi
樱桃	yīngtáo
樱	yīng
头	tóutou
点头	diǎntóu
点	diǎn
读	dú
者	zhě
读者	dúzhě
冬	dōng
冬季	dōngjì
季	jì
看到	kàndào
看	kàn
里边	lǐbian
边	biānbian
而	ér
而是	érshì
是	shì
首	shǒu
一首歌	yīshǒugē
歌手	gēshǒu
夏	xià
番茄	fānqié
番	fān
茄	jiāqié
见到	jiàndào
见	jiànxiàn
拜	bài
礼拜天	lǐbàitiān
礼	lǐ
流利	liúlì
利	lì
流	liú
总是	zǒngshì
律师	lǜshī
律	lǜ
会	huì
会员	huìyuán
公众	gōngzhòng
公	gōng
众	zhòng
化	huà
化石	huàshí
孤儿	gūér
孤	gū
老	lǎo
老是	lǎoshi
网上	wǎngshàng
网	wǎng
复	fù
复活节	fùhuójié
节	jié
活	huó
力	lì
精	jīng
精力	jīnglì
街头	jiētóu
街	jiē
有	yǒu
有用	yǒuyòng
动	dòng
动脉	dòngmài
脉	màimò
人们	rénmen
们	men
慢慢	mànmàn
瑞	ruì
典	diǎn
瑞典	ruìdiǎn
勿	wù
县	xiàn
鞋	xié
凉鞋	liángxié
凉	liángliángliàng
袖	xiù
领袖	lǐngxiù
领	lǐng
一棵树	yīkēshù
棵	kē
树	shù
雨	yǔyù
场	chǎng
一场雨	yīcháng yǔ
一场雪	yīcháng xuě
雪	xuě
园	yuán
校园	xiàoyuán
校	jiàoxiào
万	wàn
一万	yīwàn
信号	xìnhào
号	hào
信	xìn
饭	fàn
顿	dùn
一顿饭	yīdùnfàn
球	qiú
球拍	qiúpāi
拍	pāi
酸奶	suānnǎi
酸	suān
抽	chōu
屉	tì
抽屉	chōuti
一条鱼	yītiáo yú
鱼	yú
条	tiáo
胆	dǎn
胆小鬼	dǎnxiǎoguǐ
岛	dǎo
岛屿	dǎoyǔ
屿	yǔ
衫	shān
连帽衫	liánmàoshān
连	lián
帽	mào
兔	tù
夏季	xiàjì
歐楂	ōuzhā
楂	cházhā
歐	-
污水	wūshuǐ
污	wū
纸	zhǐ
一张纸条	yīzhāng zhǐtiáo
张	zhāng
个	gè
一个梗	yīgè gěng
梗	gěng
监	jiānjiàn
狱	yù
监狱	jiānyù
扁	biǎn
豆	dòu
小扁豆	xiǎobiǎndòu
气	qì
氧	yǎng
氧气	yǎngqì
心水	xīn shuǐ
心	xīn
等	děng
中等	zhōngděng
赌场	dǔchǎng
赌	dǔ
一个湖	yīgè hú
清	qīng
寺	sì
清真寺	qīngzhēnsì
真	zhēn
穆	mù
林	lín
穆斯林	mùsīlín
棉	mián
棉花	miánhua
以色列	yǐsèliè
以	yǐ
列	liè
蜘	zhī
蛛	zhū
蜘蛛	zhīzhū
配	pèi
配偶	pèi’ǒu
蹈	dǎo
舞	wǔ
舞蹈家	wǔdǎojiā
乞	qǐ
丐	gài
乞丐	qǐgài
强奸犯	qiángjiānfàn
奸	jiān
犯	fàn
强	qiáng
贪	tān
贪心	tānxīn
罗	luó
俄	é
俄罗斯	éluósī
贪钱	tānqián
殿	diàn
神	shén
神殿	shéndiàn
隧	suì
道	dào
隧道	suìdào
面筋	miànjīn
筋	jīn
质	zhì
麸质	fūzhì
麸	fū
犹太洁食	yóutài jiéshí
洁	jié
食	shísì
主教	zhǔjiào
主	zhǔ
狭窄	xiázhǎi
窄	zhǎi
狭	xiá
荣	róng
虚	xū
虚荣	xūróng
旋律	xuánlǜ
旋	xuánxuàn
液体	yètǐ
算	suàn
预算	yùsuàn
预	yù
枕	zhěn
枕头	zhěntou
殖	zhí
民	mín
殖民地	zhímíndì
语法	yǔfǎ
语	yǔyù
百分之	bǎifēnzhī
之	zhī
百	bǎi
四	sì
五	wǔ
经	jīng
已	yǐ
已经	yǐjīng
被动	bèidòng
被	bèi
九	jiǔ
十	shí
喂	wèi
找到	zhǎodào
找	zhǎo
车辆	chēliàng
辆	liàng
出	chū
出租	chūzū
朝	cháo
面条	miàntiáo
天气	tiānqì
下	xià
下雨	xiàyǔ
渴	kě
K	-
拉	lā
卡	kǎ
O	-
卡拉OK	kǎlā ok
一张照片	yīzhāng zhàopiàn
片	piàn
照	zhào
鲜	xiānxiǎnxiān
海鲜	hǎixiān
打印机	dǎyìnjī
打	dádǎ
印	yìn
网站	wǎngzhàn
站	zhàn
公民	gōngmín
公式	gōngshì
式	shì
一只眼睛	yīzhī yǎnjīng
眼	yǎn
只	zhǐzhīzhī
睛	jīng
周末	zhōumò
周	zhōu
末	mò
唱	chàng
歌唱	gēchàng
一件衬衫	yījiàn chènshān
衬	chèn
件	jiàn
急	jí
急忙	jímáng
忙	máng
听	tīng
听到	tīngdào
听见	tīngjiàn
加	jiā
热	rè
加热	jiārè
白	bái
蛋白质	dànbáizhì
蛋	dàn
户	hù
外	wài
户外	hùwài
灯	dēng
灯笼	dēnglóng
笼	lónglǒng
极	jí
极端	jíduān
端	duān
台	tái
地质	dìzhì
混乱的	hùnluàn de
混	húnhùn
乱	luàn
想	xiǎng
一个想法	yīgè xiǎngfǎ
孔	kǒng
孔雀	kǒngquè
雀	qiāoquè
撕	sī
利润	lìrùn
纷	fēn
纠纷	jiūfēn
纠	jiū
没用	méiyòng
没	méi
怒	nù
无怒如何	wúnù rúhé
无	wú
打字	dǎzì
字	zì
非法	fēifǎ
非	fēi
跃	yuè
飞跃	fēiyuè
肥	féi
肥沃	féiwò
沃	wò
苗	miáo
疫苗	yìmiáo
疫	yì
气球	qìqiú
虏	lǔ
俘	fú
俘虏	fúlǔ
下雪	xiàxuě
一场比赛	yīcháng bǐsài
赛	sài
考	kǎo
一场考试	yīcháng kǎoshì
试	shì
火	huǒ
一列火车	yīliè huǒchē
刀	dāo
一把刀	yībǎ dāo
一把椅子	yībǎ yǐzi
椅	yǐ
一张桌子	yīzhāng zhuōzi
桌	zhuō
去	qù
失去	shīqù
失	shī
傻	shǎ
记	jì
篇	piān
一篇日记	yīpiān rìjì
惭	cán
惭愧	cánkuì
愧	kuì
停	tíng
停下	tíngxià
蛇	shé
一条蛇	yītiáo shé
台风	táifēng
恤	xù
T	-
T恤	txù
完	wán
完美	wánměi
住房	zhùfáng
住	zhù
房	fáng
植	zhí
一棵植物	yīkē zhíwù
甜品	tiánpǐn
品	pǐn
天然	tiānrán
顽皮	wánpí
顽	wán
皮	pí
维	wéi
生	shēng
维生素	wéishēngsù
素	sù
反	fǎn
义	yì
反义词	fǎnyìcí
学	xué
学者	xuézhě
晓	xiǎo
晓得	xiǎode
得	děi
遇	yù
遇见	yùjiàn
沿	yán
沿海	yánhǎi
小清新	xiǎo qīng xīn
中性	zhōngxìng
战	zhàn
战术	zhànshù
哭泣	kūqì
哭	kū
泣	qì
洋	yáng
大洋洲	dàyángzhōu
愿	yuàn
祝愿	zhùyuàn
祝	zhù
爱尔兰	àiěrlán
尔	ěr
捆绑	kǔnbǎng
捆	kǔn
绑	bǎng
理	lǐ
物理	wùlǐ
山	shān
山顶	shāndǐng
顶	dǐng
同	tóngtòng
同义词	tóngyìcí
葬	zàng
埋葬	máizàng
埋	máimán
牛	niú
放	fàng
放牛	fàngniú
冰	bīng
冰川	bīngchuān
川	chuān
耐	nài
耐用	nàiyòng
插头🔌	chātóu 🔌
插	chā
🔌	-
卡通片	kǎtōngpiàn
通	tōngtòng
障	zhàng
屏	bīngbǐngpíng
屏障	píngzhàng
栋	dòng
一栋房子	yīdòng fángzi
羞愧	xiūkuì
羞	xiū
强奸	qiángjiān
毛毯	máotǎn
毯	tǎn
毛	máo
卖	mài
卖艺	màiyì
人质	rénzhì
圈内人	quānnèirén
内	nèi
圈	quān
态	tài
生态	shēngtài
村子	cūnzi
村	cūn
麦	mài
丹麦	dānmài
丹	dān
讼	sòng
诉	sù
诉讼	sùsòng
统统	tǒngtǒng
统	tǒng
凭	píng
文凭	wénpíng
文	wén
针	zhēn
指	zhǐ
指南针	zhǐnánzhēn
激	jī
令	línglǐnglìng
令人激动	lìngrénjīdòng
八	bā
看电视	kàndiànshì
电	diàn
三	sān
七	qī
不用	bùyòng
猜	cāi
猫粮	māo liáng
粮	liáng
猫	māo
业	yè
毕业生	bìyèshēng
毕	bì
明天	míngtiān
明	míng
物料	wù liào
女儿	nǚér
能	néng
本	běn
本能	běnnéng
跳舞	tiàowǔ
跳	tiào
房东	fángdōng
写	xiě
喝	hē
得分	défēn
购	gòu
购物	gòuwù
工业	gōngyè
工	gōng
互联网	hùliánwǎng
联	lián
互	hù
进	jìn
进去	jìnqù
室友	shìyǒu
友	yǒu
室	shì
盘	pán
键盘	jiànpán
键	jiàn
假期	jiàqī
期	qī
亮	liàng
月亮	yuèliang
浪漫	làngmàn
漫	màn
佛	fófúfú
佛教	fójiào
红	hóng
红酒	hóngjiǔ
酒	jiǔ
海水	hǎishuǐ
航	háng
航空	hángkōng
公主	gōngzhǔ
跪	guì
油	yóu
汽油	qìyóu
汽	qì
海浪	hǎilàng
大意	dàyi
意	yì
辰	chén
诞辰	dànchén
诞	dàn
接	jiē
间接	jiànjiē
盗窃	dàoqiè
盗	dào
窃	qiè
可	kěkè
可靠	kěkào
靠	kào
酒鬼	jiǔguǐ
千克	qiānkè
千	qiān
栗	lì
栗子	lì zi
压	yāyà
压力	yālì
茶	chá
奶茶	nǎichá
在一起	zài yīqǐ
起	qǐ
在	zài
宗教	zōngjiào
宗	zōng
范畴	fànchóu
畴	chóu
范	fàn
蓝天	lántiān
肩	jiān
膀	bǎngbàngpāngpáng
肩膀	jiānbǎng
英	yīng
俊	jùnzùn
英俊	yīngjùn
预报	yùbào
报	bào
明日	míngrì
流汗	liúhàn
汗	hàn
盖	gài
覆	fù
覆盖	fùgài
鼾	hān
打鼾	dǎhān
上去	shàngqù
如同	rútóng
套	tào
一件外套	yījiàn wàitào
欺负	qīfu
欺	qī
负	fù
药	yào
店	diàn
药店	yàodiàn
实力	shílì
音节	yīnjié
音	yīn
功	gōng
功效	gōngxiào
效	xiào
共和国	gònghéguó
共	gòng
台上	táishàng
掉东西	diào dōngxi
掉	diào
柜	jǔguì
书柜	shūguì
书	shū
山坡	shānpō
坡	pō
站住	zhànzhù
途	tú
途中	túzhōng
裤	kù
长裤	chángkù
交	jiāo
官	guān
外交官	wàijiāoguān
食欲	shíyù
欲	yù
走进	zǒujìn
走	zǒu
侣	lǚ
一对情侣	yīduì qínglǚ
情	qíng
肉	ròu
生肉	shēng ròu
吸烟	xīyān
烟	yān
吸	xī
触	chù
触手	chù shǒu
华丽	huálì
温和	wēnhé
荒凉	huāngliáng
荒	huāng
疼	téng
头疼	tóuténg
热可可	rè kěkě
消	xiāo
消费者	xiāofèizhě
费	fèi
仁	rén
杏仁膏	xìngrén gāo
膏	gāogào
杏	xìng
笑	xiào
讥	jī
讥笑	jīxiào
网页	wǎngyè
页	yè
惊	jīng
悚	sǒng
惊悚片	jīngsǒngpiān
笑声	xiàoshēng
硬件	yìngjiàn
硬	yìng
月球	yuèqiú
西兰花	xīlánhuā
一道	yīdào
仪式	yíshì
仪	yí
纽	niǔ
纽约	niǔyuē
约	yāoyuē
一同	yītóng
界限	jièxiàn
限	xiàn
界	jiè
音乐家	yīnyuèjiā
湾区	wānqū
区	qū
湾	wān
贵	guì
珍贵	zhēnguì
珍	zhēn
众多	zhòngduō
多	duō
略	lüè
战略	zhànlüè
行	xíng
可行	kěxíng
织	zhī
汇	huì
词汇表	cíhuìbiǎo
表	biǎo
矿产	kuàngchǎn
矿	kuàng
临床	línchuáng
临	lín
床	chuáng
常	cháng
照常	zhàocháng
吓	xià
我	wǒ
吓我一跳	xià wǒ yī tiào
拧	níng
呕吐	ǒutù
呕	ǒu
吐	tù
绦虫	tāochóng
绦	dítāo
虫	chóng
料子	liàozi
圈外人	quānwàirén
浪漫的	làngmàn de
地标	dìbiāo
标	biāo
袍	páo
浴	yù
浴袍	yùpáo
亭子	tíngzi
亭	tíng
威	wēi
望	wàng
威望	wēiwàng
献	xiàn
文献	wénxiàn
直径	zhíjìng
径	jìng
忠	zhōng
忠实	zhōngshí
罪	zuì
罪犯	zuìfàn
冰激凌	bīngjīlíng
凌	líng
告	gào
被告	bèigào
去年	qùnián
出去	chūqù
昨	zuó
昨天	zuótiān
不停	bùtíng
宠	chǒng
宠物	chǒngwù
一节课	yījiékè
课	kè
不值	bùzhí
值	zhí
背叛	bèipàn
叛	pàn
背	bèi
次要	cìyào
要	yào
次	cì
说	shuō
错	cuò
说错	shuōcuò
东亚	dōngyà
客	kè
乘客	chéngkè
乘	chéng
蓝莓	lánméi
莓	méi
鸡	jī
煎鸡蛋	jiān jīdàn
煎	jiān
北	běi
东北	dōngběi
东南	dōngnán
辞职	cízhí
辞	cí
职	zhí
公里	gōnglǐ
补救	bǔjiù
救	jiù
补	bǔ
此	cǐ
此次	cǐcì
爱说话	ài shuōhuà
盒	hé
盒子	hézi
今年	jīnnián
一张图片	yīzhāng túpiàn
图	tú
豪	háo
豪华	háohuá
苍	cāng
苍白	cāngbái
忘记	wàngjì
忘	wàng
赌博	dǔbó
酱油	jiàngyóu
明年	míngnián
杯	bēi
世	shì
世界杯	shìjièbēi
戴	dài
口	kǒu
戴口罩	dài kǒuzhào
罩	zhào
男	nán
男朋友	nánpéngyou
朋	péng
随	suí
跟	gēn
跟随	gēnsuí
美丽	měilì
运	yùn
好运	hǎoyùn
上次	shàngcì
有美感	yǒu měigǎn
感	gǎn
古典	gǔdiǎn
古	gǔ
坏	huài
惯	guàn
坏习惯	huàixíguàn
习	xí
极其	jíqí
其	qí
海湾	hǎiwān
渐	jiānjiàn
渐渐	jiànjiàn
下次	xiàcì
坝	bà
堤坝	dībà
堤	dī
脚	jiǎo
脚印	jiǎoyìn
工作计划	gōngzuò jìhuà
作	zuō
划	huá
计	jì
勤	qín
通勤	tōngqín
上周	shàngzhōu
恶	ěèwù
恶化	èhuà
考场	kǎochǎng
百度地图	bǎidù dìtú
秘书	mìshū
空军	kōngjūn
挺好	tǐnghǎo
挺	tǐng
来	lái
进这里来	jìn zhèlǐ lái
西北	xīběi
西南	xīnán
民主	mínzhǔ
时	shí
时区	shí qū
辐	fú
射	shè
辐射	fúshè
下周	xiàzhōu
抢救	qiǎngjiù
抢	qiǎng
有毒	yǒu dú
刷	shuā
红肉橙	hóngròu chéng
迦	jiā
释迦果	shìjiā guǒ
释	shì
热水	rèshuǐ
落	làlàoluò
伞	sǎn
降落伞	jiàngluòsǎn
降	jiàngxiáng
童	tóng
童年	tóngnián
搜	sōu
喷	pēnpèn
打喷嚏	dǎpēntì
嚏	tì
地理	dìlǐ
天文	tiānwén
梦	mèng
噩	è
噩梦	èmèng
后	hòu
后勤	hòuqín
软化	ruǎnhuà
软	ruǎn
火药	huǒyào
角	jiǎo
包	bāo
牛角包	niújiǎo bāo
单词卡	dāncí kǎ
单	shàndān
民法	mínfǎ
水很深	shuǐ hěn shēn
深	shēn
很	hěn
形容词	xíngróngcí
容	róng
形	xíng
溅	jiàn
了	le
没事了	méishì le
事	shì
志	zhì
志愿者	zhìyuànzhě
劳	láo
驾	jià
劳驾	láojià
高	gāo
心水很高	xīnshuǐ hěn gāo
逐	zhú
逐渐	zhújiàn
影	yǐng
星	xīng
影星	yǐngxīng
游	yóu
游人	yóurén
服	fúfù
佩服	pèifu
佩	pèi
宇	yǔ
宇航员	yǔhángyuán
家庭教育	jiātíngjiàoyù
育	yù
庭	tíng
助理	zhùlǐ
助	zhù
院	yuàn
庭院	tíngyuàn
自愿	zìyuàn
澳	ào
澳大利亚	àodàlìyà
充	chōng
扩	kuò
扩充	kuòchōng
蜓	tíng
蜻	qīng
蜻蜓	qīngtíng
程	chéng
碑	bēi
里程碑	lǐchéngbēi
礼节	lǐjié
早点	zǎodiǎn
早	zǎo
领事馆	lǐngshìguǎn
领土	lǐngtǔ
犹太会堂	yóutài huìtáng
冒犯	màofàn
冒	mào
徒	tú
督	dū
基督徒	jīdūtú
排	pái
前	qián
前排	qiánpái
坦	tǎn
巴勒斯坦	bālèsītǎn
巴	bā
勒	lèlēi
梯	tī
扶手电梯	fúshǒu diàntī
扶	fú
蟑	zhāng
蟑螂	zhāngláng
螂	láng
频率	pínlǜ
率	lǜshuài
有效果	yǒu xiàoguǒ
没效果	méi xiàoguǒ
瀑布	pùbù
瀑	bàopù
布	bù
息	xī
有出息	yǒu chūxi
一台手机	yītái shǒujī
莱	lái
好莱坞	hǎoláiwù
坞	wù
筛选	shāixuǎn
选	xuǎn
筛	shāi
忘性很大	wàngxìng hěndà
士	shì
绅士	shēnshì
绅	shēn
阿根廷	āgēntíng
根	gēn
阿	āāē
廷	tíng
通货膨胀	tōnghuòpéngzhàng
膨	péng
胀	zhàng
货	huò
相差	xiāngchà
相	xiāngxiāngxiàng
差	chà
崭新	zhǎnxīn
崭	chánzhǎn
庄	zhuāng
庄稼	zhuāngjia
稼	jià
半决赛	bànjuésài
决	jué
疤	bā
必	bì
必将	bìjiāng
将	jiāngjiàngqiāng
出生	chūshēng
免	miǎn
不免	bùmiǎn
排队	páiduì
弹	dàntán
弹钢琴	tángāngqín
琴	qín
处	chǔchù
到处	dàochù
两	liǎng
两年后	liǎngnián hòu
大海	dàhǎi
你身边	nǐ shēnbiān
身	shēn
你	nǐ
单调	dāndiào
调	diàotiáo
州	zhōu
加州	jiāzhōu
昌	chāng
昌盛	chāngshèng
地震	dìzhèn
震	zhèn
春	chūn
春季	chūnjì
展	zhǎn
车展	chēzhǎn
版	bǎn
出版	chūbǎn
煮鸡蛋	zhǔ jīdàn
煮	zhǔ
厨师	chúshī
厨	chú
大奖赛	dàjiǎngsài
奖	jiǎng
放音乐	fàng yīnyuè
胖	pàng
进来	jìnlái
诞生	dànshēng
楼	lóu
楼下	lóuxià
退	tuì
撤	chè
撤退	chètuì
多媒体	duōméitǐ
零下	língxià
零	líng
儿科	érkē
科	kē
鸭	yā
烤鸭	kǎoyā
一共	yígòng
高价	gāojià
个体	gètǐ
控制	kòngzhì
制	zhì
控	kòng
女朋友	nǚpéngyou
米	mǐ
毫米	háomǐ
毫	háo
毫升	háoshēng
升	shēng
呼	hū
呼吸	hūxī
广阔	guǎngkuò
阔	kuò
全部	quánbù
部	bù
全	quán
他	tā
他们	tāmen
观	guànguānguàn
主观	zhǔguān
纪	jǐjì
纪律	jìlǜ
序	xù
程序员	chéngxùyuán
护	hù
导航	dǎoháng
北方人	běifāng rén
南方人	nánfāngrén
监测	jiāncè
测	cè
离婚	líhūn
婚	hūn
离	lí
学习计划	xuéxí jìhuà
厘	lí
厘米	límǐ
岸	àn
东岸	dōngàn
西岸	xīàn
收到	shōudào
收	shōu
轮	lún
轮椅	lúnyǐ
要是	yàoshi
谷	gǔ
谷歌地图	gǔgē dìtú
它们	tāmen
南极	nánjí
问	wèn
询问	xúnwèn
询	xún
再	zài
一再	yízài
泥	nínì
上个月	shànggèyuè
如下	rúxià
诗人	shīrén
诗	shī
舒适	shūshì
舒	shū
适	kuòshìshì
西柚	xīyòu
柚	yòu
池	chí
塘	táng
池塘	chítáng
伤口	shāngkǒu
伤	shāng
长大	zhǎngdà
双手	shuāngshǒu
双	shuāng
四周	sìzhōu
随后	suíhòu
中年	zhōngnián
卫	wèi
卫衣	wèiyī
脑	nǎo
一台电脑	yītái diànnǎo
一对一	yīduìyī
喉	hóu
咙	lóng
喉咙	hóulóng
下个月	xiàgèyuè
相比	xiāngbǐ
唯一	wéiyī
唯	wéiwěi
化肥	huàféi
效率	xiàolǜ
真实	zhēnshí
锅	guō
平底煎锅	píngdǐ jiānguō
平	píng
底	dǐ
践	jiàn
践踏	jiàntà
踏	tātà
一代	yīdài
冷笑话	lěng xiào huà
搬到	bān dào
搬	bān
校外	xiàowài
甲	jiǎ
指甲	zhǐjia
再那块儿	zài nà kuàir
块	kuài
南极洲	nánjízhōu
懒惰	lǎnduò
惰	duò
祖国	zǔguó
祖	zǔ
抢工作	qiǎng gōngzuò
良心	liángxīn
良	liáng
封	fēng
密封	mìfēng
击	jī
枪	qiāng
枪击案	qiāngjīàn
案	àn
百分比	bǎifēnbǐ
气色	qìsè
谈	tán
洽	qià
洽谈	qiàtán
尖脸	jiānliǎn
脸	liǎn
尖	jiān
日常生活	rìchángshēnghuó
敲	qiāo
敲字	qiāozì
妆	zhuāng
药妆店	yàozhuāngdiàn
幅	fú
画	huà
一幅画	yīfú huà
寨	zhài
山寨品	shānzhài pǐn
生理	shēnglǐ
火警	huǒjǐng
警	jǐng
镇静	zhènjìng
镇	zhèn
每	měi
半年	bànnián
悲	bēi
悲观	bēiguān
比如说	bǐrúshuō
别	bié
别的	biéde
潮湿	cháoshī
潮	cháo
薄弱	bóruò
弱	ruò
薄	bó
不在乎	bùzàihu
乎	hū
做好	zuòhǎo
做	zuò
净	jìng
干	gān
干净	gānjìng
刮风	guāfēng
刮	guā
地毯	dìtǎn
记得	jìde
生病	shēngbìng
蒸鸡蛋	zhēng jīdàn
蒸	zhēng
各	gè
理论上说	lǐlùn shàng shuō
论	lúnlùn
籍	jí
国籍	guójí
果汁	guǒzhī
汁	zhī
队员	duìyuán
厅	tīng
大厅	dàtīng
此事	cǐshì
加油站	jiāyóuzhàn
数学	shùxué
柴	chái
柴油	cháiyóu
分类	fēnlèi
类	lèi
分离	fēnlí
信用卡	xìnyòngkǎ
开	kāi
隔开	gékāi
隔	gé
迟	chí
疑	yí
迟疑	chíyí
电子表格	diànzibiǎogé
脆	cuì
脆弱	cuìruò
旅游计划	lǚyóu jìhuà
旅	lǚ
塑	sù
袋	dài
塑料袋	sùliàodài
项	xiàng
待	dāidài
待办事项	dàibàn shìxiàng
办	bàn
陡峭	dǒuqiào
峭	qiào
陡	dǒu
全体	quántǐ
戏	xì
打游戏	dǎyóuxì
惊人	jīngrén
立即	lìjí
即	jí
立	lì
性别	xìngbié
财	cái
发财	fācái
发	fā
开通	kāitōngkāitong
坐	zuò
坐下	zuòxia
营	yíng
夏令营	xiàlìngyíng
手臂	shǒubì
闹钟	nàozhōng
闹	nào
样	yàng
样式	yàngshì
坟	fén
墓	mù
坟墓	fénmù
期末	qīmò
炸	zházhà
油炸	yóuzhá
馒头	mántou
馒	mán
拼	pīn
检	jiǎn
拼写检查	pīnxiě jiǎnchá
查	zhāchá
一架飞机	yījià fēijī
架	jià
一楼	yīlóu
一把伞	yībǎ sǎn
接她下班	jiē tā xiàbān
商	shāng
从商	cóngshāng
位	wèi
工位	gōngwèi
亿	yì
树叶	shùyè
这次爬山	zhècì páshān
爬	pá
体重	tǐzhòng
重	zhòng
溉	gài
灌溉	guàngài
灌	guàn
岁月	suìyuè
岁	suì
太空	tàikōng
天然气	tiānránqì
系列	xìliè
系	xì
亚运会	yàyùnhuì
乌	wū
云	yún
乌云	wūyún
X	-
X以上	x yǐshàng
坚硬	jiānyìng
坚	jiān
整	zhěng
整整	zhěngzhěng
简	jiǎn
简化	jiǎnhuà
豫	yù
犹豫	yóuyù
泡	pāopào
泡茶	pàochá
断	duàn
诊	zhěn
诊断	zhěnduàn
园地	yuándì
局部	júbù
局	jú
刊物	kānwù
刊	kān
考古	kǎogǔ
菜市场	càishìchǎng
菜	cài
醉	zuì
空白	kòngbái
腔	qiāng
口腔	kǒuqiāng
风铃	fēnglíng
铃	líng
思想开放	sīxiǎngkāifàng
思	sī
塔	tǎ
白塔	báitǎ
中东	zhōngdōng
一家三口	yījiā sānkǒu
让	ràng
让人分心	ràng rén fēnxīn
收起来	shōu qǐlai
气味	qìwèi
侈	chǐ
奢侈品	shēchǐpǐn
奢	shē
解	xièjiějièxiè
溶	róng
溶解	róngjiě
新西兰	xīnxīlán
乡	xiāng
野	yě
郊	jiāo
乡郊野外	xiāng jiāoyě wài
揉	róu
揉面团	róu miàntuán
坍塌	tāntā
塌	tā
坍	tān
龙	lóng
水龙头	shuǐlóngtóu
天主教	tiānzhǔjiào
性丑闻	xìngchǒuwén
丑	chǒu
闻	wén
巷	xiàng
寻	xún
寻觅	xúnmì
觅	mì
挣扎	zhēngzhá
挣	zhèng
扎	zhā
主权	zhǔquán
权	quán
自发	zìfā
冰雪	bīngxuě
付	fù
付钱	fùqián
道歉	dàoqiàn
歉	qiàn
迎	yíng
非常欢迎	fēicháng huānyíng
欢	huān
但是	dànshì
但	dàn
搭	dā
定	dìng
固定搭配	gùdìng dāpèi
心理状态	xīnlǐ zhuàngtài
状	zhuàng
并非	bìngfēi
并	bìngbìngbīng
风险	fēngxiǎn
险	xiǎn
二	èr
二十年	èrshínián
鼓	gǔ
鼓励	gǔlì
回	huí
回到	huídào
当天	dāngtiāndàngtiān
发怒	fānù
发言人	fāyánrén
法庭	fǎtíng
你们	nǐmen
庆	qìng
国庆	guóqìng
前男友	qiánnányǒu
爱干净	ài gānjìng
港口	gǎngkǒu
港	gǎng
艾	àiàiyì
艾特	ài tè
特	tè
别的事情	biéde shìqing
蓝色	lánsè
成年人	chéngniánrén
交费	jiāofèi
微	wēi
稍	shāoshào
稍微	shāowēi
宏大	hóngdà
宏	hóng
庆祝	qìngzhù
看成	kànchéng
丢	diū
丢人	diūrén
全家	quánjiā
裁	cái
独裁	dúcái
老婆	lǎopó
婆	pó
暖心	nuǎnxīn
德国猪肘	déguó zhūzhǒu
德	dé
猪	zhū
葡萄酒	pútaojiǔ
盲	máng
盲人	mángrén
愿望	yuànwàng
面对面	miànduìmiàn
秋季	qiūjì
秋	qiū
拿走	názǒu
拿	ná
电动汽车	diàndòngqìchē
陪同	péitóng
陪	péi
平方米	píngfāngmǐ
一条裙子	yītiáo qúnzi
散文	sǎnwén
散	sǎnsàn
企业家	qǐyèjiā
企	qǐ
一点点	yīdiǎndiǎn
摄像	shèxiàng
摄	shè
吃的	chīde
吃	chī
缺陷	quēxiàn
陷	xiàn
缺	quē
能力很差	nénglì hěnchā
热水器	rèshuǐqì
器	qì
人权	rénquán
正是	zhèngshì
正	zhèng
棒	bàng
棒球棒	bàngqiúbàng
时节	shíjié
航天	hángtiān
组长	zǔzhǎng
司长	sīzhǎng
西部	xībù
阳	yáng
太阳能	tàiyángnéng
熟	shú
熟成	shúchéng
么	mámame
没那么乱	méi nàme luàn
胸部	xiōngbù
焰	yàn
火焰	huǒyàn
外头	wàitou
糊	hú
杏仁糊	xìngrén hú
芝麻糊	zhīmahú
麻	má
芝	zhī
爱情片	àiqíngpiān
刑法	xíngfǎ
刑	xíng
仅	jǐn
仅仅因为	jǐnjǐn yīnwèi
因	yīn
剧	jù
加剧	jiājù
共同爱好	gòngtóngàihǎo
共同敌人	gòngtóng dírén
敌	dí
一带	yīdài
带	dài
小于	xiǎoyú
于	yú
写字台	xiězìtái
薪水	xīnshui
薪	xīn
原料	yuánliào
原	yuán
僵硬	jiāngyìng
僵	jiāng
古罗马	gǔluómǎ
马	mǎ
角落	jiǎoluò
阶层	jiēcéng
层	céng
阶	jiē
口头	kǒutóu
种	zhǒng
种种	zhǒngzhǒng
牢固	láogù
牢	láo
灵	líng
灵魂	línghún
魂	hún
勉	miǎn
勉励	miǎnlì
打印出来	dǎyìn chūlái
后排	hòupái
租房子	zūfángzi
最	zuì
最低工资	zuìdīgōngzī
资	zī
低	dī
直男	zhí nán
迫害	pòhài
害	hài
迫	pǎipò
一套房子	yītào fángzi
帜	zhì
旗	qí
旗帜	qízhì
内在美	nèizàiměi
对…敏感	duì  mǐngǎn
…	-
敏	mǐn
缺席	quēxí
席	xí
养	yǎng
养老院	yǎnglǎoyuàn
柔	róu
柔和	róuhé
撒谎	sāhuǎng
撒	sāsǎ
谎	huǎng
时代广场	shídàiguǎngchǎng
开派对	kāi pàiduì
堕落天使	duòluò tiānshǐ
堕	duò
事项	shìxiàng
书籍	shūjí
剔	tī
挑剔	tiāoti
挑	tiāotiǎo
芥	gàijiè
芥菜种	jiècài zhǒng
家族	jiāzú
族	zú
投降	tóuxiáng
投	tóu
种姓制度	zhǒngxìng zhìdù
姓	xìng
推翻	tuīfān
推	tuī
翻	fān
座	zuò
座右铭	zuòyòumíng
铭	míng
右	yòu
唉	āi
有面子	yǒu miànzi
宝宝	bǎobao
宝	bǎo
北部	běibù
小费	xiǎofèi
长途	chángtú
公斤	gōngjīn
斤	jīn
从而	cóng’ér
米饭	mǐfàn
火车站	huǒchēzhàn
登机牌	dēngjīpái
牌	pái
登	dēng
过去	guòqu
过	guò
车主	chēzhǔ
长假	chángjià
动画片	dònghuàpiàn
休息	xiūxi
休	xiū
车牌	chēpái
快	kuài
快乐	kuàilè
际	jì
国际	guójì
古代	gǔdài
皮鞋	píxié
大米	dàmǐ
大赛	dàsài
好久	hǎojiǔ
久	jiǔ
陈旧	chénjiù
旧	jiù
陈	chén
生日卡	shēngrìkǎ
困	kùn
钱包	qiánbāo
千与千寻	qiānyǔqiānxún
与	yǔ
岗	gǎng
岗位	gǎngwèi
公鸡	gōngjī
我不确定	wǒ bù quèdìng
确	què
汇率	huìlǜ
赔	péi
赔偿	péicháng
偿	cháng
肌	jī
肌肉	jīròu
猎	liè
打猎	dǎliè
核	hé
核心	héxīn
名单	míngdān
洪水	hóngshuǐ
洪	hóng
健	jiàn
健全	jiànquán
机动车	jīdòngchē
生动	shēngdòng
做好工作	zuòhǎo gōngzuò
税	shuì
大便事项	dàbiàn shìxiàng
便	biàn
工作顺利	gōngzuò shùnlì
顺	shùn
朗	lǎng
朗读	lǎngdú
着火	zháohuǒ
旅行社	lǚxíngshè
社	shè
男子	nánzǐ
管	guǎn
看管	kānguǎn
南部	nánbù
没想到	méixiǎngdào
题	tí
考题	kǎotí
评	píng
谷歌点评	gǔgē diǎnpíng
女子	nǚzǐ
休息室	xiūxīshì
清晨	qīngchén
晨	chén
奶粉	nǎifěn
粉	fěn
如今	rújīn
难	nán
难忘	nánwàng
送	sòng
送她回家	sòng tā huíjiā
为她想	wéi tā xiǎng
厦	xiàshà
高楼大厦	gāolóudàshà
索	suǒ
擎	qíng
搜索引擎	sōusuǒyǐnqíng
引	yǐn
在街上	zài jiēshang
丁	dīng
拉丁美洲	lādīngměizhōu
向我跑来	xiàng wǒ pǎo lái
飯制	-
飯	-
急救箱	jíjiùxiāng
特价	tèjià
越	yuè
越来越	yuèláiyuè
省钱	shěngqián
省	shěng
市民	shìmín
死亡	sǐwáng
死	sǐ
亡	wáng
腥	xīng
又爱又恨	yòu ài yòu hèn
恨	hèn
又	yòu
票	piào
投票	tóupiào
学分	xuéfēn
学年	xuénián
骗	piàn
“	-
“照骗”	“ zhàopiàn ”
”	-
吧	ba
网吧	wǎngbā
急剧	jíjù
吸毒	xīdú
戏曲	xìqǔ
共同朋友	gòngtóng péngyou
共同生活	gòngtóng shēnghuó
戒指	jièzhi
戒	jiè
心脏病	xīnzàngbìng
脏	zāng
远	yuǎn
远处	yuǎnchù
口音	kǒuyin
流泪	liúlèi
公厕	gōngcè
厕	cèsì
挣钱	zhèngqián
缘故	yuángù
缘	yuán
故	gù
晕	yūn
晕车	yùnchē
周期	zhōuqī
生活习惯	shēnghuóxíguàn
北美洲	běiměizhōu
南美洲	nánměizhōu
邮	yóu
邮差	yóuchāi
军事基地	jūnshìjīdì
垄	lǒng
垄断	lǒngduàn
狗	gǒu
遛	liù
遛狗	liùgǒu
社会问题	shèhuì wèntí
门	mén
推开门	tuīkāi mén
日食	rìshí
秘密武器	mìmìwǔqì
武	wǔ
参加活动	cānjiā huódòng
参	cāncēnshēn
澈	chè
清澈	qīngchè
过分了	guòfèn le
情理	qínglǐ
梢	shāo
视线	shìxiàn
线	xiàn
合	gěhé
合唱团	héchàngtuán
新教	xīnjiào
悦	yuè
喜	xǐ
喜悦	xǐyuè
愚	yú
蠢	chǔn
愚蠢	yúchǔn
元	yuán
元首	yuánshǒu
烈	liè
壮烈	zhuàngliè
壮	zhuàng
办事处	bànshìchù
悲伤	bēishāng
迟到	chídào
本事	běnshi
到他跟前	dào tā gēnqian
城	chéng
长城	chángchéng
唱歌	chànggē
变	biàn
变为	biànwéi
传真	chuánzhēn
财富	cáifù
富	fù
彩	cǎi
彩票	cǎipiào
匆忙	cōngmáng
匆	cōng
酷	kù
残	cán
残酷	cánkù
差距	chājù
距	jù
甭	béng
迸	bèng
迸发	bèngfā
对我很好	duì wǒ hěn hǎo
成效	chéngxiào
纯净水	chúnjìngshuǐ
纯	chún
愁	chóu
炒	chǎo
炒鸡蛋	chǎojīdàn
地铁站	dìtiězhàn
手控	shǒu kòng
多数	duōshù
传言	chuányán
回家	huíjiā
说真话	shuō zhēnhuà
的确	díquè
开车	kāi chē
花钱	huāqián
减	jiǎn
减肥	jiǎnféi
或	huò
许	xǔ
或许	huòxǔ
插座	chāzuò
燕	yānyàn
隔夜燕麦	géyè yànmài
简直	jiǎnzhí
法制	fǎzhì
印度菜	yìndù cài
丰	fēng
丰收	fēngshōu
握手	wòshǒu
握	wò
飞行员	fēixíngyuán
迟缓	chíhuǎn
缓	huǎn
峰会	fēnghuì
峰	fēng
一双眼睛	yīshuāng yǎnjīng
父	fù
父子	fùzǐ
更是	gèngshì
更	gèng
其次	qícì
机器人	jīqìrén
步	bù
脚步	jiǎobù
家园	jiāyuán
讲课	jiǎngkè
讲	jiǎng
节假日	jiéjiàrì
球鞋	qiúxié
联合国	liánhéguó
具	jù
玩具	wánjù
繁忙	fánmáng
繁	fán
美金	měijīn
匙	chíshi
钥	yuè
钥匙	yàoshi
也许	yěxǔ
也	yě
相似	xiāngsì
似	shìsì
男士	nánshì
培训班	péixùnbān
训	xùn
培	péi
流感	liúgǎn
平稳	píngwěn
稳	wěn
勇	yǒng
勇气	yǒngqì
元旦	uándàn
旦	dàn
膜	mó
作者	zuòzhě
主题	zhǔtí
上楼	shànglóu
紫	zǐ
厚	hòu
深厚	shēnhòu
起点	qǐdiǎn
石油	shíyóu
扇子	shànzi
扇	shānshàn
睡着	shuìzháo
睡	shuì
操	cāo
操心	cāoxīn
董	dǒng
古董	gǔdǒng
乳制品	rǔzhìpǐn
乳	rǔ
山谷	shāngǔ
怎	zěn
怎样	zěnyàng
数目	shùmù
目	mù
伤员	shāngyuán
知	zhī
通知书	tōngzhīshū
深深	shēnshēn
聚	jù
生日聚会	shēngrì jùhuì
果断	guǒduàn
滨	bīn
海滨	hǎibīn
泰	tài
泰国	tàiguó
题材	tícái
材	cái
没礼貌	méi lǐmào
貌	mào
滑	huá
轮滑	lúnhuá
阳台	yángtái
严	yán
厉	lì
严厉	yánlì
细胞	xìbāo
胞	bāo
细	xì
支付	zhīfù
简要	jiǎnyào
用来	yònglái
希	xī
腊	xīlà
古希腊	gǔxīlà
资金	zījīn
再也	zàiyě
之内	zhīnèi
健身房	jiànshēnfáng
职能	zhínéng
中毒	zhòngdú
宽敞	kuānchang
敞	chǎng
疼爱	téng’ài
黎明	límíng
黎	lí
接待客人	jiēdàikèrén
少数族裔	shǎoshù zúyì
裔	yì
一年四季	yīniánsìjì
碌	liùlù
忙碌	mánglù
气候变化	qìhòubiànhuà
候	hòu
疲	pí
疲倦	píjuàn
倦	juàn
张个儿	zhāng gèr
跌	diē
股票跌了	gǔpiào diē le
股	gǔ
象	xiàng
乱象	luànxiàng
入	rù
输	shū
输入密码	shūrù mìmǎ
散布	sànbù
山脊	shānjǐ
脊	jǐ
日剧	rìjù
游乐园	yóulèyuán
温带	wēndài
嗅觉	xiùjué
觉	jiàojué
嗅	xiù
血压	xuèyā
舆	yú
舆论	yúlùn
招标	zhāobiāo
招	zhāo
主义	zhǔyì
办学	bànxué
奥秘	àomì
奥	ào
呢	ne
叉子	chāzi
叉	chācháchǎ
常用	chángyòng
所	suǒ
场所	chǎngsuǒ
疾	jí
残疾人	cánjírén
充电器	chōngdiànqì
滴	dī
初	chū
初级	chūjí
级	jí
健康	jiànkāng
康	kāng
窗帘	chuānglián
帘	lián
留学	liúxué
留	liú
方便面	fāngbiànmiàn
空气	kōngqì
公平	gōngpíng
大脑	dànǎo
寒	hán
寒假	hánjià
豆腐	dòufu
腐	fǔ
练	liàn
操练	cāoliàn
低温	dīwēn
坚强	jiānqiáng
歌迷	gēmí
迷	mí
中国菜	zhōngguó cài
篮球队	lánqiúduì
篮	lán
饮	yǐnyìn
饮料	yǐnliào
高铁	gāotiě
和平	hépíng
列车	lièchē
丑恶	chǒu’è
舶	bó
船	chuán
船舶	chuánbó
雄	xióng
雌雄	cíxióng
雌	cí
次序	cìxù
我睡了	wǒ shuì le
获	huò
获奖	huòjiǎng
国歌	guógē
圣	kūshèng
圣诞快乐	shèngdànkuàilè
过后	guòhòu
势	shì
趋势	qūshì
趋	qū
明星	míngxīng
适合	shìhé
难看	nánkàn
顺序	shùnxù
平等	píngděng
年末	niánmò
快活	kuàihuo
金钱	jīnqián
泪水	lèishuǐ
这边	zhèbiān
日报	rìbào
相同	xiāngtóng
酒水	jiǔshuǐ
就算	jiùsuàn
就	jiǜ
美好	měihǎo
盐	yán
美女	měinǚ
农民	nóngmín
农	nóng
名片	míngpiàn
字面意思	zìmiàn yìsi
强烈	qiángliè
打开窗子	dǎkāi chuāngzi
丰盛	fēngshèng
亲	qīnqìng
亲密	qīnmì
咨询室	zīxúnshì
咨	zī
一把钥匙	yībǎ yàoshi
一条裤子	yītiáo kùzi
商标	shāngbiāo
公道	gōngdao
清洁	qīngjié
收费	shōufèi
骤	zhòu
步骤	bùzhòu
迟早	chízǎo
山峰	shānfēng
棍	gùn
板棍	bǎngùn
图案	tú’àn
柔道棕带	róudào zōngdài
集	jí
集训课	jíxùn kè
下面	xiàmiàn
农贸市场	nóngmàoshìchǎng
贸	mào
花蕾	huālěi
蕾	lěi
向前	xiàngqián
招待客人	zhāodài kèrén
一方面	yīfāngmiàn
基因	jīyīn
物品	wùpǐn
菌	jūnjùn
细菌	xìjūn
蜜月期	mìyuè qī
蜜	mì
慢性病	mànxìngbìng
赢得	yíngdé
赢	yíng
有限	yǒuxiàn
写字楼	xiězìlóu
泡面	pàomiàn
译	yì
翻译笔	fānyì bǐ
佬	lǎo
基佬	jī lǎo
零件	língjiàn
远远	yuǎnyuǎn
欧	ōu
欧元	ōuyuán
梳	shū
梳子	shūzi
终	zhōng
最终	zuìzhōng
中美洲	zhōngměizhōu
秒	miǎo
最后一秒	zuìhòu yīmiǎo
辽	liáo
辽阔	liáokuò
生活质量	shēnghuó zhìliàng
美满	měimǎn
满	mǎn
执照	zhízhào
执	zhí
展示能力	zhǎnshì nénglì
示	shì
瑜	yú
伽	jiā
瑜伽	yújiā
偏差	piānchā
偏	piān
偏见	piānjiàn
品德	pǐndé
造句	zàojù
造	zào
句	jù
高颧骨	gāoquángǔ
颧	quán
骨	gǔ
咬	yǎo
咬肌	yǎo jī
劫	jié
抢劫	qiǎngjié
村里	cūnlǐ
清晰	qīngxī
晰	xī
深情厚谊	shēnqíng-hòuyì
谊	yì
舔	tiǎn
外行	wàiháng
蔚	yùwèi
蔚蓝	wèilán
乌黑	wūhēi
物资	wùzī
欣	xīn
欣慰	xīnwèi
慰	wèi
刑事	xíngshì
遥	yáo
遥远	yáoyuǎn
衣裳	yīshang
英明	yīngmíng
债	zhài
债券	zhàiquàn
券	quàn
种族	zhǒngzú
百分点	bǎifēndiǎn
闭	bì
幕	mù
闭幕式	bìmùshì
不要	bùyào
边境	biānjìng
境	jìng
拨打	bōdǎ
拨	bō
趣	qù
兴	xīngxīngxìng
感兴趣	gǎnxìngqù
侧	cèzhāi
大多数	dàduōshù
厂	hǎnchǎng
厂长	chǎngzhǎng
边界	biānjiè
促	cù
促销	cùxiāo
销	xiāo
动物园	dòngwùyuán
好听	hǎotīng
此时	cǐshí
赶	gǎn
赶快	gǎnkuài
动人	dòngrén
胆小	dǎnxiǎo
责	zé
负责人	fùzérén
低于	dīyú
加班	jiābān
杂	zá
嘈杂	cáozá
嘈	cáo
地下室	dìxiàshì
好事	hǎoshìhàoshì
法官	fǎguān
阅读	yuèdú
阅	yuè
都	dōu
都市	dūshì
正式	zhèngshì
高温	gāowēn
挚	zhì
诚挚	chéngzhì
证	zhèng
办签证	bàn qiānzhèng
签	qiān
中文	zhōngwén
请进	qǐngjìn
请	qǐng
感人	gǎnrén
免费	miǎnfèi
过于	guòyú
脱帽子	tuō màozi
脱	tuō
华语	huáyǔ
孤独	gūdú
里头	lǐtou
火腿	huǒtuǐ
氛	fēn
气氛	qìfēn
技巧	jìqiǎo
巧	qiǎo
技	jì
海外	hǎiwài
合约	héyuē
驾照	jiàzhào
权力	quánlì
炒蔬菜	chǎo shūcài
蔬	shū
感恩节	gǎnēnjié
恩	ēn
紧	jǐn
紧紧	jǐnjǐn
近来	jìnlái
近	jìn
开幕式	kāimùshì
手工	shǒugōng
客户	kèhù
快递	kuàidì
递	dì
丝绸	sīchóu
绸	chóu
丝	sī
绝	jué
杜	dù
杜绝	dùjué
人数	rénshù
脸色	liǎnsè
完整	wánzhěng
逻	luó
逻辑	luóji
辑	jí
看得见	kàndéjiàn
意大利面	yìdàlì miàn
永	yǒng
永远	yǒngyuǎn
依然	yīrán
依	yī
迫切	pòqiè
切	qiē
旅店	lǚdiàn
期中	qīzhōng
接电话	jiēdiànhuà
墨	mò
墨水	mòshuǐ
前方	qiánfāng
益	yì
收益	shōuyì
关	guān
公关	gōngguān
冷萃咖啡	lěngcuì kāfēi
萃	cuì
咖	gākā
啡	fēi
适用	shìyòng
神情	shénqíng
天气预报	tiānqìyùbào
规	guī
规章	guīzhāng
章	zhāng
国防	guófáng
防	fáng
图画	túhuà
识字	shízì
识	shízhì
种菜	zhǒngcài
糖	táng
糖果	tángguǒ
下楼	xiàlóu
化妆	huàzhuāng
天堂	tiāntáng
外币	wàibì
币	bì
应	yīngyīngyìng
应当	yīngdāng
望见	wàngjiàn
急切	jíqiè
西班牙语	xībānyáyǔ
依旧	yījiù
一辈子	yíbèizi
辈	bèi
小麦	xiǎomài
用途	yòngtú
陋	lòu
简陋	jiǎnlòu
月底	yuèdǐ
焦	jiāo
焦急	jiāojí
原有	yuányǒu
紧迫	jǐnpò
音量	yīnliàng
资产	zīchǎn
拢	lǒng
靠拢	kàolǒng
恳切	kěnqiè
恳	kěn
雷达	léidá
雷	léi
达	dá
胃口	wèikǒu
胃	wèi
罪恶	zuìè
作战	zuòzhàn
汉族	hànzú
汉	hàn
原版	yuánbǎn
凄凉	qīliáng
凄	qī
坐牢	zuòláo
足	jùzú
人手不足	rénshǒubùzú
敏感话题	mǐngǎnhuàtí
让你退学	ràng nǐ tuìxué
审理	shěnlǐ
审	shěn
声誉	shēngyù
誉	yù
视力	shìlì
洗	xǐ
洗手液	xǐshǒuyè
律法	lǜfǎ
教会	jiàohuì
往常	wǎngcháng
往	wǎng
委	wěiwēiwěi
委员	wěiyuán
文雅	wényǎ
畜	chùxù
牧	mù
畜牧	xùmù
学说	xuéshuō
样品	yàngpǐn
犹如	yóurú
宇宙	yǔzhòu
宙	zhòu
熨	yùn
嘴	zuǐ
嘴唇	zuǐchún
唇	chún
作息	zuòxī
昂	áng
昂贵	ángguì
例	lì
比例	bǐlì
惨	cǎn
悲惨	bēicǎn
常常	chángcháng
偶遇	ǒu yù
小时	xiǎoshí
妻	qīqì
妻子	qīzi
羊肉	yángròu
羊	yáng
大夫	dàifu
夫	fūfú
短	duǎn
短信	duǎnxìn
长久	chángjiǔ
没关系	méiguānxì
游泳	yóuyǒng
泳	yǒng
带领	dàilǐng
漂	piāopiǎopiào
漂亮	piàoliang
务	wù
财务	cáiwù
爆款	bào kuǎn
爆	bào
地带	dìdài
课文	kèwén
司机	sījī
粥	zhōu
燕麦粥	yànmàizhōu
经济	jīngjì
济	jǐjǐjì
疯	fēng
紧急	jǐnjí
谨	jǐn
谨慎	jǐnshèn
慎	shèn
那里	nàli
法语	fǎyǔ
观看	guānkàn
助手	zhùshǒu
高跟鞋	gāogēnxié
苦	kǔ
吃苦	chīkǔ
肺	fèi
辣椒	làjiāo
辣	là
椒	jiāo
一副眼镜	yīfù yǎnjìng
镜	jìng
副	fù
崇	chóng
崇高	chónggāo
连忙	liánmáng
柜子	guìzi
日期	rìqī
摸	mō
国王	guówáng
然而	rán’ér
旅客	lǚkè
拿到	nádào
患者	huànzhě
患	huàn
难题	nántí
绘画	huìhuà
绘	huì
紧密	jǐnmì
箭	jiàn
鼠标	shǔbiāo
鼠	shǔ
口袋	kǒudài
危险	wēixiǎn
危	wēi
梨	lí
旅馆	lǚguǎn
绝大多数	juédàduōshù
反常	fǎncháng
一群人	yīqún rén
勇敢	yǒnggǎn
敢	gǎn
方言	fāngyán
脖子	bózi
脖	bó
拍照	pāizhào
胖子	pàngzi
骗子	piànzi
粉末	fěnmò
频繁	pínfán
身份证	shēnfènzhèng
座位	zuòwèi
群体	qúntǐ
姿	zī
姿势	zīshì
字幕	zìmù
扶手	fúshǒu
涨	zhǎng
上涨	shàngzhǎng
尬	gà
尷	-
尷尬癌	-
事实	shìshí
公务	gōngwù
时常	shícháng
益虫	yìchóng
日语	rìyǔ
怎么办	zěnmebàn
躲	duǒ
躲起来	duǒqǐlái
球棍	qiúgùn
滤	lǜ
过滤	guòlǜ
时时	shíshí
罕见	hǎnjiàn
罕	hǎn
送礼	sònglǐ
特大	tèdà
新郎	xīnláng
郎	láng
现状	xiànzhuàng
赂	lù
贿	huì
贿赂	huìlù
邮件	yóujiàn
医	yī
疗	liáo
医疗	yīliáo
言语	yányǔyányu
以内	yǐnèi
香菜籽	xiāng càizǐ
由此	yóucǐ
由	yóu
民国时期	mínguóshíqī
冷淡	lěngdàn
淡	dàn
原理	yuánlǐ
一行	yīxíng
英雄	yīngxióng
精确	jīngquè
优质	yōuzhì
优	yōu
敬礼	jìnglǐ
敬	jìng
磕	kē
自治县	zìzhìxiàn
治	zhì
钟头	zhōngtóu
钻	zuānzuàn
文化冲突	wénhuàchōngtū
冲	chòng
突	tū
桥	qiáo
立交桥	lìjiāoqiáo
放烟花	fàng yānhuā
粤	yuè
粤菜	yuècài
挪	nuó
好的关系	hǎo de guānxi
全局	quánjú
坦然	tǎnrán
触动神经	chùdòng shénjīng
哨	shào
画画	huàhuà
呻	shēn
吟	yín
呻吟	shēnyín
垫子	diànzi
垫	diàn
三文鱼	sānwényú
饲养	sìyǎng
饲	sì
索取	suǒqǔ
拔	bá
挺拔	tǐngbá
团圆	tuányuán
圆	yuán
微观	wēiguān
溪	xī
乡镇	xiāngzhèn
眨	zhǎ
摘	zhāi
摘要	zhāiyào
战役	zhànyì
役	yì
支流	zhīliú
做主	zuòzhǔ
小时候	xiǎoshíhou
把手	bǎshou
草	cǎo
打扫	dǎsǎo
学校	xuéxiào
姆	mǔ
保	bǎo
保姆	bǎomǔ
不再	bùzài
打折	dǎzhé
折	zhé
哀	āi
悲哀	bēi’āi
不仅仅	bùjǐnjǐn
水果	shuǐguǒ
衬衣	chènyī
霜	shuāng
涂	tú
晒	shài
涂防晒霜	tú fángshàishuāng
敌人	dírén
儿童	értóng
多亏	duōkuī
亏	kuī
朵	duǒ
打破	dǎpò
破	pò
借	jiè
学习	xuéxí
型	xíng
大型	dàxíng
聊天	liáotiān
聊	liáo
船只	chuánzhī
海洋	hǎiyáng
护士	hùshi
单一	dānyī
裁缝	cáifeng
缝	féngfèng
般	bānpán
一般来说	yībānláishuō
价格	jiàgé
来到	láidào
动机	dòngjī
头发	tóufa
动画	dònghuà
氏	shìzhī
华氏度	huáshìdù
符	fú
符号	fúhào
那边	nàbian
抱	bào
拥	yōng
拥抱	yōngbào
招手	zhāoshǒu
有名	yǒumíng
公告	gōnggào
自己	zìjǐ
己	jǐ
女票	nǚ piào
歌词	gēcí
召	shàozhào
号召	hàozhào
合并	hébìng
能干	nénggàn
摧	cuī
摧残	cuīcán
过新年	guò xīnnián
手机应用	shǒujī yìngyòng
小朋友	xiǎopéngyǒu
火箭	huǒjiàn
伤害	shānghài
我都喜欢	wǒ dōu xǐhuan
类似	lèisì
狂	kuáng
人口	rénkǒu
慕	mù
羡慕	xiànmù
羡	xiàn
相反	xiāngfǎn
二氧化碳	èryǎnghuàtàn
碳	tàn
漫长	màncháng
门诊	ménzhěn
面子	miànzi
防御	fángyù
御	yù
皮包	píbāo
痒	yǎng
疫情	yìqíng
培育	péiyù
抽象意思	chōuxiàng yìsi
运气	yùnqi
敲门	qiāomén
一部电影	yībù diànyǐng
旱	hàn
干旱	gānhàn
心里	xīnli
专家	zhuānjiā
专	zhuān
炮	bāopáopào
忍	rěn
受	shòu
忍受	rěnshòu
宫	gōng
宫殿	gōngdiàn
求职	qiúzhí
求	qiú
英文	yīngwén
英语	yīngyǔ
试图	shìtú
佣	yòngyōng
雇佣	gùyōng
雇	gù
咱	zázán
棍棒	gùnbàng
推销	tuīxiāo
薯	shǔ
薯片	shǔpiàn
水泥	shuǐní
仅供参考	jǐngōngcānkǎo
供	gōnggòng
违反	wéifǎn
违	wéi
瓣	bàn
花瓣	huābàn
相互	xiānghù
掏	tāo
文艺	wényì
聖誕趴	-
趴	pā
聖	-
誕	-
荒谬	huāngmiù
谬	miù
修	xiū
煌	huáng
辉煌	huīhuáng
辉	huī
先前	xiānqián
先	xiān
新型	xīnxíng
学时	xuéshí
演技很好	yǎnjì hěn hǎo
演	yǎn
外观	wàiguān
议	yì
协	xié
协议书	xiéyìshū
外资	wàizī
印刷	yìnshuā
凶手	xiōngshǒu
凶	xiōng
选拔	xuǎnbá
词根	cígēn
缴纳	jiǎonà
纳	nà
缴	jiǎo
结局	jiéjú
结	jiējié
足够	zúgòu
够	gòu
珍珠	zhēnzhū
珠	zhū
真理	zhēnlǐ
之外	zhīwài
吃素	chīsù
盟	méng
欧盟	ōuméng
占据	zhànjù
占	zhàn
卡通	kǎtōng
知名	zhīmíng
政府干部	zhèngfǔ gànbù
政	zhèng
府	fǔ
柱子	zhùzi
柱	zhù
专用	zhuānyòng
冷酷	lěngkù
吻	wěn
人情美	rénqíng měi
小柴胡	xiǎocháihú
胡	hú
山脚	shānjiǎo
聋	lóng
聋哑	lóngyǎ
哑	yāyǎ
掠	lüè
夺	duó
掠夺	lüèduó
主流文化	zhǔliú wénhuà
密度	mìdù
电子产品	diànzichǎnpǐn
锐	ruì
敏锐	mǐnruì
眼影盘	yǎnyǐng pán
拿手	náshǒu
捏	niē
剧透	jùtòu
透	tòu
一般就说	yībān jiù shuō
蜘蛛网	zhīzhūwǎng
圈套	quāntào
擅	shàn
擅自	shànzì
才	cái
才华	cáihuá
有市场	yǒu shìchǎng
金门大桥	jīnméndàqiáo
审判	shěnpàn
判	pàn
省会	shěnghuì
实质	shízhì
兽	shòu
野兽	yěshòu
胎	tāi
双胞胎	shuāngbāotāi
司令	sīlìng
天赋	tiānfù
赋	fù
丸	wán
无非	wúfēi
谢绝	xièjué
谢	xiè
寓言	yùyán
寓	yù
真挚	zhēnzhì
嘱	zhǔ
咐	fù
嘱咐	zhǔfù
按摩	ànmó
按	àn
摩	mó
叫	jiào
百货	bǎihuò
封印	fēng yìn
写完作业	xiě wán zuòyè
不能不	bùnéngbù
采纳	cǎinà
采	cǎicǎicài
当时	dàngshí
欢迎	huānyíng
硬核	yìng hé
独特	dútè
对待	duìdài
法院	fǎyuàn
买	mǎi
冬天	dōngtiān
到达	dàodá
离开	líkāi
隔壁	gébì
船员	chuányuán
逛	guàng
小言	xiǎo yán
短裤	duǎnkù
掌	zhǎng
鼓掌	gǔzhǎng
好像	hǎoxiàng
才干	cáigàn
瓶	píng
瓶子	píngzi
当年	dāngniándàngnián
大道	dàdào
大批	dàpī
批	pī
等级	děngjí
世界	shìjiè
慌	huāng
慌张	huāngzhāng
降落	jiàngluò
地名	dìmíng
干吗	gànmá
吗	ma
罚	fá
坏人	huàirén
举办	jǔbàn
举	jǔ
熊猫	xióngmāo
熊	xióng
反抗	fǎnkàng
抗	kàng
虎	hǔ
老虎	lǎohǔ
拿去	ná qù
购买	gòumǎi
力气	lìqi
父女	fùnǚ
沛	pèi
充沛	chōngpèi
怪	guài
顾问	gùwèn
顾	gù
后年	hòunián
请坐	qǐngzuò
骂	mà
眉	méi
眉毛	méimao
弄	nòng
暖和	nuǎnhuo
入口	rùkǒu
森	sēn
森林	sēnlín
好似	hǎosì
青春	qīngchūn
青	qīng
剪	jiǎn
剪刀	jiǎndāo
汤	tāng
八宝汤	bābǎo tāng
如何	rúhé
软件	ruǎnjiàn
具有	jùyǒu
神秘	shénmì
星期日	xīngqīrì
星期天	xīngqītiān
孙子	sūnzi
孙	sūn
看出	kànchū
乐观	lèguān
输入	shūrù
还没想好	huán méixiǎng hǎo
还	hái
秋天	qiūtiān
预习	yùxí
列为	lièwéi
政治	zhèngzhì
开头	kāitóu
系统	xìtǒng
抗议	kàngyì
肠	cháng
香肠	xiāngcháng
模范	mófàn
模	mómú
虚心	xūxīn
天上	tiānshàng
允许	yǔnxǔ
允	yǔn
陆	lùliùlù
陆军	lùjūn
只要	zhǐyào
妙	miào
夏天	xiàtiān
强迫	qiǎngpò
奶牛	nǎiniú
晴	qíng
晴朗	qínglǎng
钙	gài
身高	shēngāo
如此	rúcǐ
一件衣服	yījiàn yīfú
沙	shā
漠	mò
沙漠	shāmò
收音机	shōuyīnjī
升高	shēnggāo
银行卡	yínhángkǎ
银	yín
虹	hóng
彩虹	cǎihóng
丧失	sàngshī
丧	sàng
罐	guàn
藏	zàngcángzàng
藏起来	cáng qǐlai
听众	tīngzhòng
灾	zāi
水灾	shuǐzāi
设	shè
设计师	shèjìshī
器材	qìcái
中心	zhōngxīn
周年	zhōunián
同行	tónghángtóngxíng
同一	tóngyī
悔恨	huǐhèn
悔	huǐ
选手	xuǎnshǒu
途径	tújìng
吞	tūn
速	sù
迅	xùn
迅速	xùnsù
化学	huàxué
危机	wēijī
刷剧	shuājù
许可	xǔkě
摇	yáo
摇头	yáotóu
一句话	yījùhuà
拥有	yōngyǒu
有着	yǒuzhe
羽绒服	yǔróngfú
绒	róng
搅	jiǎo
拌	bàn
搅拌	jiǎobàn
侥幸	jiǎoxìng
幸	xìng
侥	jiǎoyáo
重量	zhòngliàng
陌生	mòshēng
陌	mò
越南	yuènán
职位	zhíwèi
乐曲	yuèqǔ
伐	fá
砍	kǎn
砍伐	kǎnfá
资本	zīběn
政策	zhèngcè
策	cè
之类	zhīlèi
坑	kēng
治病	zhìbìng
链	liàn
链接	liànjiē
白大褂	báidàguà
褂	guà
廓	kuò
轮廓	lúnkuò
过马路	guò mǎlù
路	lù
情侣	qínglǚ
伸	shēn
拉伸	lāshēn
侵	qīn
侵略	qīnlüè
外貌	wàimào
政府官员	zhèngfǔ guānyuán
准	zhǔn
审美标准	shěnměi biāozhǔn
徙	xǐ
迁徙	qiānxǐ
迁	qiān
外在	wài zài
笔名	bǐmíng
求婚	qiúhūn
弱点	ruòdiǎn
性情	xìngqíng
予	yúyǔ
授	shòu
授予	shòuyǔ
书面	shūmiàn
探测	tàncè
探	tàn
妥	tuǒ
妥善	tuǒshàn
善	shàn
顽固	wángù
无知	wúzhī
向来	xiànglái
耀	yào
耀眼	yàoyǎn
责怪	zéguài
添	tiān
增	zēng
增添	zēngtiān
招收	zhāoshōu
中立	zhōnglì
皱纹	zhòuwén
纹	wén
皱	zhòu
被子	bèizi
漫改	màn gǎi
改	gǎi
报答	bàodá
答	dādá
本地	běndì
屁	pì
打屁股	dǎpìgu
不少	bùshǎo
旁边	pángbiān
旁	páng
复杂	fùzá
丈	zhàng
丈夫	zhàngfu
遍	biàn
遍地	biàndì
抱负	bàofù
午	wǔ
上午	shàngwǔ
报酬	bàochou
酬	chóu
除	chú
除夕	chúxī
夕	xī
学生	xuéshēng
贝	bèi
壳	kéqiào
贝壳	bèikè
潮流	cháoliú
飞机	fēijī
地址	dìzhǐ
址	zhǐ
分开	fēnkāi
发表	fābiǎo
出于	chūyú
城乡	chéngxiāng
波涛	bōtāo
涛	tāo
等待	děngdài
阴	yīn
多云	duōyún
功能	gōngnéng
创意	chuàngyì
创	chuāngchuàng
歌单	gēdān
买菜	mǎicài
裙子	qúnzi
即使	jíshǐ
猴子	hóuzi
猴	hóu
等候	děnghòu
大师	dàshī
课本	kèběn
广场	guǎngchǎng
电饭锅	diànfànguō
过来	guòláiguòlai
刷牙	shuāyá
装	zhuāng
假装	jiǎzhuāng
法规	fǎguī
画家	huàjiā
角度	jiǎodù
摄氏度	shèshìdù
金色	jīnsè
高原	gāoyuán
客观	kèguān
教师	jiàoshī
随便吃吧	suíbiàn chī bā
瓜	guā
巾	jīn
毛巾	máojīn
高峰	gāofēng
面对	miànduì
仔	zīzǐ
牛仔裤	niúzǎikù
农业	nóngyè
她们	tāmen
能量	néngliàng
夹	jiājiájià
旅游攻略	lǚyóu gōnglüè
攻	gōng
社会	shèhuì
晚	wǎn
去世	qùshì
官方灯泡	guānfāng dēngpào
那样	nàyàng
世纪	shìjì
皇	huáng
皇帝	huángdì
回应	huíyìng
稻	dào
稻谷	dàogǔ
剧场	jùchǎng
警告	jǐnggào
居民	jūmín
居	jūjījū
假日	jiàrì
石头	shítou
前年	qiánnián
细节	xìjié
晴天	qíngtiān
课题	kètí
淘	táo
淘气	táoqì
西红柿	xīhóngshì
柿	shì
塞	sāisāisàisè
堵塞	dǔsè
堵	dǔ
列入	lièrù
割	gē
食物	shíwù
许多	xǔduō
煤气	méiqì
冰雕节	bīngdiāo jié
雕	diāo
难度	nándù
聞	-
見	-
喜聞樂見	-
樂	-
驳	bó
反驳	fǎnbó
男性	nánxìng
名人	míngrén
赖	lài
纺	fǎng
纺织	fǎngzhī
农产品	nóngchǎnpǐn
诽	fěi
谤	bàng
诽谤	fěibàng
流量小生	liú liàng xiǎo shēng
否决	fǒujué
否	fǒupǐ
回答问题	huídá wèntí
赚	zhuàn
睁	zhēng
整个	zhěnggè
慧	huì
智慧	zhìhuì
智	zhì
派出	pàichū
尴尬	gāngà
尴	gān
衡	héng
平衡	pínghéng
存	cún
生存	shēngcún
诫	jiè
告诫	gàojiè
胜	shèng
胜利	shènglì
奇妙	qímiào
奇	jīqí
兵	bīng
士兵	shìbīng
源	yuán
根源	gēnyuán
树林	shùlín
熟人	shúrén
书桌	shūzhuō
输出	shūchū
挑选	tiāoxuǎn
照相	zhàoxiàng
痕	hén
迹	jì
痕迹	hénjì
无限	wúxiàn
探索	tànsuǒ
违规	wéiguī
秀	xiù
賣	-
賣家秀	-
行李	xíngli
李	lǐ
徒弟	túdì
弟	dì
浊	zhuó
混浊	hùnzhuó
寻找	xúnzhǎo
机灵	jīling
迎接	yíngjiē
寻求	xúnqiú
延	yán
延伸	yánshēn
以及	yǐjí
增长	zēngzhǎng
共同话题	gòngtónghuàtí
狡	jiǎo
猾	huá
狡猾	jiǎohuá
喵	miāo
喵星人	miāo xīng rén
赏	shǎng
奖赏	jiǎngshǎng
野生	yěshēng
赠	zèng
赠送	zèngsòng
露营	lùyíng
露	lùlòulù
止	zhǐ
阻止	zǔzhǐ
阻	zǔ
炸药	zhàyào
注射	zhùshè
注	zhù
删	shān
删除	shānchú
可口	kěkǒu
筐	kuāng
亏待	kuīdài
自在	zìzai
总部	zǒngbù
总经理	zǒngjīnglǐ
藏族	zàng zú
幸亏	xìngkuī
轮胎	lúntāi
蔓	mánmàn
蔓延	mànyán
雪山	xuěshān
配音	pèiyīn
自私	zìsī
私	sī
展示才华	zhǎnshì cáihuá
破例	pòlì
欺骗	qīpiàn
买方	mǎifāng
逝世	shìshì
逝	shì
守护	shǒuhù
守	shǒu
损坏	sǔnhuài
损	sǔn
唾弃	tuòqì
唾	tuò
弃	qì
峡	xiá
峡谷	xiágǔ
陷阱	xiànjǐng
阱	jǐng
羞耻	xiūchǐ
耻	chǐ
严禁	yánjìn
禁	jīnjìn
预言	yùyán
遭	zāo
殃	yāng
遭殃	zāoyāng
瞻仰	zhānyǎng
仰	yǎng
瞻	zhān
砖	zhuān
宗旨	zōngzhǐ
旨	zhǐ
阻拦	zǔlán
拦	lán
钻石	zuànshí
安静	ānjìng
谁	shéi
悲剧	bēijù
表达	biǎodá
表扬	biǎoyáng
扬	yáng
生日	shēngrì
重新	chóngxīn
粗	cū
粗心	cūxīn
传染	chuánrǎn
染	rǎn
出租车	chūzūchē
长寿	chángshòu
程度	chéngdù
给	gěi
长跑	chángpǎo
长远	chángyuǎn
山火	shānhuǒ
场馆	chǎngguǎn
变迁	biànqiān
出汗	chūhàn
句子	jùzi
崇拜	chóngbài
回去	huíqu
做运动员	zuò yùndòngyuán
冠	guànguānguàn
冠军	guànjūn
光	guāng
光滑	guānghuá
档	dǎngdàng
搭档	dādàng
一年半前	yīnián bànqián
挡	dǎng
电源	diànyuán
典礼	diǎnlǐ
档案	dàng’àn
抵	dǐ
抵抗	dǐkàng
市中心	shìzhōngxīn
疯狂	fēngkuáng
尽快	jǐnkuài
尽	jǐnjìn
高大	gāodà
浪费	làngfèi
个儿	gèr
叫作	jiàozuò
公正	gōngzhèng
古老	gǔlǎo
富人	fùrén
储	chǔ
储备	chǔbèi
含	hán
含有	hányǒu
麦克风	màikèfēng
触犯	chùfàn
工商	gōngshāng
锤	chuí
签证	qiānzhèng
拐	guǎi
书店	shūdiàn
片面	piànmiàn
国产	guóchǎn
果树	guǒshù
仍	réng
仍然	réngrán
勤奋	qínfèn
奋	fèn
怠	dài
怠慢	dàimàn
至	zhì
甚至	shènzhì
甚	shèn
生意	shēngyi
闪	shǎn
闪电	shǎndiàn
新年	xīnnián
时髦	shímáo
髦	máo
空儿	kòngr
杨	yáng
杨红	yánghóng
剑	jiàn
定义	dìngyì
教育部	jiàoyùbù
括号	kuòhào
括	kuò
商人	shāngrén
投资	tóuzī
对称	duìchèn
称	chēng
信封	xìnfēng
顿时	dùnshí
繁华	fánhuá
年初	niánchū
研	yán
科研	kēyán
模式	móshì
心理	xīnlǐ
冷气	lěngqì
批准	pīzhǔn
女性	nǚxìng
押金	yājīn
押	yā
停车场	tíngchēchǎng
两侧	liǎngcè
泌	bìmì
分泌	fēnmì
增加	zēngjiā
占线	zhànxiàn
应付	yìngfu
路过	lùguò
亲人	qīnrén
灾难	zāinàn
运用	yùnyòng
午睡	wǔshuì
穷人	qióngrén
穷	qióng
人力	rénlì
贫	pín
贫困	pínkùn
品牌	pǐnpái
置	zhì
设置	shèzhì
恰	qià
恰当	qiàdàng
收集	shōují
若	ruò
体操	tǐcāo
跳高	tiàogāo
跳远	tiàoyuǎn
水库	shuǐkù
师生	shīshēng
适当	shìdàng
蔼	ǎi
和蔼	hé’ǎi
耿直	gěng zhí
耿	gěng
虽	suī
台灯	táidēng
中世纪	zhōngshìjì
牙刷	yáshuā
王子	wángzǐ
影视	yǐngshì
异	yì
异人之下	yì rén zhīxià
消耗	xiāohào
耗	hào
属	shǔzhǔ
金属	jīnshǔ
以往	yǐwǎng
卡车	kǎchē
路透	lù tòu
艇	tǐng
舰艇	jiàntǐng
舰	jiàn
再次	zàicì
有钱人	yǒuqiánrén
震惊	zhènjīng
正如	zhèngrú
雨衣	yǔyī
校内	xiàonèi
终止	zhōngzhǐ
总数	zǒngshù
总量	zǒngliàng
先干为敬	xiāngān wéi jìng
大山深处	dàshānshēnchù
吝啬	lìnsè
吝	lìn
啬	sè
山腰	shānyāo
腰	yāo
笼罩	lǒngzhào
免疫	miǎnyì
敏捷	mǐnjié
捷	jié
调头	diàotou
恼	nǎo
恼火	nǎohuǒ
倾听	qīngtīng
倾	qīng
做标记	zuò biāojì
音乐圈	yīnyuè quān
卖方	màifāng
墓碑	mùbēi
宜	yí
适宜	shìyí
手势	shǒushì
纤维	xiānwéi
纤	qiànxiān
演变	yǎnbiàn
要点	yàodiǎn
庸	yōng
庸俗	yōngsú
俗	sú
优越	yōuyuè
正负	zhèngfù
侄子	zhízi
侄	zhí
我们	wǒmen
矮	ǎi
什	shénshí
为什么	wèishénme
上頭姐妹	-
妹	mèi
頭	-
姐	jiě
追星	zhuī xīng
追	zhuī
城市	chéngshì
不一定	bùyīdìng
乘坐	chéngzuò
厨房	chúfáng
步行	bùxíng
饿	è
身体	shēntǐ
餐馆	cānguǎn
餐	cān
抄写	chāoxiě
抄	chāo
电脑	diànnǎo
超	chāo
超级	chāojí
故事	gùshi
大象	dàxiàng
地球	dìqiú
厂商	chǎngshāng
柿子	shìzi
睡觉	shuìjiào
城镇	chéngzhèn
处罚	chǔfá
妨碍	fáng’ài
妨	fáng
碍	ài
评价	píngjià
喜欢	xǐhuān
可爱	kě’ài
从中	cóngzhōng
初等	chūděng
饭馆	fànguǎn
东部	dōngbù
念	niàn
怨	yuàn
怨念	yuàn niàn
短期	duǎnqī
创办	chuàngbàn
建	jiàn
创建	chuàngjiàn
不由得	bùyóude
录	lù
登录	dēnglù
地面	dìmiàn
多次	duōcì
晚睡晚起	wǎnshuì wǎnqǐ
偿还	chánghuán
察	chá
警察	jǐngchá
放大	fàngdà
短片	duǎnpiàn
斗	dǒudǒudòu
奋斗	fèndòu
陈列	chénliè
该	gāi
应该	yīnggāi
共计	gòngjì
力量	lìliàng
受欢迎	shòuhuānyíng
暗	àn
黑暗	hēiàn
慈	cí
慈善	císhàn
嫩	nèn
伺	cìsì
伺候	cìhou
建成	jiànchéng
浅	qiǎn
金牌	jīnpái
亲爱	qīn’ài
建造	jiànzào
昏	hūn
进化	jìnhuà
科技	kējì
鸭梨山大	yālí shān dà
书架	shūjià
空中	kōngzhōng
兜	dōu
乐趣	lèqù
断绝	duànjué
身边	shēnbiān
什么样	shénmeyàng
媒体	méitǐ
领带	lǐngdài
威胁	wēixié
胁	xié
走路	zǒulù
卧	wò
卧室	wòshì
敏感	mǐngǎn
一切	yíqiè
优秀	yōuxiù
牌子	páizi
羽毛球	yǔmáoqiú
域	yù
区域	qūyù
全都	quándōu
热门	rèmén
高超	gāochāo
自动	zìdòng
强壮	qiángzhuàng
桥梁	qiáoliáng
梁	liáng
排除法	páichúfǎ
害虫	hàichóng
车厢	chēxiāng
厢	xiāng
找出	zhǎochū
童话	tónghuà
土地	tǔdì
运动鞋	yùndòngxié
桃树	táoshù
收取	shōuqǔ
放大招	fàngdà zhāo
買	-
買家秀	-
形成	xíngchéng
候选人	hòuxuǎnrén
杏仁	xìngrén
修建	xiūjiàn
睡衣	shuìyī
显	xiǎn
显出	xiǎnchū
优良	yōuliáng
玉米	yùmǐ
铸	zhù
铸铁	zhùtiě
刻苦	kèkǔ
刻	kè
沿着	yánzhe
要不然	yàobùrán
菜花	càihuā
增产	zēngchǎn
阴影	yīnyǐng
精简	jīngjiǎn
真诚	zhēnchéng
境界	jìngjiè
原告	yuángào
制约	zhìyuē
咀	jǔ
嚼	jiáojiào
咀嚼	jǔjué
注册	zhùcè
册	cè
直升机	zhíshēngjī
洞	dòng
空洞	kōngdòng
恐吓	kǒnghè
恐	kǒng
文化包容	wénhuà bāoróng
溜	liū
情绪化	qíngxùhuà
绪	xù
论坛	lùntán
坛	tán
生活方式	shēnghuó fāngshì
有耐心	yǒu nàixīn
谋求	móuqiú
谋	móu
眼影	yǎnyǐng
排练	páiliàn
烹	pēng
饪	rèn
烹饪	pēngrèn
虚假	xūjiǎ
签署	qiānshǔ
署	shǔ
勤俭	qínjiǎn
俭	jiǎn
犬	quǎn
娱	yú
娱乐圈	yúlèquān
且	qiě
尚且	shàngqiě
尚	shàng
奢侈	shēchǐ
牲畜	shēngchù
牲	shēng
首饰	shǒushì
饰	shì
俗话	súhuà
倘	chángtǎng
倘若	tǎngruò
挽回	wǎnhuí
挽	wǎn
下属	xiàshǔ
严峻	yánjùn
峻	jùn
蛮	mán
野蛮	yěmán
拥护	yōnghù
渔	yú
渔民	yúmín
预先	yùxiān
在意	zàiyì
折磨	zhémó
磨	mómò
之际	zhī jì
致	zhì
致使	zhìshǐ
拄	zhǔ
滋味	zīwèi
滋	zī
保卫	bǎowèi
彼	bǐ
彼此	bǐcǐ
值得	zhíde
便于	biànyú
成为	chéngwéi
趁	chèn
保重	bǎozhòng
不曾	bùcéng
曾	zēngcéngzēng
不良	bùliáng
参与	cānyù
大约	dàyuē
笨	bèn
笨拙	bènzhuō
拙	zhuō
差异	chāyì
出色	chūsè
政府	zhèngfǔ
穿上	chuānshang
穿	chuān
简单	jiǎndān
代表团	dàibiǎotuán
秒懂	miǎo dǒng
懂	dǒng
回来	huílai
灯光	dēngguāng
争	zhēng
竞争	jìngzhēng
竞	jìng
嗽	sòu
咳嗽	késou
绝对	juéduì
人民	rénmín
高于	gāoyú
接到	jiēdào
后果	hòuguǒ
灵活	línghuó
最近	zuìjìn
浏览	liúlǎn
览	lǎn
浏	liú
处境	chǔjìng
耐心	nàixīn
基本上	jīběnshang
革	gé
革新	géxīn
垂直	chuízhí
垂	chuí
黄	huáng
黄瓜	huángguā
年纪	niánjì
回顾	huígù
官司	guānsi
扔	rēng
路边	lùbiān
勺子	sháozi
勺	sháo
对我来说	duì wǒ láishuō
乏	fá
缺乏	quēfá
基督教	jīdūjiào
排球	páiqiú
碰	pèng
失眠	shīmián
眠	mián
快速	kuàisù
躺	tǎng
收据	shōujù
看待	kàndài
丢三落四	diūsānlàsì
领先	lǐngxiān
提	tí
倡	chàng
提倡	tíchàng
就是说	jiùshìshuō
两边	liǎngbiān
牙膏	yágāo
项链	xiàngliàn
推送	tuī sòng
放射	fàngshè
有利	yǒulì
齐	qí
齐全	qíquán
取消	qǔxiāo
质量	zhìliàng
确保	quèbǎo
没收	mòshōu
制造	zhìzào
中旬	zhōngxún
旬	xún
全世界	quánshìjiè
设立	shèlì
港湾	gǎngwān
隔离	gélí
社区	shèqū
亲属	qīnshǔ
红牛	hóngniú
摄像机	shèxiàngjī
摄影师	shèyǐngshī
收看	shōukàn
音乐会	yīnyuèhuì
刷子	shuāzi
恭敬	gōngjìng
恭	gōng
全新	quánxīn
缩	suō
缩短	suōduǎn
手法	shǒufǎ
挑战	tiǎozhàn
深化	shēnhuà
换	huàn
兑	duì
兑换	duìhuàn
无法	wúfǎ
候选	hòuxuǎn
涩	sè
小型	xiǎoxíng
狗血	gǒu xiě
娃娃	wáwa
娃	wá
消除	xiāochú
蝴	hú
蝶	dié
蝴蝶	húdié
恐怖片	kǒngbùpiān
怖	bù
极限	jíxiàn
动作片	dòngzuòpiān
壕	háo
整天	zhěngtiān
优美	yōuměi
预测	yùcè
制作	zhìzuò
依次	yīcì
智力	zhìlì
解散	jiěsàn
用处	yòngchu
敬业	jìngyè
掌声	zhǎngshēng
照耀	zhàoyào
哲学	zhéxué
哲	zhé
扛	káng
政权	zhèngquán
症状	zhèngzhuàng
自我	zìwǒ
却	què
冷却	lěngquè
洛杉矶	luòshānjī
矶	jī
洛	luò
杉	shān
磨合	móhé
皮革	pígé
拼搏	pīnbó
搏	bó
启程	qǐchéng
启	qǐ
请示	qǐngshì
树立	shùlì
弹性	tánxìng
衅	xìn
挑衅	tiǎoxìn
椭圆	tuǒyuán
椭	tuǒ
威力	wēilì
无比	wúbǐ
夕阳	xīyáng
毅力	yìlì
毅	yì
镇定	zhèndìng
岸上	ànshàng
暴力	bàolì
暴	bào
教室	jiàoshì
伴	bàn
伴侣	bànlǚ
打电话	dǎdiànhuà
诚恳	chéngkěn
诶	éi
查出	cháchū
登记	dēngjì
河	hé
黄河	huánghé
椅子	yǐzi
窗台	chuāngtái
放暑假	fàngshǔjià
暑	shǔ
反而	fǎn’ér
当初	dāngchū
剥削	bōxuē
削	xuē
剥	bāobō
故意	gùyì
各自	gèzì
打牌	dǎpái
房租	fángzū
胡说	húshuō
糊涂	hútu
赶到	gǎndào
赶紧	gǎnjǐn
卡农	kǎnóng
艰苦	jiānkǔ
艰	jiān
毒品	dúpǐn
穴	xué
巢穴	cháoxué
巢	cháo
公共	gōnggòng
温度	wēndù
哪	nǎ
哪些	nǎxiē
钢笔	gāngbǐ
格外	géwài
前天	qiántiān
请问	qǐngwèn
过分	guòfèn
传单	chuándān
明显	míngxiǎn
模糊	móhu
课堂	kètáng
股东	gǔdōng
将近	jiāngjìn
任何	rènhé
任	rénrèn
海报	hǎibào
技能	jìnéng
加速	jiāsù
阴天	yīntiān
互动	hùdòng
奖学金	jiǎngxuéjīn
就业	jiùyè
售货员	shòuhuòyuán
售	shòu
嗓	sǎng
嗓子	sǎngzi
猜灯谜	cāi dēngmí
谜	mèimí
景象	jǐngxiàng
景	jǐng
局面	júmiàn
王蕴宏	wángyùnhóng
蕴	yùn
讨论	tǎolùn
讨	tǎo
锁	suǒ
无聊	wúliáo
精美	jīngměi
天真	tiānzhēn
额外	éwài
额	é
而已	éryǐ
快车	kuàichē
述	shù
描述	miáoshù
描	miáo
默默	mòmò
默	mò
尤	yóu
尤其	yóuqí
形状	xíngzhuàng
流量小花	liú liàng xiǎo huā
以来	yǐlái
准确	zhǔnquè
福气	fúqi
福	fú
种子	zhǒngzi
制定	zhìdìng
复兴	fùxīng
劲	jìnjìng
干劲	gànjìn
施	shī
设施	shèshī
恰恰	qiàqià
一部分	yībùfen
凹造型	āozàoxíng
凹	āo
球星	qiúxīng
塑料	sùliào
所长	suǒchángsuǒzhǎng
黑子	hēi zi
归还	guīhuán
归	guī
特性	tèxìng
走过	zǒuguò
微博	wēibó
叹气	tànqì
叹	tàn
探讨	tàntǎo
特意	tèyì
田	tián
黄昏	huánghūn
演唱会	yǎnchànghuì
银牌	yínpái
信箱	xìnxiāng
眼泪	yǎnlèi
胡同	hútòng
翔	xiáng
嚇	-
嚇出翔	-
英勇	yīngyǒng
营业	yíngyè
过塑	guòsù
血管	xuèguǎn
预期	yùqī
不夜城	bùyèchéng
艺人	yìrén
做客	zuòkè
自来水	zìláishuǐ
证书	zhèngshū
值班	zhíbān
战场	zhànchǎng
县城	xiànchéng
指头	zhǐtou
提纲	tígāng
纲	gāng
捞	lāo
象棋	xiàngqí
棋	qí
赛马	sàimǎ
惫	bèi
疲惫	píbèi
代购	dàigòu
确切	quèqiè
没人管	méirénguǎn
口音很重	kǒuyin hěn zhòng
盛开	shèngkāi
奇特	qítè
是非	shìfēi
芸薹属	yúntái shǔ
芸	yìyúnyún
薹	tái
昔日	xīrì
昔	xī
辛	xīn
辛勤	xīnqín
绣	xiù
压缩	yāsuō
隐	yǐnyìn
隐约	yǐnyuē
幼稚	yòuzhì
稚	zhì
幼	yòu
赞	zàn
赞叹	zàntàn
拽	zhuài
庄重	zhuāngzhòng
罢工	bàgōng
罢	bàba
暴风雨	bàofēngyǔ
有道理	yǒu dàoli
本身	běnshēn
版本	bǎnběn
姐姐	jiějie
补偿	bǔcháng
吧啦吧啦	bā lā bā lā
啦	la
声音	shēngyīn
中午	zhōngwǔ
才能	cáinéng
复习	fùxí
没有对错	méiyǒu duìcuò
鼻涕	bítì
涕	tì
鼻	bí
看见	kànjiàn
辨认	biànrèn
辨	biàn
认	rèn
臭	chòu
城区	chéngqū
传输	chuánshū
害羞	hàixiū
其实	qíshí
当场	dāngchǎng
合法	héfǎ
大力	dàlì
担忧	dānyōu
担	dāndàn
忧	yōu
当作	dàngzuò
舒服	shūfu
诧异	chàyì
诧	chà
忽	hū
忽然	hūrán
斗争	dòuzhēng
验	yàn
经验	jīngyàn
多半	duōbàn
银行	yínháng
决赛	juésài
哈哈	hāhā
哈	hā
老鼠	lǎoshǔ
俩	liǎ
说漏嘴	shuō lòu zuǐ
光荣	guāngróng
盒饭	héfàn
生活	shēnghuó
怯	qiè
胆怯	dǎnqiè
适应	shìyìng
旧金山	jiùjīnshān
顺利	shùnlì
时尚	shíshàng
看来	kànlai
体验	tǐyàn
纠正	jiūzhèng
漏洞	lòudòng
幸福	xìngfú
演员	yǎnyuán
梦想	mèngxiǎng
脑子	nǎozi
正常	zhèngcháng
分量	fènliàng
平坦	píngtǎn
平原	píngyuán
认出	rènchū
整齐	zhěngqí
商业	shāngyè
资格	zīgé
高明	gāomíng
根深蒂固	gēnshēndìgù
蒂	dì
实验室	shíyànshì
耕地	gēngdì
耕	gēng
试题	shìtí
射击	shèjī
烦躁	fánzào
躁	zào
烦	fán
说不定	shuōbudìng
时光	shíguāng
炸弹	zhàdàn
旗子	qízi
过奖	guòjiǎng
当心	dāngxīn
外套	wàitào
网址	wǎngzhǐ
迈	mài
豪迈	háomài
呵	hē
和气	héqi
体积	tǐjī
积	jī
做到	zuòdào
逼	bī
逼格	bī gé
算是	suànshì
岁数	suìshu
违法	wéifǎ
皇后	huánghòu
闲	xián
货币	huòbì
机智	jīzhì
顽强	wánqiáng
信念	xìnniàn
嫉	jí
嫉妒	jídù
妒	dù
依照	yīzhào
有幸福感	yǒu xìngfúgǎn
救护车	jiùhùchē
用不着	yòngbuzháo
指出	zhǐchū
桨	jiǎng
雨水	yǔshuǐ
订	dìng
制订	zhìdìng
之下	zhīxià
省略	shěnglüè
亏损	kuīsǔn
连同	liántóng
寺庙	sìmiào
庙	miào
芹菜	qíncài
芹	qín
农田	nóngtián
瞄	miáo
瞄准	miáozhǔn
堪	kān
难堪	nánkān
比方说	bǐfangshuō
情报	qíngbào
缺口	quēkǒu
棺	guān
棺材	guāncai
守旧	shǒujiù
瞬	shùn
瞬间	shùnjiān
条约	tiáoyuē
通俗	tōngsú
微不足道	wēibùzúdào
蒸发	zhēngfā
知觉	zhījué
则	zé
准则	zhǔnzé
姿态	zītài
作风	zuòfēng
拜访	bàifǎng
访	fǎng
第	dì
第一	dìyī
什么	shénme
怎么	zěnme
冰箱	bīngxiāng
衬衫	chènshān
尝	cháng
早上	zǎoshàng
不顾	búgù
电子邮件	diànzǐyóujiàn
报仇	bàochóu
仇	qiúchóuqiú
不光	bùguāng
不怎么	bùzěnme
赚钱	zhuànqián
说谎	shuōhuǎng
措施	cuòshī
措	cuò
蹦	bèng
害怕	hàipà
怕	pà
成长	chéngzhǎng
大自然	dàzìrán
存在	cúnzài
表决	biǎojué
看情况	kàn qíngkuàng
况	kuàng
担保	dānbǎo
怪不得	guàibude
后悔	hòuhuǐ
到来	dàolái
美元	měiyuán
仓	cāng
仓促	cāngcù
父母	fùmǔ
母	mǔ
概	gài
概念	gàiniàn
体育	tǐyù
电车	diànchē
突然	tūrán
完成	wánchéng
红色	hóngsè
听力	tīnglì
个性	gèxìng
洗手间	xǐshǒujiān
画儿	huàr
澡	zǎo
洗澡	xǐzǎo
朝代	cháodài
门口	ménkǒu
风俗	fēngsú
公务员	gōngwùyuán
共有	gòngyǒu
城堡	chéngbǎo
堡	bǎobǔ
拿来	nálái
柏	bǎibǎibó
柏林	bólín
停更	tíng gēng
男票	nán piào
高科技	gāokējì
自然	zìrán
加快	jiākuài
倒	dào
推倒	tuī dǎo
姑	gū
姑姑	gūgu
坚决	jiānjué
汇款	huìkuǎn
坚固	jiāngù
热爱	rè’ài
人生	rénshēng
混乱	hùnluàn
深刻	shēnkè
疾病	jíbìng
地势	dìshì
事物	shìwù
老头儿	lǎotóur
烤肉	kǎoròu
渴望	kěwàng
似乎	sìhū
文件	wénjiàn
凉水	liángshuǐ
兔子	tùzi
信息	xìnxī
中学	zhōngxué
未必	wèibì
未	wèi
命运	mìngyùn
文学	wénxué
奔走相告	bēn zǒu xiāng gào
消失	xiāoshī
幽	yōu
幽默	yōumò
模特儿	mótèr
齿	chǐ
牙齿	yáchǐ
联盟	liánméng
分红	fēnhóng
晚安	wǎnān
晚会	wǎnhuì
员工	yuángōng
服气	fúqì
热烈	rèliè
清醒	qīngxǐng
醒	xǐng
腹	fù
泻	xiè
腹泻	fùxiè
确立	quèlì
人间	rénjiān
实施	shíshī
格局	géjú
山区	shānqū
潜力	qiánlì
潜	qián
尷尬癥	-
癥	-
剩下	shèngxià
剩	shèng
松树	sōngshù
松	sōng
早就	zǎojiù
蔬菜	shūcài
惯例	guànlì
停止	tíngzhǐ
损害	sǔnhài
时期	shíqī
外文	wàiwén
地道	dìdao
屋	wū
屋子	wūzi
做饭	zuòfàn
相等	xiāngděng
消毒	xiāodú
消防	xiāofáng
外来	wàilái
王后	wánghòu
饥	jī
饥饿	jī’è
家常	jiācháng
一流	yīliú
证据	zhèngjù
修车	xiūchē
自从	zìcóng
自身	zìshēn
增强	zēngqiáng
祝福	zhùfú
模特	mótè
茎	jīng
买单	mǎidān
住宅	zhùzhái
宅	zhái
蜡烛	làzhú
蜡	là
烛	zhú
火盆	huǒpén
盆	pén
伶俐	línglì
俐	lì
伶	líng
推卸责任	tuīxièzérèn
卸	xiè
屡次	lǚcì
屡	lǚ
弥漫	mímàn
弥	mí
正后面	zhèng hòumiàn
庞大	pángdà
庞	páng
劈	pī
片断	piànduàn
慎重	shènzhòng
落地窗	luòdìchuāng
思索	sīsuǒ
肢	zhī
四肢	sìzhī
体系	tǐxì
妥当	tuǒdang
响亮	xiǎngliàng
严寒	yánhán
愈	yù
杂技	zájì
阵地	zhèndì
阵	zhèn
智商	zhìshāng
庄严	zhuāngyán
自满	zìmǎn
赁	lìn
租赁	zūlìn
扮演	bànyǎn
扮	bàn
巴士	bāshì
饱	bǎo
鼻子	bízi
不但	bùdàn
不见得	bújiàndé
不耐烦	búnàifán
榜样	bǎngyàng
榜	bǎng
车票	chēpiào
地图	dìtú
采用	cǎiyòng
公共汽车	gōnggòngqìchē
地上	dìshang
长处	chángchù
朋友	péngyǒu
粗糙	cūcāo
糙	cāo
关系	guānxi
苹	píng
苹果	píngguǒ
谢谢	xièxie
几	jǐ
几乎	jīhū
辩	biàn
辩证	biànzhèng
别致	biézhì
糯	nuò
处处	chùchù
工厂	gōngchǎng
此处	cǐchù
号码	hàomǎ
村庄	cūnzhuāng
请假	qǐngjià
操劳	cāoláo
奖金	jiǎngjīn
伙	huǒ
伙伴	huǒbàn
家务	jiāwù
马路	mǎlù
花园	huāyuán
坏处	huàichu
小心	xiǎoxīn
多方面	duōfāngmiàn
幅度	fúdù
钢琴	gāngqín
开水	kāishuǐ
共享	gòngxiǎng
享	xiǎng
就要	jiùyào
含量	hánliàng
喜剧	xǐjù
歌星	gēxīng
炊烟	chuīyān
炊	chuī
身上	shēnshang
构建	gòujiàn
构	gòu
获取	huòqǔ
或是	huòshì
将要	jiāngyào
下边	xiàbian
忍不住	rěnbuzhù
首都	shǒudū
据说	jùshuō
尽可能	jǐnkěnéngjìnkěnéng
臟	-
辮	-
臟辮	-
简介	jiǎnjiè
介	jiè
青少年	qīngshàonián
截	jié
截至	jiézhì
金融	jīnróng
融	róng
详细	xiángxì
少数	shǎoshù
良好	liánghǎo
学期	xuéqī
发誓	fāshì
誓	shì
毛衣	máoyī
客车	kèchē
口试	kǒushì
摩托	mótuō
托	tuō
消极	xiāojí
心脏	xīnzàng
领取	lǐngqǔ
品种	pǐnzhǒng
作家	zuòjiā
日常	rìcháng
逐步	zhúbù
群众	qúnzhòng
主任	zhǔrèn
格式	géshi
使劲	shǐjìn
强化	qiánghuà
供不应求	gōngbúyìngqiú
清洗	qīngxǐ
翅	chì
翅膀	chìbǎng
思维	sīwéi
外汇	wàihuì
围巾	wéijīn
卫生	wèishēng
显得	xiǎnde
外界	wàijiè
须	xū
胡须	húxū
田径	tiánjìng
商业区	shāngyèqū
浑身	húnshēn
浑	hún
柜台	guìtái
有效	yǒuxiào
任性	rènxìng
乐队	yuèduì
虐心	nüè xīn
虐	nüè
坚实	jiānshí
职工	zhígōng
药品	yàopǐn
要么	yàome
抓住	zhuāzhù
抓	zhuā
阅览室	yuèlǎnshì
轮流	lúnliú
职务	zhíwù
扎实	zhāshi
啃	kěn
奇观	qíguān
留神	liúshén
唆	suō
啰唆	luōsuo
啰	luōluo
茫茫	mángmáng
茫	máng
藐视	miǎoshì
藐	miǎo
宁	níngníngnìng
宁愿	nìngyuàn
飘扬	piāoyáng
飘	piāo
颧骨	quángǔ
曲折	qūzhé
容忍	róngrěn
尿	niàosuī
糖尿病	tángniàobìng
施展	shīzhǎn
歪	wāi
歪曲	wāiqū
无偿	wúcháng
馅儿	xiànr
馅	xiàn
一目了然	yímùliǎorán
咋	zǎ
篷	péng
帐	zhàng
帐篷	zhàngpeng
遮	zhē
遮挡	zhēdǎng
珍稀	zhēnxī
稀	xī
指令	zhǐlìng
注释	zhùshì
熬夜	áoyè
熬	áo
办事	bànshì
乡村	xiāngcūn
菜单	càidān
比重	bǐzhòng
不大	bùdà
房间	fángjiān
蛋糕	dàngāo
糕	gāo
今天	jīntiān
窗户	chuānghu
成人	chéngrén
下午	xiàwǔ
重复	chóngfù
打针	dǎzhēn
大使馆	dàshǐguǎn
老师	lǎoshī
个子	gèzi
春天	chūntiān
衣服	yīfu
电视机	diànshìjī
仓库	cāngkù
称号	chēnghào
或者	huòzhě
再见	zàijiàn
起床	qǐchuáng
否则	fǒuzé
软柿子	ruǎnshìzi
工人	gōngrén
墅	shù
别墅	biéshù
高速公路	gāosùgōnglù
此刻	cǐkè
好笑	hǎoxiào
顾客	gùkè
船长	chuánzhǎng
不可能	bù kěnéng
家人	jiārén
步伐	bùfá
互相	hùxiāng
财政	cáizhèng
起飞	qǐfēi
何必	hébì
然后	ránhòu
公路	gōnglù
花生	huāshēng
多样	duōyàng
图书馆	túshūguǎn
敞开	chǎngkāi
镜子	jìngzi
新闻	xīnwén
房价	fángjià
愤	fèn
愤怒	fènnù
理解	lǐjiě
快餐	kuàicān
慌忙	huāngmáng
关爱	guānài
接近	jiējìn
金主	jīn zhǔ
网友	wǎngyǒu
艰难	jiānnán
江	jiāng
档次	dàngcì
导弹	dǎodàn
胶带	jiāodài
具体	jùtǐ
狮子	shīzi
狮	shī
酒吧	jiǔbā
决不	juébù
气温	qìwēn
同情	tóngqíng
宽广	kuānguǎng
动身	dòngshēn
金额	jīné
连接	liánjiē
推荐	tuījiàn
荐	jiàn
零食	língshí
犀利	xī lì
犀	xī
至少	zhìshǎo
模型	móxíng
体育场	tǐyùchǎng
男女	nánnǚ
因素	yīnsù
人工智能	réngōngzhìnéng
气体	qìtǐ
免得	miǎndé
账户	zhànghù
账	zhàng
俯	fǔ
俯视	fǔshì
内地	nèidì
沙子	shāzi
善良	shànliáng
上升	shàngshēng
搁	gē
倾向	qīngxiàng
暑假	shǔjià
让座	ràngzuò
调皮	tiáopí
率领	shuàilǐng
中小学	zhōngxiǎoxué
时装	shízhuāng
航行	hángxíng
钓	diào
武器	wǔqì
舞台	wǔtái
宏伟	hóngwěi
伟	wěi
素质	sùzhì
卫星	wèixīng
听取	tīngqǔ
会晤	huìwù
晤	wù
衣架	yījià
外科	wàikē
微波炉	wēibōlú
坚韧	jiānrèn
韧	rèn
幼儿园	yòu’éryuán
见解	jiànjiě
閨	-
男閨蜜	-
中部	zhōngbù
有力	yǒulì
娇气	jiāoqì
娇	jiāo
原先	yuánxiān
唯一一个	wéiyī yīgè
子女	zǐnǚ
在内	zàinèi
进而	jìn’ér
音像	yīnxiàng
远方	yuǎnfāng
政党	zhèngdǎng
党	dǎng
唠	láolào
嗑	kè
唠嗑	làokē
究	jiū
追究	zhuījiū
历	lì
来历	láilì
睬	cǎi
理睬	lǐcǎi
悟	wù
领悟	lǐngwù
麻木	mámù
木	mù
茫然	mángrán
神圣	shénshèng
荒郊	huāngjiāo
欧美	ōuměi
涮火锅	shuànhuǒguō
涮	shuàn
条理	tiáolǐ
问世	wènshì
无穷无尽	wúqióngwújìn
惠	huì
贤	xián
贤惠	xiánhuì
摇摆	yáobǎi
摆	bǎi
意图	yìtú
乐谱	yuèpǔ
谱	pǔ
岳母	yuèmǔ
岳	yuè
阻挠	zǔnáo
挠	náo
被迫	bèipò
长江	chángjiāng
饱和	bǎohé
答案	dá’àn
咖啡	kāfēi
得到	dédào
不许	bùxǔ
重要	zhòngyào
促使	cùshǐ
护照	hùzhào
尝试	chángshì
等于	děngyú
放假	fàngjià
撤离	chèlí
繁荣	fánróng
持	chí
持有	chíyǒu
思考	sīkǎo
寸	cùn
个人	gèrén
运动员	yùndòngyuán
大伙儿	dàhuǒr
倒闭	dǎobì
说废话	shuō fèihuà
获得	huòdé
当选	dāngxuǎn
电灯	diàndēng
参谋	cānmóu
地形	dìxíng
当成	dàngchéng
电力	diànlì
教材	jiàocái
夫人	fūrén
发放	fāfàng
反响	fǎnxiǎng
游戏	yóuxì
看不起	kànbuqǐ
工作日	gōngzuòrì
进入	jìnrù
自行车	zìxíngchē
炸毛	zhà máo
高手	gāoshǒu
车来了	chēlái le
观光	guānguāng
会谈	huìtán
平静	píngjìng
热心	rèxīn
人类	rénlèi
善于	shànyú
吉	jí
吉利	jílì
祥	xiáng
吉祥	jíxiáng
洗剪吹	xǐ jiǎn chuīand
吹	chuī
果粉	guǒ fěn
雕刻	diāokè
一下儿	yīxiàr
教堂	jiàotáng
节能	jiénéng
取得	qǔdé
全年	quánnián
例外	lìwài
楼梯	lóutī
正确	zhèngquè
看作	kànzuò
显然	xiǎnrán
繁体字	fántǐzì
送给	sònggěi
年底	niándǐ
难得	nándé
飞翔	fēixiáng
悠久	yōujiǔ
悠	yōu
器官	qìguān
人士	rénshì
深入	shēnrù
总之	zǒngzhī
各抒己见	gèshūjǐjiàn
抒	shū
公然	gōngrán
神奇	shénqí
手指	shǒuzhǐ
取款	qǔkuǎn
时机	shíjī
股份	gǔfèn
热线	rèxiàn
孙女	sūnnǚ
会议室	huìyìshì
规格	guīgé
中级	zhōngjí
宏观	hóngguān
特快	tèkuài
修改	xiūgǎi
鲜艳	xiānyàn
艳	yàn
级别	jíbié
鸭子	yāzi
协助	xiézhù
意味着	yìwèizhe
游泳池	yóuyǒngchí
浸泡	jìnpào
浸	jìn
局势	júshì
惧	jù
恐惧	kǒngjù
中华	zhōnghuá
款式	kuǎnshì
列举	lièjǔ
歧	qí
种族歧视	zhǒngzúqíshì
盆地	péndì
气概	qìgài
付水电费	fù shuǐdiànfèi
山脉	shānmài
施加	shījiā
缸	gāng
鱼缸	yúgāng
摊	tān
体裁	tǐcái
田野	tiányě
玩意儿	wányìr
挽救	wǎnjiù
畏	wèi
畏惧	wèijù
误差	wùchā
误	wù
嫌	xián
嫌疑	xiányí
现成	xiànchéng
欣欣向荣	xīnxīnxiàngróng
悬殊	xuánshū
悬	xuán
殊	shū
遗留	yíliú
遗	yí
盈	yíng
盈利	yínglì
沼泽	zhǎozé
沼	zhǎo
泽	zé
正月	zhēngyuè
传记	zhuànjì
着重	zhuózhòng
总而言之	zǒng’éryánzhī
安全	ānquán
必然	bìrán
如果	rúguǒ
变更	biàngēng
博览会	bólǎnhuì
彻底	chèdǐ
彻	chè
捕	bǔ
眼睛	yǎnjīng
沉重	chénzhòng
沉	chén
逼迫	bīpò
汉语	hànyǔ
皮肤	pífū
肤	fū
电池	diànchí
道路	dàolù
炒股	chǎogǔ
充足	chōngzú
付款	fùkuǎn
节日	jiérì
皂	zào
肥皂	féizào
导演	dǎoyǎn
好玩儿	hǎowánr
裤子	kùzi
电视剧	diànshìjù
历史	lìshǐ
史	shǐ
处长	chùzhǎng
捉	zhuō
捕捉	bǔzhuō
元氣	-
氣	-
从没	cóngméi
合适	héshì
感到	gǎndào
盘子	pánzi
国庆节	guóqìngjié
亲自	qīnzì
既	jì
既然	jìrán
家具	jiājù
恶心	ěxin
好多	hǎoduō
电器	diànqì
定价	dìngjià
禁止	jìnzhǐ
男孩儿	nánháir
惩	chéng
惩罚	chéngfá
仿佛	fǎngfú
仿	fǎng
女孩儿	nǚháir
凉快	liángkuai
红茶	hóngchá
最后	zuìhòu
刚	gāng
刚好	gānghǎo
外国	wàiguó
外语	wàiyǔ
球迷	qiúmí
防晒霜	fángshàishuāng
当面	dāngmiàn
看望	kànwàng
咸	xián
尾巴	wěiba
尾	wěiyǐ
码头	mǎtóu
目前	mùqián
贩	fàn
贩卖	fànmài
难以	nányǐ
隊	-
站隊	-
疑问	yíwèn
部首	bùshǒu
粉碎	fěnsuì
碎	suì
拥挤	yōngjǐ
挤	jǐ
马车	mǎchē
民歌	míngē
准时	zhǔnshí
情节	qíngjié
屏幕	píngmù
舍	shěshèshè
舍得	shěde
固然	gùrán
提问	tíwèn
啪啪啪	pā pā pā
啪	pā
升学	shēngxué
睦	mù
和睦	hémù
供你参考	gōng nǐ cānkǎo
呼啸	hūxiào
啸	xiào
毁	huǐ
灭	miè
毁灭	huǐmiè
参加比赛	cānjiā bǐsài
续	xù
延续	yánxù
无边	wúbiān
先锋	xiānfēng
锋	fēng
以便	yǐbiàn
精分	jīng fēn
意志	yìzhì
至今	zhìjīn
有害	yǒuhài
降临	jiànglín
灾区	zāiqū
增多	zēngduō
意愿	yìyuàn
弯	wān
转弯	zhuǎnwān
转	zhuàn
许可证	xǔkězhèng
治安	zhì’ān
举世瞩目	jǔshìzhǔmù
瞩	zhǔ
沮丧	jǔsàng
沮	jǔ
剧烈	jùliè
倔	juéjuè
倔强	juéjiàng
转向	zhuǎnxiàngzhuànxiàng
这就是说	zhèjiùshìshuō
空虚	kōngxū
旷课	kuàngkè
旷	kuàng
装备	zhuāngbèi
壮观	zhuàngguān
熙熙攘攘	xīxīrǎngrǎng
熙	xī
攘	rǎng
长辈	zhǎngbèi
美妙	měimiào
墨水儿	mòshuǐr
片刻	piànkè
旗袍	qípáo
迄	qì
迄今为止	qìjīn-wéizhǐ
擅长	shàncháng
捎	shāo
完毕	wánbì
往事	wǎngshì
争端	zhēngduān
追悼	zhuīdào
悼	dào
比方	bǐfāng
保守	bǎoshǒu
便利	biànlì
右边	yòubiān
抽烟	chōuyān
做完	zuò wán
承受	chéngshòu
承	chéng
男人	nánrén
不料	búliào
牛奶	niúnǎi
大学	dàxué
漫威	màn wēi
草原	cǎoyuán
告诉	gàosù
初步	chūbù
方法	fāngfǎ
放松	fàngsōng
达到	dádào
初期	chūqī
幸运	xìngyùn
风景	fēngjǐng
工资	gōngzī
电视台	diànshìtái
滩	tān
沙滩	shātān
单独	dāndú
不相上下	bùxiāngshàngxià
观察	guānchá
交水电费	jiāo shuǐdiànfèi
灿	càn
烂	làn
灿烂	cànlàn
以前	yǐqián
海边	hǎibiān
教育	jiàoyù
精彩	jīngcǎi
弊	bì
流弊	liú bì
方针	fāngzhēn
景色	jǐngsè
更加	gèngjiā
回国	huíguó
凡是	fánshì
凡	fán
防守	fángshǒu
搞	gǎo
搞好	gǎohǎo
供应	gōngyìng
赤	chì
赤字	chìzì
主要	zhǔyào
华人	huárén
传授	chuánshòu
其中	qízhōng
机制	jīzhì
打仗	dǎzhàng
仗	zhàng
坚定	jiāndìng
检验	jiǎnyàn
下班	xiàbān
接连	jiēlián
小孩儿	xiǎoháir
经费	jīngfèi
奠	diàn
奠定	diàndìng
月末	yuèmò
推特	tuī tè
逃	táo
全身	quánshēn
景点	jǐngdiǎn
小吃	xiǎochī
开创	kāichuàng
易	yì
贸易	màoyì
发扬	fāyáng
大快人心	dà kuài rén xīn
没带脑子	méidài nǎozi
因此	yīncǐ
南北	nánběi
排名	páimíng
信任	xìnrèn
蓝领	lánlǐng
宁静	níngjìng
频道	píndào
请教	qǐngjiào
汽水	qìshuǐ
灾害	zāihài
签约	qiānyuē
签字	qiānzì
办手续	bànshǒuxù
盼	pàn
盼望	pànwàng
平凡	píngfán
失业	shīyè
亲眼	qīnyǎn
姑且	gūqiě
日夜	rìyè
收购	shōugòu
如一	rúyī
拐杖	guǎizhàng
杖	zhàng
伤亡	shāngwáng
统计	tǒngjì
升值	shēngzhí
时而	shí’ér
逃走	táozǒu
环	huán
耳环	ěrhuán
耳	ěr
发抖	fādǒu
抖	dǒu
物价	wùjià
延长	yáncháng
性能	xìngnéng
铺	pū
卧铺	wòpù
急躁	jízào
无效	wúxiào
依据	yījù
袖珍	xiùzhēn
运动会	yùndònghuì
园林	yuánlín
段	duàn
段子手	duàn zi shǒu
晋升	jìnshēng
晋	jìn
振动	zhèndòng
振	zhèn
正规	zhèngguī
就近	jiùjìn
躬	gōng
鞠	jū
鞠躬	jūgōng
开阔	kāikuò
侃侃而谈	kǎnkǎn ér tán
侃	kǎn
空想	kōngxiǎng
珠宝	zhūbǎo
主角	zhǔjué
坦率	tǎnshuài
旅游区	lǚyóuqū
少数民族	shǎoshùmínzú
乐器	yuèqì
蔑	miè
蔑视	mièshì
万圣节	wànshèngjié
驱	qū
驱逐	qūzhú
饶	ráo
恕	shù
饶恕	ráoshù
人格	réngé
标点符号	biāodiǎnfúhào
畅	chàng
舒畅	shūchàng
坦白	tǎnbái
瓷	cí
陶瓷	táocí
陶	táo
调料	tiáoliào
卷	juǎn
卷心菜	juǎnxīncài
挖	wā
挖掘	wājué
掘	jué
无动于衷	wúdòngyúzhōng
衷	zhōng
务必	wùbì
衔接	xiánjiē
衔	xián
以免	yǐmiǎn
引擎	yǐnqíng
优胜劣汰	yōushèngliètài
汰	tài
劣	liè
优异	yōuyì
愚昧	yúmèi
昧	mèi
侦探	zhēntàn
侦	zhēn
征收	zhēngshōu
征	zhēng
坠	zhuì
爱国	àiguó
把关	bǎguān
拜托	bàituō
博客	bókè
商店	shāngdiàn
邻居	línjū
邻	lín
西瓜	xīguā
补助	bǔzhù
粉頭	-
背诵	bèisòng
诵	sòng
考试	kǎoshì
从小	cóngxiǎo
后来	hòulái
场地	chǎngdì
否认	fǒurèn
代替	dàitì
替	tì
错过	cuòguò
回忆	huíyì
忆	yì
过敏	guòmǐn
刚刚	gānggang
合同	hétong
残忍	cánrěn
灰心	huīxīn
同意	tóngyì
二维码	èrwéimǎ
碗	wǎn
能力	nénglì
门票	ménpiào
拒	jù
拒绝	jùjué
腿玩年	tuǐ wán nián
夫妻	fūqī
炎	yán
发炎	fāyán
高尚	gāoshàng
教学	jiāoxuéjiàoxué
工艺	gōngyì
女生	nǚshēng
了不起	liǎobuqǐ
陆地	lùdì
另	lìng
另一个人	lìng yīgè rén
判断	pànduàn
农村	nóngcūn
国旗	guóqí
散步	sànbù
日程	rìchéng
日历	rìlì
唐	táng
唐人街	tángrénjiē
谜语	míyǔ
设计	shèjì
看上去	kànshangqu
所有	suǒyǒu
始	shǐ
始终	shǐzhōng
同时	tóngshí
网球	wǎngqiú
口号	kǒuhào
讨价还价	tǎojiàhuánjià
橡皮	xiàngpí
橡	xiàng
消息	xiāoxi
比萨饼	bǐsàbǐng
饼	bǐng
萨	sà
心情	xīnqíng
众创空间	zhòngchuàng kōngjiān
严重	yánzhòng
邮局	yóujú
友好	yǒuhǎo
原谅	yuánliàng
谅	liàng
聊天儿	liáotiānr
吩	fēn
吩咐	fēnfù
强度	qiángdù
抚	fǔ
抚养	fǔyǎng
裕	yù
富裕	fùyù
支票	zhīpiào
更正	gēngzhèng
因为	yīnwèi
收听	shōutīng
三明治	sānmíngzhì
铁路	tiělù
主人	zhǔrén
蒙	méngmēngméngméngměngmēngméng
蒙圈	mēngquān
推行	tuīxíng
把妹	bǎ mēi
特地	tèdì
学问	xuéwen
机密	jīmì
形态	xíngtài
学位	xuéwèi
舞蹈	wǔdǎo
季军	jìjūn
網	-
紅	-
網紅	-
共同努力	gòngtóngnǔlì
努	nǔ
预订	yùdìng
鉴	jiàn
鉴别	jiànbié
原则	yuánzé
用于	yòngyú
虚心学习	xūxīnxuéxí
依赖	yīlài
一齐	yīqí
惊动	jīngdòng
争议	zhēngyì
兢兢业业	jīngjīngyèyè
兢	jīng
就职	jiùzhí
科目	kēmù
职责	zhízé
波士顿	bōshìdùn
惑	huò
迷惑	míhuò
纳闷儿	nàmènr
闷	mēnmèn
凝视	níngshì
凝	níng
炫耀	xuànyào
炫	xuàn
搞混	gǎohùn
丢垃圾	diū lājī
垃	lā
圾	jī
散发	sànfā
势必	shìbì
污蔑	wūmiè
向往	xiàngwǎng
喧哗	xuānhuá
喧	xuān
哗	huāhuá
削弱	xuēruò
巡	xún
巡逻	xúnluó
支柱	zhīzhù
衷心	zhōngxīn
驻扎	zhùzhā
驻	zhù
铸造	zhùzào
包含	bāohán
白领	báilǐng
杯子	bēizi
服务	fúwù
败坏	bàihuài
败	bài
颁发	bānfā
颁	bān
一点儿	yīdiǎnr
参观	cānguān
庇	bì
包庇	bāobì
桑	sāng
饱经沧桑	bǎojīngcāngsāng
沧	cāng
打球	dǎqiú
打扰	dǎrǎo
扰	rǎo
上学	shàngxué
沉默	chénmò
策略	cèlüè
季节	jìjié
吨	dūn
罚款	fákuǎn
改变	gǎibiàn
承包	chéngbāo
创立	chuànglì
此后	cǐhòu
队长	duìzhǎng
搏斗	bódòu
干活儿	gànhuór
部署	bùshǔ
其他	qítā
地下	dìxià
采集	cǎijí
记者	jìzhě
点燃	diǎnrán
草案	cǎo’àn
过年	guònián
提高	tígāo
电动	diàndòng
路口	lùkǒu
路上	lùshang
捡	jiǎn
讲座	jiǎngzuò
分析	fēnxī
析	xī
举行	jǔxíng
犯罪	fànzuì
交给	jiāogěi
理想	lǐxiǎng
好好	hǎohǎo
利息	lìxī
规模	guīmó
高层	gāocéng
寒冷	hánlěng
名牌	míngpái
名胜古迹	míngshènggǔjì
纯洁	chúnjié
家属	jiāshǔ
能源	néngyuán
篮球	lánqiú
建立	jiànlì
玩儿	wánr
好学	hǎoxuéhàoxué
进展	jìnzhǎn
减轻	jiǎnqīng
衡量	héngliáng
是否	shìfǒu
交际	jiāojì
熟悉	shúxī
悉	xī
小学	xiǎoxué
局长	júzhǎng
使劲儿	shǐjìnr
一块儿	yīkuàir
推迟	tuīchí
客气	kèqi
另一方面	lìngyīfāngmiàn
近视	jìnshì
端正	duānzhèng
井	jǐng
离不开	líbukāi
立场	lìchǎng
堆	duī
堆积	duījī
小说	xiǎoshuō
眼镜	yǎnjìng
下载	xiàzài
载	zǎizài
宽阔	kuānkuò
有趣	yǒuqù
票价	piàojià
屁股	pìgu
暖气	nuǎnqì
优势	yōushì
植物	zhíwù
起码	qǐmǎ
周围	zhōuwéi
轻易	qīngyì
人工	réngōng
惜	xī
珍惜	zhēnxī
竹子	zhúzi
竹	zhú
聘请	pìnqǐng
聘	pìn
姓名	xìngmíng
球员	qiúyuán
测验	cèyàn
缩小	suōxiǎo
商城	shāngchéng
海拔	hǎibá
桃花	táohuā
维持	wéichí
体力	tǐlì
多余	duōyú
余	yú
恶劣	èliè
撩妹	liáo mēi
撩	liāo
鲜花	xiānhuā
相片	xiàngpiàn
赔钱	péiqián
講	-
講真	-
学费	xuéfèi
线索	xiànsuǒ
相声	xiàngsheng
洗衣粉	xǐyīfěn
迹象	jìxiàng
指示牌	zhǐshìpái
圆满	yuánmǎn
赞助	zànzhù
要素	yàosù
皆	jiē
在场	zàichǎng
中奖	zhòngjiǎng
意想不到	yìxiǎngbùdào
精密	jīngmì
用品	yòngpǐn
圆珠笔	yuánzhūbǐ
远离	yuǎnlí
战友	zhànyǒu
挑水	tiāoshuǐ
注重	zhùzhòng
绳	shéng
绳子	shéngzi
自豪	zìháo
至于	zhìyú
款待	kuǎndài
自学	zìxué
连年	liánnián
廉洁	liánjié
廉	lián
赞美	zànměi
普拉提	pǔlātí
普	pǔ
畔	pàn
平面	píngmiàn
扰乱	rǎoluàn
生效	shēngxiào
高血压	gāoxuèyā
思念	sīniàn
伪造	wěizào
伪	wěi
辱	rǔ
侮	wǔ
侮辱	wǔrǔ
物美价廉	wùměijiàlián
辅	fǔ
相辅相成	xiāngfǔxiāngchéng
隆	lónglōnglóng
兴隆	xīnglóng
验收	yànshōu
野心	yěxīn
依托	yītuō
应邀	yìngyāo
邀	yāo
勇于	yǒngyú
忠诚	zhōngchéng
尊严	zūnyán
尊	zūn
办理	bànlǐ
比如	bǐrú
别人	biéren
表面	biǎomiàn
超过	chāoguò
哥哥	gēge
哥	gē
操作	cāozuò
出国	chūguó
出席	chūxí
精致	jīngzhì
春节	chūnjié
差别	chābié
黑板	hēibǎn
回答	huídá
承办	chéngbàn
炒作	chǎozuò
成品	chéngpǐn
功夫	gōngfu
底下	dǐxia
不像话	búxiànghuà
哺	bǔbū
哺乳	bǔrǔ
不妨	bùfáng
教学楼	jiàoxuélóu
裁员	cáiyuán
当前	dāngqián
大街	dàjiē
壶	hú
语言	yǔyán
降低	jiàngdī
返	fǎn
返回	fǎnhuí
黄色	huángsè
陈述	chénshù
可怜	kělián
怜	lián
矿泉水	kuàngquánshuǐ
泉	quán
成天	chéngtiān
夸	kuā
例如	lìrú
前边	qiánbian
筹	chóu
筹备	chóubèi
赶忙	gǎnmáng
广泛	guǎngfàn
泛	fàn
密码	mìmǎ
蓄	xù
储蓄	chǔxù
面临	miànlín
贺卡	hèkǎ
贺	hè
胡同儿	hútòngr
磁带	cídài
磁	cí
股票	gǔpiào
季度	jìdù
逮	dǎidài
逮捕	dàibǔ
横	héng
忽略	hūlüè
新历	xīnlì
首先	shǒuxiān
会长	huìzhǎng
普通	pǔtōng
焦点	jiāodiǎn
董事长	dǒngshìzhǎng
完全	wánquán
着迷	zháomí
粮食	liángshi
停电	tíngdiàn
毛笔	máobǐ
严格	yángé
无数	wúshù
看好	kānhǎokànhǎo
样子	yàngzi
邀请	yāoqǐng
慶	-
普天同慶	-
反馈	fǎnkuì
馈	kuì
名牌儿	míngpáir
内在	nèizài
联赛	liánsài
废除	fèichú
风趣	fēngqù
全球	quánqiú
前途	qiántú
人民币	rénmínbì
腐烂	fǔlàn
笑话儿	xiàohuar
皮球	píqiú
组成	zǔchéng
二哈	èr hā
一路顺风	yīlùshùnfēng
诗歌	shīgē
有空儿	yǒukòngr
古怪	gǔguài
攀岩	pānyán
攀	pān
固有	gùyǒu
抓马	zhuāmǎ
捍卫	hànwèi
捍	hàn
位置	wèizhi
唤	huàn
呼唤	hūhuàn
臉	-
嚴	-
嚴肅臉	-
肅	-
误解	wùjiě
晃	huǎng
透露	tòulù
眼前	yǎnqián
小偷儿	xiǎotōur
合影	héyǐng
欣赏	xīnshǎng
往年	wǎngnián
璃	lí
玻璃心	bō lí xīn
玻	bō
有的是	yǒudeshì
文娱	wényú
夹子	jiāzi
志愿	zhìyuàn
交叉	jiāochā
奏	zòu
演奏	yǎnzòu
瑟	sè
得瑟	dé sè
征服	zhēngfú
增大	zēngdà
隐私	yǐnsī
疲劳	píláo
娶	qǔ
终身	zhōngshēn
正当	zhèngdāng
时差	shíchā
牢骚	láosāo
骚	sāo
座谈会	zuòtánhuì
吊	diào
吊瓶	diàopíng
字体	zìtǐ
落成	luòchéng
猛烈	měngliè
猛	měng
描绘	miáohuì
拟	nǐ
拟定	nǐdìng
脊柱	jǐzhù
譬	pì
譬如	pìrú
品尝	pǐncháng
平庸	píngyōng
起源	qǐyuán
恰到好处	qiàdàohǎochù
恰巧	qiàqiǎo
勤劳	qínláo
流浪者	liúlàngzhě
任意	rènyì
数额	shù’é
挑拨	tiǎobō
响应	xiǎngyìng
效益	xiàoyì
压制	yāzhì
欲望	yùwàng
安慰	ānwèi
帮助	bāngzhù
帮	bāng
包围	bāowéi
报考	bàokǎo
表格	biǎogé
左	zuǒ
左边	zuǒbiān
批判	pīpàn
出发	chūfā
大学生	dàxuéshēng
猜测	cāicè
彩色	cǎisè
餐饮	cānyǐn
驰	chí
奔驰	bēnchí
醋	cù
国家	guójiā
大声	dàshēng
霉	méi
倒霉	dǎoméi
超越	chāoyuè
桌子	zhuōzi
场景	chǎngjǐng
方向	fāngxiàng
放弃	fàngqì
结婚	jiéhūn
从此	cóngcǐ
当中	dāngzhōng
分数	fēnshù
房屋	fángwū
看病	kànbìng
单打	dāndǎ
电子版	diànzǐbǎn
侧面	cèmiàn
抵达	dǐdá
集合	jíhé
建筑	jiànzhù
筑	zhù
渡	dù
面条儿	miàntiáor
接下来	jiēxiàlái
崇敬	chóngjìng
马虎	mǎhu
到时候	dàoshíhòu
命令	mìnglìng
快点儿	kuàidiǎnr
内科	nèikē
家乡	jiāxiāng
自洽	zì qià
巧克力	qiǎokèlì
奇迹	qíjì
日记	rìjì
确认	quèrèn
编	biān
编程	biānchéng
导向	dǎoxiàng
得力	délì
混合	hùnhé
角色	juésè
会计	kuàijì
卫生间	wèishēngjiān
来源	láiyuán
漫画	mànhuà
反之	fǎnzhī
行为	xíngwéi
联手	liánshǒu
杂志	zázhì
图片	túpiàn
分明	fēnmíng
真正	zhēnzhèng
期限	qīxiàn
前头	qiántou
签订	qiāndìng
专门	zhuānmén
造成	zàochéng
前提	qiántí
人员	rényuán
小声	xiǎoshēng
神话	shénhuà
告辞	gàocí
总算	zǒngsuàn
清洁工	qīngjiégōng
热点	rèdiǎn
体现	tǐxiàn
团结	tuánjié
首相	shǒuxiàng
书房	shūfáng
双打	shuāngdǎ
委托	wěituō
車震	-
車	-
性质	xìngzhì
演讲	yǎnjiǎng
刷屏	shuā píng
强迫症	qiǎngpòzhèng
赞赏	zànshǎng
仪器	yíqì
遗憾	yíhàn
憾	hàn
蜜蜂	mìfēng
蜂	fēng
君子	jūnzǐ
君	jūn
辟	bìpìpì
开辟	kāipì
转让	zhuǎnràng
子弹	zǐdàn
主持人	zhǔchírén
脉搏	màibó
恋	liàn
同性恋	tóngxìngliàn
派遣	pàiqiǎn
遣	qiǎn
批发	pīfā
偏僻	piānpì
僻	pì
充电宝	chōngdiàn bǎo
起草	qǐcǎo
起初	qǐchū
柬	jiǎn
请柬	qǐngjiǎn
帖	tiētiětiè
请帖	qǐngtiě
偷听	tōutīng
野外	yěwài
水利	shuǐlì
伦	lún
天伦之乐	tiānlúnzhīlè
跳跃	tiàoyuè
新颖	xīnyǐng
颖	yǐng
噪音	zàoyīn
噪	zào
渣	zhā
知足常乐	zhīzúchánglè
爱情	àiqíng
暧昧	àimèi
暧	ài
半夜	bànyè
非常	fēicháng
不错	bùcuò
不够	bùgòu
医院	yīyuàn
草地	cǎodì
弟弟	dìdi
时候	shíhou
卑	bēi
鄙	bǐ
卑鄙	bēibǐ
医生	yīshēng
氪	kè
氪金	kè jīn
关心	guānxīn
诚信	chéngxìn
待遇	dàiyù
肚	dǔdù
肚子	dùzi
抽奖	chōujiǎng
丰富	fēngfù
此前	cǐqián
大熊猫	dàxióngmāo
大于	dàyú
大致	dàzhì
发明	fāmíng
地位	dìwèi
合理	hélǐ
动员	dòngyuán
基本	jīběn
为了	wèile
各种	gèzhǒng
借口	jièkǒu
繁殖	fánzhí
遇到	yùdào
汽车	qìchē
注意	zhùyì
联合	liánhé
现代	xiàndài
苗条	miáotiao
年龄	niánlíng
龄	líng
目标	mùbiāo
活力	huólì
确实	quèshí
商量	shāngliang
奖励	jiǎnglì
能够	nénggòu
监督	jiāndū
来信	láixìn
斜	xié
体育馆	tǐyùguǎn
宣布	xuānbù
宣	xuān
强大	qiángdà
风土人情	fēngtǔrénqíng
丰满	fēngmǎn
再三	zàisān
母女	mǔnǚ
内衣	nèiyī
星星	xīngxing
总共	zǒnggòng
前来	qiánlái
率先	shuàixiān
书法	shūfǎ
毫无	háowú
想象	xiǎngxiàng
无疑	wúyí
预计	yùjì
笑脸	xiàoliǎn
笑容	xiàoróng
用户	yònghù
优先	yōuxiān
循环	xúnhuán
循	xún
昆虫	kūnchóng
昆	kūn
研发	yánfā
战争	zhàn zhēng
重大	zhòngdà
魅	mèi
魅力	mèilì
艺术家	yìshùjiā
支配	zhīpèi
撑	chēng
支撑	zhīchēng
可恶	kěwù
枯燥	kūzào
燥	zào
枯	kū
雾	wù
明智	míngzhì
沐	mù
沐浴	mùyù
派别	pàibié
谈恋爱	tánliànài
不要脸	bùyàoliǎn
生育	shēngyù
示意	shìyì
事态	shìtài
天生	tiānshēng
香料	xiāngliào
虑	lǜ
无忧无虑	wúyōuwúlǜ
潇	xiāo
洒	sǎ
潇洒	xiāosǎ
雄厚	xiónghòu
婴儿	yīng’ér
婴	yīng
诈骗	zhàpiàn
诈	zhà
钻研	zuānyán
按时	ànshí
爱戴	àidài
暗示	ànshì
报刊	bàokān
参加	cānjiā
编辑	biānjí
财产	cáichǎn
不满	bùmǎn
出差	chūchāi
很迷	hěn mí
动物	dòngwù
保障	bǎozhàng
抽象	chōuxiàng
布满	bùmǎn
电视	diànshì
希望	xīwàng
场面	chǎngmiàn
大衣	dàyī
成本	chéngběn
法律	fǎlǜ
干什么	gànshénme
见面	jiànmiàn
复印	fùyìn
处在	chǔzài
带动	dàidòng
懂得	dǒngde
面包	miànbāo
当代	dāngdài
打官司	dǎguānsi
舱	cāng
低头	dītóu
机器	jīqì
豆制品	dòuzhìpǐn
郊区	jiāoqū
馋	chán
干预	gānyù
音乐	yīnyuè
劳动	láodòng
公认	gōngrèn
干涉	gānshè
涉	shè
流传	liúchuán
处置	chǔzhì
行业	hángyè
綠	-
平常	píngcháng
海底	hǎidǐ
强调	qiángdiào
剪子	jiǎnzi
随着	suízhe
生长	shēngzhǎng
举动	jǔdòng
开幕	kāimù
骑车	qíchē
鉴定	jiàndìng
体贴	tǐtiē
贴	tiē
知识	zhīshi
叶子	yèzi
小气	xiǎoqi
友谊	yǒuyì
小腿	xiǎotuǐ
风味	fēngwèi
重视	zhòngshì
著名	zhùmíng
著	zhù
洗衣机	xǐyījī
腐朽	fǔxiǔ
朽	xiǔ
情形	qíngxíng
夜里	yèli
市区	shìqū
一生	yīshēng
躲猫猫	duǒmāomāo
痛苦	tòngkǔ
痛	tòng
住院	zhùyuàn
微笑	wēixiào
首次	shǒucì
合伙	héhuǒ
住宅区	zhùzháiqū
外出	wàichū
好胜	hàoshèng
外衣	wàiyī
治愈系	zhì yù xì
纪要	jìyào
毒舌	dú shé
舌	jīshé
依法	yīfǎ
肴	yáo
佳	jiā
佳肴	jiāyáo
见多识广	jiànduōshíguǎng
结算	jiésuàn
真相	zhēnxiàng
字母	zìmǔ
直线	zhíxiàn
主体	zhǔtǐ
可观	kěguān
丝毫	sīháo
扩散	kuòsàn
走私	zǒusī
祖父	zǔfù
祖母	zǔmǔ
兽医	shòu yī
祈	qí
祈祷	qídǎo
祷	dǎo
脱口秀	tuōkǒuxiù
平行	píngxíng
虚伪	xūwěi
尸体	shītǐ
尸	shī
司法	sīfǎ
外表	wàibiǎo
无能为力	wúnéngwéilì
无辜	wúgū
辜	gū
众所周知	zhòngsuǒzhōuzhī
转达	zhuǎndá
包子	bāozi
老板	lǎobǎn
饭店	fàndiàn
从前	cóngqián
公司	gōngsī
崩	bēng
溃	huìkuì
崩溃	bēngkuì
产业	chǎnyè
反对	fǎnduì
贬义	biǎnyì
贬	biǎn
的话	dehuà
冰雹	bīngbáo
雹	báo
好吃	hǎochī
多久	duōjiǔ
达成	dáchéng
屑	xiè
不屑一顾	búxièyígù
了解	liǎojiě
过程	guòchéng
奇怪	qíguài
开会	kāihuì
大使	dàshǐ
分散	fēnsàn
工程师	gōngchéngshī
各个	gègè
秤	chèng
领域	lǐngyù
出神	chūshén
民族	mínzú
穿越	chuānyuè
普遍	pǔbiàn
是不是	shìbùshì
集团	jítuán
巧妙	qiǎomiào
检测	jiǎncè
失望	shīwàng
急救	jíjiù
可乐	kělè
市场	shìchǎng
里面	lǐmiàn
吸引	xīyǐn
救助	jiùzhù
肯	kěn
拍摄	pāishè
营养	yíngyǎng
封锁	fēngsuǒ
火星哥	huǒ xīng gē
腐败	fǔbài
清理	qīnglǐ
改良	gǎiliáng
办公楼	bàngōnglóu
报社	bàoshè
早餐	zǎocān
光彩	guāngcǎi
团体	tuántǐ
巔	-
顏值巔峰	-
顏	-
天才	tiāncái
哄	hōng
化验	huàyàn
管子	guǎnzi
雄伟	xióngwěi
记性	jìxing
运输	yùnshū
选举	xuǎnjǔ
战士	zhànshì
笑尿	xiào niào
早期	zǎoqī
借助	jièzhù
游戏机	yóuxìjī
证实	zhèngshí
聚精会神	jùjīnghuìshén
争夺	zhēngduó
框	kuàng
框架	kuàngjià
立体	lìtǐ
领会	lǐnghuì
隆重	lóngzhòng
沫	mò
泡沫	pàomò
谦	qiān
谦逊	qiānxùn
逊	xùn
惹	rě
惹祸	rěhuò
祸	huò
荣幸	róngxìng
记忆力	jìyìlì
盛产	shèngchǎn
雕像	diāoxiàng
贪污	tānwū
拖延	tuōyán
拖	tuō
宪法	xiànfǎ
宪	xiàn
性感	xìnggǎn
炎热	yánrè
厌	yàn
厌恶	yànwù
意料	yìliào
毅然	yìrán
终究	zhōngjiū
遵循	zūnxún
遵	zūn
白色	báisè
抱歉	bàoqiàn
包装	bāozhuāng
变成	biànchéng
老公	lǎogong
播	bō
播出	bōchū
尺子	chǐzi
尺	chěchǐ
刚才	gāngcái
成交	chéngjiāo
传播	chuánbō
度娘	dù niáng
打雷	dǎléi
并列	bìngliè
累	lèi
感激	gǎnjī
航班	hángbān
规则	guīzé
开玩笑	kāiwánxiào
驶	shǐ
驾驶	jiàshǐ
京剧	jīngjù
京	jīng
分解	fēnjiě
距离	jùlí
公布	gōngbù
沉着	chénzhuó
服从	fúcóng
计算机	jìsuànjī
家庭	jiātíng
精神	jīngshén
改善	gǎishàn
成心	chéngxīn
吐实	tǔshí
高档	gāodàng
国民	guómín
难道	nándào
粹	cuì
纯粹	chúncuì
加强	jiāqiáng
老年	lǎonián
管道	guǎndào
光辉	guānghuī
解开	jiěkāi
歹	dǎi
歹徒	dǎitú
军人	jūnrén
援	yuán
救援	jiùyuán
看得起	kàndeqǐ
浓	nóng
配备	pèibèi
自黑	zì hēi
情感	qínggǎn
想起	xiǎngqǐ
热量	rèliàng
转告	zhuǎngào
平台	píngtái
一路平安	yīlùpíngān
西装	xīzhuāng
事故	shìgù
手里	shǒulǐ
事件	shìjiàn
渠	qújùqú
渠道	qúdào
却是	quèshì
有意思	yǒuyìsi
体检	tǐjiǎn
光芒	guāngmáng
芒	máng
含糊	hánhu
五颜六色	wǔyánliùsè
颜	yán
算了	suànle
现有	xiànyǒu
邮票	yóupiào
一律	yílǜ
严肃	yánsù
肃	sù
一口气	yīkǒuqì
萌萌噠	-
萌	méng
噠	-
战胜	zhànshèng
作品	zuòpǐn
招生	zhāoshēng
影迷	yǐngmí
正义	zhèngyì
制成	zhìchéng
开明	kāimíng
苦涩	kǔsè
逃避	táobì
避	bì
手痒痒	shǒu yǎngyang
留念	liúniàn
渺	miǎo
渺小	miǎoxiǎo
帖子	tiězi
好奇心	hàoqíxīn
难能可贵	nánnéngkěguì
歧视	qíshì
审美	shěnměi
瞎	xiā
瞎扯	xiāchě
扯	chě
代笔	dàibǐ
堕胎	duòtāi
瘾	yǐn
上瘾	shàngyǐn
盛情	shèngqíng
首要	shǒuyào
艘	sōu
随即	suíjí
索性	suǒxìng
探望	tànwàng
未免	wèimiǎn
掩	yǎn
掩盖	yǎngài
一度	yídù
以致	yǐzhì
忧郁	yōuyù
郁	yù
预料	yùliào
郑重	zhèngzhòng
郑	zhèng
致力	zhìlì
专长	zhuāncháng
宝石	bǎoshí
不对	bùduì
部分	bùfen
便条	biàntiáo
吃饭	chīfàn
电梯	diàntī
病情	bìngqíng
妹妹	mèimei
爸爸	bàba
爸	bà
妈	mā
妈妈	māma
产品	chǎnpǐn
导游	dǎoyóu
测定	cèdìng
名字	míngzi
烦恼	fánnǎo
父亲	fùqīn
范围	fànwéi
道德	dàodé
黄金	huángjīn
草率	cǎoshuài
多年	duōnián
多种	duōzhǒng
防治	fángzhì
畅销	chàngxiāo
分为	fēnwéi
蹲	dūn
可是	kěshì
可惜	kěxī
军事	jūnshì
国内	guónèi
分工	fēngōng
终于	zhōngyú
等一会儿	děng yīhuìr
母亲	mǔqīn
美术	měishù
偶尔	ǒu’ěr
排列	páiliè
皮下	pí xià
次品	cìpǐn
汇报	huìbào
粗鲁	cūlǔ
鲁	lǔ
老朋友	lǎopéngyou
火灾	huǒzāi
给予	jǐyǔ
熟练	shúliàn
利益	lìyì
解鎖技能	-
鎖	-
多元化	duōyuánhuà
苏	sū
苏州	sūzhōu
内心	nèixīn
学术	xuéshù
听讲	tīngjiǎng
理智	lǐzhì
责任	zérèn
西餐	xīcān
民警	mínjǐng
争取	zhēngqǔ
认可	rènkě
嚕	-
天啦嚕	-
上衣	shàngyī
状况	zhuàngkuàng
药片	yàopiàn
手套	shǒutào
举重	jǔzhòng
公证	gōngzhèng
飯拍	-
生活费	shēnghuófèi
逃跑	táopǎo
往后	wǎnghòu
往来	wǎnglái
安利	ān lì
旋转	xuánzhuǎn
种植	zhòngzhí
占领	zhànlǐng
惊奇	jīngqí
遭受	zāoshòu
慨	kǎi
慷慨	kāngkǎi
慷	kāng
立法	lìfǎ
美观	měiguān
着凉	zháoliáng
搞笑	gǎoxiào
翘	qiào
手腕	shǒuwàn
腕	wàn
停顿	tíngdùn
滞	zhì
停滞	tíngzhì
同志	tóngzhì
信誉	xìnyù
遗失	yíshī
隐蔽	yǐnbì
蔽	bì
杂交	zájiāo
暂	zàn
暂且	zànqiě
指望	zhǐwàng
踪	zōng
踪迹	zōngjì
白天	báitiān
扒	bā
毕业	bìyè
必须	bìxū
磅	bàng
厕所	cèsuǒ
成功	chénggōng
地铁	dìtiě
不易	bùyì
打车	dǎchē
地点	dìdiǎn
备忘录	bèiwànglù
参赛	cānsài
电影院	diànyǐngyuàn
大大	dàdà
鄙视	bǐshì
对话	duìhuà
方面	fāngmiàn
对比	duìbǐ
变故	biàngù
撤销	chèxiāo
分手	fēnshǒu
膊	bó
胳	gē
胳膊	gēbo
博大精深	bódàjīngshēn
满意	mǎnyì
官宣	guān xuān
独立	dúlì
婚礼	hūnlǐ
骄傲	jiāo’ào
傲	ào
骄	jiāo
耳机	ěrjī
同事	tóngshì
夺取	duóqǔ
考虑	kǎolǜ
故乡	gùxiāng
犯规	fànguī
飞船	fēichuán
骏	jùn
崎	qí
宫崎骏	gōngqíjùn
上车	shàngchē
哪怕	nǎpà
平时	píngshí
期待	qīdài
记载	jìzǎi
请求	qǐngqiú
受不了	shòubuliǎo
靠近	kàojìn
揭	jiē
连续	liánxù
惊喜	jīngxǐ
通常	tōngcháng
军队	jūnduì
娘炮	niáng pào
轮船	lúnchuán
训练	xùnliàn
意外	yìwài
风气	fēngqì
全面	quánmiàn
西方	xīfāng
民意	mínyì
感染	gǎnrǎn
爱惜	àixī
功劳	gōngláo
摔	shuāi
饮食	yǐnshí
特定	tèdìng
首脑	shǒunǎo
首席	shǒuxí
喜爱	xǐài
协议	xiéyì
傻白甜	shǎ bái tián
行驶	xíngshǐ
讳	huì
忌	jì
忌讳	jìhuì
引进	yǐnjìn
愉	yú
愉悦	yúyuè
小婊砸	xiǎo biǎo zá
砸	zá
婊	biǎo
正版	zhèngbǎn
遭到	zāodào
营造	yíngzào
忠心	zhōngxīn
搂	lǒu
气压	qìyā
拆	chāi
拆哪儿	chāi nǎr
曲子	qǔzi
容器	róngqì
深奥	shēn’ào
俗语	súyǔ
束	shù
缚	fù
束缚	shùfù
素食	sùshí
停泊	tíngbó
娃娃菜	wáwa cài
推理	tuīlǐ
无微不至	wúwēibúzhì
挂	guà
悬挂	xuánguà
踊	yǒng
踊跃	yǒngyuè
诱惑	yòuhuò
诱	yòu
肪	fáng
脂肪	zhīfáng
脂	zhī
自卑	zìbēi
爱人	àiren
大家	dàjiā
矮小	ǎixiǎo
保持	bǎochí
例子	lìzi
病人	bìngrén
标题	biāotí
播放	bōfàng
出现	chūxiàn
不至于	bùzhìyú
星期	xīngqī
测量	cèliáng
不禁	bùjīn
东西	dōngxi
读书	dúshū
堵车	dǔchē
虫子	chóngzi
机会	jīhuì
香蕉	xiāngjiāo
蕉	jiāoqiáo
出动	chūdòng
大巴	dàbā
出事	chūshì
储存	chǔcún
不言而喻	bùyán’éryù
喻	yù
倒车	dǎochēdàochē
发音	fāyīn
认为	rènwéi
话题	huàtí
盗版	dàobǎn
道教	dàojiào
聚会	jùhuì
退散	tuì sàn
划船	huáchuán
批评	pīpíng
慈祥	cíxiáng
女士	nǚshì
热闹	rènao
亲切	qīnqiè
和谐	héxié
谐	xié
午饭	wǔfàn
阶段	jiēduàn
混血儿	hùnxue3ér
考验	kǎoyàn
手术	shǒushù
扩展	kuòzhǎn
污染	wūrǎn
日子	rìzi
中学生	zhōngxuéshēng
美食	měishí
绕	rào
围绕	wéirào
军舰	jūnjiàn
戏剧	xìjù
所以	suǒyǐ
方圆	fāngyuán
内部	nèibù
同样	tóngyàng
裂	liè
暂时	zànshí
培训	péixùn
前往	qiánwǎng
楼道	lóudào
情景	qíngjǐng
身材	shēncái
上级	shàngjí
臊	sāo
工艺品	gōngyìpǐn
攻克	gōngkè
胜负	shèngfù
管辖	guǎnxiá
辖	xiá
手续费	shǒuxùfèi
薯条	shǔtiáo
说实话	shuōshíhuà
项目	xiàngmù
延期	yánqī
修养	xiūyǎng
夜间	yèjiān
阴谋	yīnmóu
展示	zhǎnshì
精通	jīngtōng
支援	zhīyuán
足以	zúyǐ
联欢	liánhuān
晾	liàng
流氓	liúmáng
氓	mángméng
络绎不绝	luòyìbùjué
络	làoluò
绎	yì
弥补	míbǔ
清除	qīngchú
缔	dì
取缔	qǔdì
世代	shìdài
视野	shìyě
威风	wēifēng
志气	zhìqì
重心	zhòngxīn
专程	zhuānchéng
搬家	bānjiā
晚上	wǎnshàng
吃惊	chījīng
表面上	biǎomiànshang
不必	bùbì
听不懂	tīngbudǒng
手机	shǒujī
此外	cǐwài
奔波	bēnbō
地表最強	-
強	-
铅笔	qiánbǐ
铅	qiān
带来	dàilái
重组	chóngzǔ
礼物	lǐwù
大陆	dàlù
滚	gǔn
基础	jīchǔ
础	chǔ
继续	jìxù
继	jì
减少	jiǎnshǎo
记忆	jìyì
颤	chàn
颤抖	chàndǒu
分享	fēnxiǎng
发电	fādiàn
辅助	fǔzhù
尽量	jìnliàng
果然	guǒrán
充当	chōngdāng
理由	lǐyóu
面前	miànqián
月饼	yuèbǐng
使用	shǐyòng
圣诞节	shèngdànjié
接触	jiēchù
尽力	jìnlì
激情	jīqíng
提供	tígōng
提醒	tíxǐng
手续	shǒuxù
有的	yǒude
节奏	jiézòu
往往	wǎngwǎng
统一	tǒngyī
对策	duìcè
推辞	tuīcí
东南西北	dōngnánxīběi
万一	wànyī
位于	wèiyú
迷人	mírén
明明	míngmíng
想到	xiǎngdào
杠杆	gànggǎn
杆	gāngǎn
杠	gānggàng
门把	mén bǎ
企图	qǐtú
食品	shípǐn
深处	shēnchù
同框	tóng kuāng
孤立	gūlì
特殊	tèshū
替代	tìdài
这样	zhèyàng
打交道	dǎjiāodao
国务院	guówùyuàn
过失	guòshī
耗费	hàofèi
停留	tíngliú
恭喜	gōngxǐ
需求	xūqiú
需	xū
姻	yīn
婚姻	hūnyīn
拣	jiǎn
有利于	yǒulìyú
剖	pōu
解剖	jiěpōu
自主	zìzhǔ
异常	yìcháng
支出	zhīchū
据悉	jùxī
高调	gāodiào
诸位	zhūwèi
诸	zhū
况且	kuàngqiě
凌晨	língchén
语气	yǔqì
印度人	yìndùrén
名次	míngcì
殴打	ōudǎ
殴	ōu
任命	rènmìng
骚扰	sāorǎo
嫂	sǎo
嫂子	sǎozi
条款	tiáokuǎn
妥协	tuǒxié
妄想	wàngxiǎng
妄	wàng
宣誓	xuānshì
摇滚	yáogǔn
报到	bàodào
班级	bānjí
國	-
國漫	-
变动	biàndòng
必修	bìxiū
不同	bùtóng
承担	chéngdān
常见	chángjiàn
鸡蛋	jīdàn
手表	shǒubiǎo
问题	wèntí
旅行	lǚxíng
充满	chōngmǎn
冻	dòng
客人	kèrén
讽刺	fěngcì
刺	cì
讽	fěng
火车	huǒchē
机票	jīpiào
电动车	diàndòngchē
饺子	jiǎozi
饺	jiǎo
歌声	gēshēng
写作	xiězuò
各地	gèdì
一样	yíyàng
愿意	yuànyì
巩固	gǒnggù
巩	gǒng
划分	huàfēn
火柴	huǒchái
大臣	dàchén
臣	chén
名称	míngchēng
下车	xiàchē
日用品	rìyòngpǐn
商品	shāngpǐn
姐妹	jiěmèi
碰到	pèngdào
双方	shuāngfāng
调整	tiáozhěng
救命	jiùmìng
兴奋	xīngfèn
明亮	míngliàng
年度	niándù
分辨	fēnbiàn
招聘	zhāopìn
外地	wàidì
午餐	wǔcān
赞成	zànchéng
填坑	tián kēng
填	tián
仍旧	réngjiù
拉拉	lā lā
抱大腿	bào dà tuǐ
赛场	sàichǎng
归根到底	guīgēndàodǐ
过问	guòwèn
事后	shìhòu
试点	shìdiǎn
调解	tiáojiě
哼	hēng
退货	tuìhuò
公主病	gōng zhǔ bìng
演唱	yǎnchàng
激发	jīfā
激励	jīlì
公司法	gōngsīfǎ
邮箱	yóuxiāng
医学	yīxué
寞	mò
寂寞	jìmò
烟花	yānhuā
眼看	yǎnkàn
交涉	jiāoshè
笑点	xiào diǎn
精心	jīngxīn
援助	yuánzhù
举足轻重	jǔzúqīngzhòng
灵敏	língmǐn
媒介	méijiè
魄	pò
魄力	pòlì
牵扯	qiānchě
牵	qiān
权威	quánwēi
失踪	shīzōng
野人	yěrén
手艺	shǒuyì
提议	tíyì
统治	tǒngzhì
违背	wéibèi
漆	qī
油漆	yóuqī
攒	zǎn
揍	zòu
必要	bìyào
报道	bàodào
保密	bǎomì
不管	bùguǎn
必需	bìxū
参考	cānkǎo
宾	bīn
宾馆	bīngguǎn
车站	chēzhàn
常识	chángshí
变形	biànxíng
病房	bìngfáng
程序	chéngxù
东边	dōngbian
纵	zòng
操纵	cāozòng
大部分	dàbùfen
亚洲	yàzhōu
会议	huìyì
处于	chǔyú
检查	jiǎnchá
表彰	biǎozhāng
彰	zhāng
国外	guówài
短处	duǎnchù
大都	dàdūdàdōudàdū
单纯	dānchún
不堪	bùkān
代价	dàijià
登山	dēngshān
打断	dǎduàn
访问	fǎngwèn
喊	hǎn
倡议	chàngyì
付出	fùchū
扩大	kuòdà
姥	lǎomǔ
姥姥	lǎolao
零钱	língqián
话剧	huàjù
谦虚	qiānxū
西边	xībiān
救灾	jiùzāi
外公	wàigōng
铃声	língshēng
信心	xìnxīn
最好	zuìhǎo
面貌	miànmào
梦见	mèngjiàn
面试	miànshì
提到	tídào
移民	yímín
移	yí
匹	pǐ
祝贺	zhùhè
评选	píngxuǎn
量词	liàngcí
颂	sòng
歌颂	gēsòng
神经	shénjīng
文明	wénmíng
即便	jíbiàn
亚军	yàjūn
检讨	jiǎntǎo
旺	wàng
兴旺	xīngwàng
鉴于	jiànyú
将就	jiāng jiù
之前	zhīqián
拘留	jūliú
拘	jū
指责	zhǐzé
后院	hòuyuàn
总裁	zǒngcái
刻不容缓	kèbùrónghuǎn
连锁	liánsuǒ
分担	fēndān
清真	qīngzhēn
赴	fù
全力以赴	quánlìyǐfù
衰老	shuāilǎo
衰	shuāi
万分	wànfēn
无赖	wúlài
壮丽	zhuànglì
廊	láng
走廊	zǒuláng
您	nín
白菜	báicài
怎么样	zěnmeyàng
高级	gāojí
报警	bàojǐng
巴结	bājié
爆炸	bàozhà
表情	biǎoqíng
不断	búduàn
看不懂	kànbudǒng
参展	cānzhǎn
称为	chēngwéi
成果	chéngguǒ
常年	chángnián
方式	fāngshì
坏了	huài le
禁欲	jìn yù
大纲	dàgāng
合作	hézuò
后背	hòubèi
服装	fúzhuāng
坚持	jiānchí
将来	jiānglái
改造	gǎizào
相信	xiāngxìn
需要	xūyào
实习	shíxí
加工	jiāgōng
裝	-
裝逼犯	-
青年	qīngnián
球队	qiúduì
思想	sīxiǎng
随身	suíshēn
困扰	kùnrǎo
早饭	zǎofàn
老实	lǎoshí
形势	xíngshì
原因	yuányīn
估	gūgù
评估	pínggū
泼	pō
职业	zhíyè
慢车	mànchē
责备	zébèi
自信	zìxìn
抚摸	fǔmō
证件	zhèngjiàn
排行榜	páihángbǎng
食堂	shítáng
似的	shìde
泥石流	ní shí liú
情绪	qíngxù
固执	gùzhi
盛行	shèngxíng
消费	xiāofèi
恍然大悟	huǎngrándàwù
恍	huǎng
依靠	yīkào
移动	yídòng
一下子	yīxiàzi
协会	xiéhuì
掰弯	bāi wān
掰	bāi
悲催	bēi cuī
催	cuī
竭尽全力	jiéjìnquánlì
竭	jié
涨价	zhǎngjià
竞选	jìngxuǎn
执行	zhíxíng
家家户户	jiājiāhùhù
转换	zhuǎnhuàn
中外	zhōngwài
零星	língxīng
潜移默化	qiányí-mòhuà
苏醒	sūxǐng
托运	tuōyùn
习俗	xísú
袭击	xíjī
袭	xí
霞	xiá
严密	yánmì
眼色	yǎnsè
罢了	bàlebàliǎo
案件	ànjiàn
彩虹屁	cǎi hóng pì
避免	bìmiǎn
补课	bǔkè
采购	cǎigòu
还是	háishì
动力	dònglì
旅游	lǚyóu
冲动	chōngdòng
草莓	cǎoméi
经理	jīnglǐ
感动	gǎndòng
共同	gòngtóng
大规模	dàguīmó
公开	gōngkāi
帽子	màozi
沟通	gōutōng
沟	gōu
导致	dǎozhì
记住	jìzhu
呆	dāi
发行	fāxíng
选择	xuǎnzé
择	zé
桔	jié
桔子	júzi
来自	láizì
出息	chūxi
计算	jìsuàn
拼音	pīnyīn
瞧	qiáo
申请	shēnqǐng
申	shēn
经营	jīngyíng
得不偿失	débùchángshī
雕塑	diāosù
全国	quánguó
无论	wúlùn
录音	lùyīn
土豆	tǔdòu
兑现	duìxiàn
现象	xiànxiàng
描写	miáoxiě
形容	xíngróng
礼堂	lǐtáng
秒回	miǎo huí
事先	shìxiān
游客	yóukè
欲求不满	yù qiú bù mǎn
水分	shuǐfèn
特有	tèyǒu
发愁	fāchóu
吸收	xīshōu
为主	wéizhǔ
慰问	wèiwèn
通道	tōngdào
无关	wúguān
协商	xiéshāng
状态	zhuàngtài
遭遇	zāoyù
装饰	zhuāngshì
资助	zīzhù
只得	zhǐdé
非洲	fēizhōu
学历	xuélì
游览	yóulǎn
盲目	mángmù
伏	fú
起伏	qǐfú
钦	qīn
钦佩	qīnpèi
容貌	róngmào
锈	xiù
生锈	shēngxiù
婪	lán
贪婪	tānlán
兼	jiān
统筹兼顾	tǒngchóujiāngù
悬崖峭壁	xuányáqiàobì
崖	yá
掩饰	yǎnshì
办公室	bàngōngshì
爆发	bàofā
饼干	bǐnggān
并且	bìngqiě
发生	fāshēng
半途而废	bàntú’érfèi
称赞	chēngzàn
长期	chángqī
吵	chǎo
吵架	chǎojià
放学	fàngxué
出售	chūshòu
促进	cùjìn
濒	bīn
濒临	bīnlín
打败	dǎbài
理论	lǐlùn
答复	dáfù
打动	dǎdòng
好奇	hàoqí
得了	déledéliǎo
飞行	fēixíng
欧洲	ōuzhōu
忽视	hūshì
费用	fèiyòng
容易	róngyì
水平	shuǐpíng
早睡早起	zǎoshuìzǎoqǐ
嘉宾	jiābīn
发布	fābù
结实	jiēshi
公元	gōngyuán
口味	kǒuwèi
礼貌	lǐmào
光临	guānglín
冒险	màoxiǎn
杠精	gàng jīng
人才	réncái
幻	huàn
幻想	huànxiǎng
镜头	jìngtóu
居然	jūrán
态度	tàidu
连续剧	liánxùjù
断定	duàndìng
模仿	mófǎng
引起	yǐnqǐ
宴	yàn
宴会	yànhuì
排除	páichú
锋利	fēnglì
心中	xīnzhōng
纲领	gānglǐng
起诉	qǐsù
实行	shíxíng
强盗	qiángdào
属于	shǔyú
贯彻	guànchè
贯	guàn
自驾游	zìjiàyóu
睡眠	shuìmián
烘	hōng
细致	xìzhì
枝	zhī
克制	kèzhì
伸懒腰	shēnlǎnyāo
倾斜	qīngxié
若干	ruògān
投机	tóujī
酗	xù
酗酒	xùjiǔ
序言	xùyán
言论	yánlùn
贼	zéi
幢	zhuàng
卓	zhuó
卓越	zhuóyuè
本科	běnkē
北边	běibiān
担心	dānxīn
出院	chūyuàn
公园	gōngyuán
跑步	pǎobù
大人	dàren
弊病	bìbìng
遍布	biànbù
得出	déchū
标记	biāojì
知道	zhīdao
可以	kěyǐ
不可思议	bùkěsīyì
对方	duìfāng
年级	niánjí
防止	fángzhǐ
生气	shēngqì
递给	dìgěi
孕	yùn
怀孕	huáiyùn
怀	huái
观点	guāndiǎn
动手	dòngshǒu
缠	chán
缠绕	chánrào
节省	jiéshěng
南边	nánbian
今后	jīnhòu
举手	jǔshǒu
丛	cóng
速度	sùdù
简历	jiǎnlì
收入	shōurù
碰见	pèngjiàn
家电	jiādiàn
特色	tèsè
类型	lèixíng
小伙子	xiǎohuǒzi
毛病	máobìng
捐	juān
捐赠	juānzèng
捐助	juānzhù
康复	kāngfù
享受	xiǎngshòu
于是	yúshì
前进	qiánjìn
平均	píngjūn
均	jūn
晚餐	wǎncān
设备	shèbèi
配置	pèizhì
药水	yàoshuǐ
骨干	gǔgàn
视为	shìwéi
早晨	zǎochén
透明	tòumíng
迷弟	mí dì
走开	zǒukāi
四处	sìchù
通讯	tōngxùn
讯	xùn
鼓舞	gǔwǔ
活该	huógāi
意识	yìshí
治疗	zhìliáo
戒备	jièbèi
最佳	zuìjiā
埋伏	máifú
抛	pāo
抛弃	pāoqì
起哄	qǐhòng
趣味	qùwèi
烁	shuò
闪烁	shǎnshuò
上任	shàngrèn
疏	shū
疏忽	shūhū
爽	shuǎng
爽快	shuǎngkuài
武装	wǔzhuāng
销毁	xiāohuǐ
运算	yùnsuàn
制裁	zhìcái
北京	Běijīng
博士	bóshì
背后	bèihòu
本期	běnqī
部门	bùmén
笔试	bǐshì
不利	bùlì
放心	fàngxīn
电影	diànyǐng
得意	déyì
拆除	chāichú
大门	dàmén
边疆	biānjiāng
疆	jiāng
乘车	chéngchē
超出	chāochū
等到	děngdào
表态	biǎotài
公交车	gōngjiāochē
及时	jíshí
段落	duànluò
风度	fēngdù
夫妇	fūfù
负担	fùdān
恐怕	kǒngpà
照片	zhàopiàn
出卖	chūmài
敢于	gǎnyú
等等	děngděng
目的	mùdì
书包	shūbāo
仅仅	jǐnjǐn
中秋节	zhōngqiūjié
会见	huìjiàn
商务	shāngwù
双关语	shuāngguānyǔ
精品	jīngpǐn
稳定	wěndìng
破产	pòchǎn
企业	qǐyè
前景	qiánjǐng
嚇尿	-
附	fù
附和	fùhè
赋予	fùyǔ
受灾	shòuzāi
这么	zhème
显示	xiǎnshì
不舒服	bù shūfu
何况	hékuàng
及早	jízǎo
早已	zǎoyǐ
心愿	xīnyuàn
因而	yīn’ér
智能	zhìnéng
精打细算	jīngdǎxìsuàn
经纬	jīngwěi
纬	wěi
之中	zhīzhōng
自言自语	zìyánzìyǔ
力求	lìqiú
冒充	màochōng
全球变暖	quánqiú biànnuǎn
南辕北辙	nányuánběizhé
辕	yuán
辙	zhé
编剧	biānjù
宣扬	xuānyáng
周密	zhōumì
安排	ānpái
安宁	ānníng
报纸	bàozhǐ
本领	běnlǐng
拜年	bàinián
颁布	bānbù
不久	bùjiǔ
操场	cāochǎng
错误	cuòwù
打招呼	dǎzhāohu
不止	bùzhǐ
出示	chūshì
拆迁	chāiqiān
开始	kāishǐ
发展	fāzhǎn
发言	fāyán
打听	dǎting
练习	liànxí
怀念	huáiniàn
活跃	huóyuè
发觉	fājué
定时	dìngshí
各位	gèwèi
福利	fúlì
枣	zǎo
吹捧	chuīpěng
捧	pěng
实用	shíyòng
千万	qiānwàn
回头	huítóu
机遇	jīyù
破坏	pòhuài
近期	jìnqī
燃烧	ránshāo
烧	shāo
顺便	shùnbiàn
瞪	dèng
寿命	shòumìng
东张西望	dōngzhāngxīwàng
解说	jiěshuō
老家	lǎojiā
嗯	en
嗯嗯	en en
少年	shàonián
维修	wéixiū
印象	yìnxiàng
糟糕	zāogāo
糟	zāo
名义	míngyì
能否	néngfǒu
上面	shàngmiàn
萌炸	méng zhà
休假	xiūjià
高涨	gāozhǎng
跟踪	gēnzōng
强势	qiángshì
势力	shìlì
碧	bì
碧池	bì chí
涉及	shèjí
外交	wàijiāo
哇	wa
遗产	yíchǎn
乙	yǐ
信仰	xìnyǎng
预备	yùbèi
原始	yuánshǐ
一路上	yīlùshàng
主席	zhǔxí
中药	zhōngyào
主办	zhǔbàn
恐怖	kǒngbù
作废	zuòfèi
事迹	shìjì
瘫	tān
瘫痪	tānhuàn
痪	huàn
提拔	tíbá
推论	tuīlùn
威信	wēixìn
隘	ài
狭隘	xiá’ài
紊	wěn
有条不紊	yǒutiáobùwěn
俱	jù
与日俱增	yǔrìjùzēng
安装	ānzhuāng
拔苗助长	bámiáozhùzhǎng
本质	běnzhì
茶叶	cháyè
部队	bùduì
查看	chákàn
度过	dùguò
高兴	gāoxìng
诺	nuò
承诺	chéngnuò
经过	jīngguò
感觉	gǎnjué
筷子	kuàizi
筷	kuài
改进	gǎijìn
高中	gāo zhōng
打造	dǎzào
太阳	tàiyáng
调研	diàoyán
沉思	chénsī
改革	gǎigé
男生	nánshēng
讲话	jiǎnghuà
分裂	fēnliè
照相机	zhàoxiàngjī
内容	nèiróng
某	mǒu
平方	píngfāng
即将	jíjiāng
伤心	shāngxīn
当事人	dāngshìrén
当务之急	dāngwùzhījí
花费	huāfèi
农历	nónglì
舍不得	shěbude
抬	tái
时代	shídài
居住	jūzhù
损失	sǔnshī
总结	zǒngjié
实现	shíxiàn
轮子	lúnzi
跨	kuà
膝	xī
膝盖	xīgài
留言	liúyán
色彩	sècǎi
生产	shēngchǎn
自由	zìyóu
鸽子	gēzi
鸽	gē
称呼	chēnghu
融入	róngrù
上当	shàngdàng
只能	zhǐnéng
师父	shīfu
迷妹	mí mèi
躲藏	duǒcáng
呼吁	hūyù
吁	xūyù
提交	tíjiāo
通行	tōngxíng
业务	yèwù
巨	jù
艰巨	jiānjù
监视	jiānshì
心灵	xīnlíng
注视	zhùshì
过日子	guòrìzi
带头	dàitóu
挎	kuà
宽容	kuānróng
历来	lìlái
谅解	liàngjiě
要不	yàobù
宁肯	nìngkěn
生疏	shēngshū
安身立命	ānshēnlìmìng
推测	tuīcè
无耻	wúchǐ
意向	yìxiàng
源泉	yuánquán
蕴藏	yùncáng
展望	zhǎnwàng
资深	zīshēn
班长	bānzhǎng
暴露	bàolù
暴雨	bàoyǔ
技術宅	-
術	-
波动	bōdòng
成立	chénglì
打开	dǎkāi
报复	bàofù
充分	chōngfèn
结束	jiéshù
观众	guānzhòng
大胆	dàdǎn
激动	jīdòng
积累	jīlěi
及格	jígé
端午节	uānwǔjié
嘲	cháozhāo
嘲笑	cháoxiào
结合	jiéhé
看法	kànfǎ
交朋友	jiāopéngyou
咖位	kā weì
快要	kuàiyào
从容	cóngróng
搓	cuō
实际	shíjì
摄影	shèyǐng
试卷	shìjuàn
特点	tèdiǎn
袜子	wàzi
袜	wà
预约	yùyuē
退休	tuìxiū
开夜车	kāiyèchē
迷信	míxìn
养成	yǎngchéng
太太	tàitai
录音机	lùyīnjī
封建	fēngjiàn
问路	wènlù
感慨	gǎnkǎi
行动	xíngdòng
总理	zǒnglǐ
杀毒	shādú
杀	shā
实际上	shíjìshàng
帅哥	shuàigē
帅	shuài
勾	gōugōugòu
勾结	gōujié
水产品	shuǐchǎnpǐn
意义	yìyì
审查	shěnchá
孔雀女	kǒng què nǚ
偷偷	tōutōu
送行	sòngxíng
下降	xiàjiàng
形式	xíngshì
尖锐	jiānruì
只是	zhǐshì
解雇	jiěgù
主管	zhǔguǎn
障碍	zhàng’ài
整顿	zhěngdùn
纪录片	jìlùpiān
蒙古族	měnggǔzú
气魄	qìpò
土豪	tǔháo
俏皮	qiàopi
俏	qiào
生机	shēngjī
识别	shíbié
一举两得	yìjǔliǎngdé
鞭炮	biānpào
鞭	biān
辩论	biànlùn
不然	bùrán
时间	shíjiān
不便	bùbiàn
根据	gēnjù
场合	chǎnghé
残疾	cánjí
耽误	dānwu
耽	dān
难过	nánguò
重建	chóngjiàn
传递	chuándì
概括	gàikuò
传出	chuánchū
打架	dǎjià
明白	míngbai
活泼	huópō
参照	cānzhào
残留	cánliú
节约	jiéyuē
没有	méiyǒu
专注	zhuānzhù
防范	fángfàn
海关	hǎiguān
满足	mǎnzú
好转	hǎozhuǎn
轻视	qīngshì
竞赛	jìngsài
老太太	lǎotàitai
叮	dīng
叮嘱	dīngzhǔ
拉开	lākāi
督促	dūcù
流通	liútōng
恩怨	ēnyuàn
陆续	lùxù
发呆	fādāi
法人	fǎrén
理财	lǐcái
期间	qījiān
西医	xīyī
阂	hé
隔阂	géhé
侵犯	qīnfàn
共鸣	gòngmíng
鸣	míng
退出	tuìchū
网络	wǎngluò
无所谓	wúsuǒwèi
谓	wèi
形象	xíngxiàng
通红	tōnghóng
退票	tuìpiào
混淆	hùnxiáo
淆	xiáo
外部	wàibù
偶像包袱	ǒu xiàng bāo fu
袱	fú
渣男	zhā nán
兼职	jiānzhí
業界良心	-
業	-
剪彩	jiǎncǎi
足球	zúqiú
迎来	yínglái
应对	yìngduì
嘴巴	zuǐba
惕	tì
警惕	jǐngtì
救济	jiùjì
自杀	zìshā
遵守	zūnshǒu
埋怨	mányuàn
盘旋	pánxuán
荣誉	róngyù
声势	shēngshì
私自	sīzì
文物	wénwù
新陈代谢	xīnchéndàixiè
迎面	yíngmiàn
振奋	zhènfèn
震撼	zhènhàn
撼	hàn
制止	zhìzhǐ
摆动	bǎidòng
笔记本	bǐjìběn
不客气	búkèqì
不得了	bùdéliǎo
耳朵	ěrduo
本钱	běnqián
动作	dòngzuò
对于	duìyú
反正	fǎnzhèng
感谢	gǎnxiè
大多	dàduō
关键	guānjiàn
发动	fādòng
典型	diǎnxíng
动态	dòngtài
结账	jiézhàng
构造	gòuzào
光盘	guāngpán
难受	nánshòu
上课	shàngkè
摩托车	mótuōchē
乓	pāng
乒	pīng
乒乓球	pīngpāngqiú
交警	jiāojǐng
缺少	quēshǎo
难听	nántīng
械	xiè
机械	jīxiè
剧本	jùběn
绝望	juéwàng
通知	tōngzhī
脸盆	liǎnpén
嗦	suō
哆	duō
哆嗦	duōsuo
委屈	wěiqu
屈	qū
物质	wùzhì
想念	xiǎngniàn
义务	yìwù
晚报	wǎnbào
专心	zhuānxīn
以下	yǐxià
中餐	zhōngcān
研制	yánzhì
华裔	huáyì
鑄	-
鐵	-
鑄鐵	zhùtiě
用心	yòngxīn
摆着	bǎizhe
低调	dīdiào
声调	shēngdiào
叨	dāotāo
唠叨	láodao
拳	quán
拳头	quántou
猜想	cāixiǎng
申报	shēnbào
耸	sǒng
诬	wū
诬陷	wūxiàn
泄露	xièlòu
行政	xíngzhèng
须知	xūzhī
悬念	xuánniàn
振兴	zhènxīng
逐年	zhúnián
挨打	áidǎ
办公	bàngōng
巴不得	bābude
一起	yìqǐ
北极	běijí
工具	gōngjù
打印	dǎyìn
装修	zhuāngxiū
创造	chuàngzào
街道	jiēdào
感想	gǎnxiǎng
布局	bùjú
热情	rèqíng
健身	jiànshēn
文化	wénhuà
新鲜	xīnxiān
舅舅	jiùjiu
舅	jiù
赶不上	gǎnbùshàng
川流不息	chuānliúbùxī
床单	chuángdān
吹牛	chuīniú
供给	gōngjǐ
难免	nánmiǎn
关联	guānlián
淡季	dànjì
淡水	dànshuǐ
点缀	diǎnzhuì
缀	zhuì
老百姓	lǎobǎixìng
白毛女	bái máo nǚ
性格	xìnggé
开设	kāishè
一致	yízhì
仔细	zǐxì
影片	yǐngpiàn
拖鞋	tuōxié
鲜明	xiānmíng
箱子	xiāngzi
研究生	yánjiūshēng
药物	yàowù
学科	xuékē
见闻	jiànwén
顏值爆表	-
自觉	zìjué
难怪	nánguài
追求	zhuīqiú
中断	zhōngduàn
阻碍	zǔ’ài
澳洲	àozhōu
力争	lìzhēng
眯	mī
唯独	wéidú
斥	chì
排斥	páichì
迫不及待	pòbùjídài
潜水	qiánshuǐ
砂	shā
磨砂	móshā
仁慈	réncí
高管	gāoguǎn
斯文	sīwen
滔滔不绝	tāotāobùjué
滔	tāo
剂	jì
调剂	tiáojì
缉	jīqī
通缉	tōngjī
酌	zhuó
斟	zhēn
斟酌	zhēnzhuó
办法	bànfǎ
帮忙	bāngmáng
玻璃	bōli
斑	bān
逛街	guàngjiē
聪明	cōngming
聪	cōng
前面	qiánmiàn
不时	bùshí
现在	xiànzài
附近	fùjìn
檔	-
定檔	-
事情	shìqing
小姐	xiǎojiě
创新	chuàngxīn
广告	guǎnggào
习惯	xíguàn
巨大	jùdà
来得及	láidejí
跟前	gēnqián
官方	guānfāng
窜	cuàn
答辩	dábiàn
缺点	quēdiǎn
课程	kèchéng
降价	jiàngjià
趟	tàng
受伤	shòushāng
摔倒	shuāidǎo
主意	zhǔyi
吸取	xīqǔ
反感	fǎngǎn
冷水	lěngshuǐ
前后	qiánhòu
上下	shàngxià
谈判	tánpàn
所在	suǒzài
销售	xiāoshòu
经商	jīngshāng
造型	zàoxíng
一次性	yīcìxìng
装置	zhuāngzhì
精益求精	jīngyìqiújīng
中央	zhōngyāng
央	yāng
刊登	kāndēng
朴素	pǔsù
朴	piáopòpǔ
迁就	qiānjiù
啥	shá
特长	tècháng
熏陶	xūntáo
熏	xūn
淹	yān
淹没	yānmò
栽培	zāipéi
栽	zāi
宝贵	bǎoguì
保健	bǎojiàn
大概	dàgài
从来	cónglái
不安	bùān
发烧	fāshāo
脫飯	-
脫	-
标本	biāoběn
传达	chuándá
不择手段	bùzéshǒuduàn
布告	bùgào
积极	jījí
否定	fǒudìng
教授	jiàoshòu
脫粉	-
爷	yé
爷爷	yéye
迟钝	chídùn
钝	dùn
富有	fùyǒu
规划	guīhuà
脾	pí
脾气	píqi
缓解	huǎnjiě
白左	bái zuǒ
惦记	diànjì
惦	diàn
讨厌	tǎoyàn
东道主	dōngdàozhǔ
数码	shùmǎ
荡	dàng
动荡	dòngdàng
真的	zhēnde
落实	luòshí
应聘	yìngpìn
期望	qīwàng
种类	zhǒnglèi
盖章	gàizhāng
收回	shōuhuí
切实	qièshí
标点	biāodiǎn
院子	yuànzi
吸管	xīguǎn
为期	wéiqī
眼光	yǎnguāng
往返	wǎngfǎn
淋	lín
上火	shànghuǒ
华尔街	huáěrjiē
收缩	shōusuō
外向	wàixiàng
凶恶	xiōng’è
正经	zhèngjing
本土	běntǔ
餐厅	cāntīng
边缘	biānyuán
不见	bùjiàn
持续	chíxù
电话	diànhuà
节目	jiémù
还有	háiyǒu
辞典	cídiǎn
出面	chūmiàn
改正	gǎizhèng
而且	érqiě
对象	duìxiàng
爬山	páshān
光明	guāngmíng
高速	gāosù
恩人	ēnrén
进步	jìnbù
惊讶	jīngyà
讶	yà
基地	jīdì
外边	wàibian
开业	kāiyè
学院	xuéyuàn
島	-
島國	-
考察	kǎochá
误会	wùhuì
礼拜	lǐbài
效果	xiàoguǒ
由于	yóuyú
老乡	lǎoxiāng
偶然	ǒurán
配套	pèitào
录像	lùxiàng
评论	pínglùn
其余	qíyú
认得	rènde
扭	niǔ
作文	zuòwén
时事	shíshì
一家人	yījiārén
维护	wéihù
未来	wèilái
辅导	fǔdǎo
显著	xiǎnzhù
挂号	guàhào
拐弯	guǎiwān
弯曲	wānqū
转变	zhuǎnbiàn
著作	zhùzuò
只不过	zhǐbuguò
局限	júxiàn
治理	zhìlǐ
留恋	liúliàn
朴实	pǔshí
竖	shù
雪上加霜	xuěshàngjiāshuāng
压岁钱	yāsuìqián
装卸	zhuāngxiè
着手	zhuóshǒu
作弊	zuòbì
显眼包	xiǎn yǎn bāo
凸	tū
凹凸	āotū
包裹	bāoguǒ
裹	guǒ
标志	biāozhì
词典	cídiǎn
伴随	bànsuí
成熟	chéngshú
创作	chuàngzuò
对手	duìshǒu
出访	chūfǎng
便宜	piányi
存款	cúnkuǎn
清楚	qīngchu
楚	chǔ
关机	guānjī
查获	cháhuò
楼上	lóushàng
经历	jīnglì
钞	chāo
钞票	chāopiào
干脆	gāncuì
个别	gèbié
奉	fèng
奉献	fèngxiàn
出身	chūshēn
脑袋	nǎodai
冻结	dòngjié
近日	jìnrì
盾	dùn
矛	máo
矛盾	máodùn
研究	yánjiū
方位	fāngwèi
签名	qiānmíng
以后	yǐhòu
通信	tōngxìn
头脑	tóunǎo
宿	sùsùxiǔxiù
宿舍	sùshè
寒暄	hánxuān
暄	xuān
晚点	wǎndiǎn
荒唐	huāngtáng
推出	tuīchū
籍贯	jíguàn
家喻户晓	jiāyùhùxiǎo
学员	xuéyuán
揭露	jiēlù
增进	zēngjìn
历代	lìdài
睹	dǔ
目睹	mùdǔ
凝固	nínggù
气势	qìshì
权衡	quánhéng
神气	shénqì
完备	wánbèi
兴高采烈	xìnggāocǎiliè
兴致勃勃	xìngzhìbóbó
勃	bó
涌	chōngyǒng
汹涌	xiōngyǒng
汹	xiōng
榨	zhà
压榨	yāzhà
一如既往	yìrújìwǎng
隐瞒	yǐnmán
瞒	mán
自力更生	zìlìgēngshēng
爱护	àihù
传统	chuántǒng
关于	guānyú
告别	gàobié
好处	hǎochu
待会儿	dāihuìr
母语	mǔyǔ
接受	jiēshòu
一般	yìbān
高度	gāodù
赤道	chìdào
公安	gōngān
回信	huíxìn
孔明灯	kǒngmíngdēng
发育	fāyù
来往	láiwǎng
粉色	fěnsè
展开	zhǎnkāi
上来	shànglái
贵族	guìzú
后代	hòudài
同胞	tóngbāo
宣传	xuānchuán
图书	túshū
陷入	xiànrù
展现	zhǎnxiàn
做梦	zuòmèng
开除	kāichú
勘探	kāntàn
勘	kān
口气	kǒuqì
摸索	mōsuǒ
逆行	nìxíng
逆	nì
岂	qǐ
岂有此理	qǐyǒu-cǐlǐ
生物	shēngwù
信赖	xìnlài
昼夜	zhòuyè
昼	zhòu
布置	bùzhì
补考	bǔkǎo
补习	bǔxí
唱片	chàngpiàn
环境	huánjìng
初中	chūzhōng
传来	chuánlái
此致	cǐzhì
合格	hégé
解释	jiěshì
建设	jiànshè
对外	duìwài
行李箱	xínglixiāng
干扰	gānrǎo
来不及	láibují
冷静	lěngjìng
红包	hóngbāo
后头	hòutou
价值	jiàzhí
交易	jiāoyì
任务	rènwu
平安	píng’ān
一些	yīxiē
杰出	jiéchū
杰	jié
议论	yìlùn
蚀	shí
腐蚀	fǔshí
内外	nèiwài
握爪	wò zhǎo/wò zhuǎ
爪	zhǎozhuǎ
好好儿	hǎohāor
十足	shízú
手段	shǒuduàn
上演	shàngyǎn
推开	tuīkāi
行列	hángliè
表情包	biǎoqíng bāo
通话	tōnghuà
挥	huī
霍	huò
挥霍	huīhuò
欠	qiàn
嘴欠	zuǐ qiàn
高冷	gāolěng
一身	yīshēn
主导	zhǔdǎo
隙	xì
空隙	kòngxì
中期	zhōngqī
习惯用语	xíguànyòngyǔ
好坏	hǎohuài
虐待	nüèdài
判决	pànjué
谴	qiǎn
谴责	qiǎnzé
融洽	róngqià
疏远	shūyuǎn
铜	tóng
熄灭	xīmiè
熄	xī
心血	xīnxuè
掩护	yǎnhù
永恒	yǒnghéng
恒	héng
滋润	zīrùn
保护	bǎohù
除了	chúle
采访	cǎifǎng
鞭策	biāncè
啤酒	píjiǔ
啤	pí
对应	duìyìng
接待	jiēdài
垃圾桶	lājītǒng
桶	tǒng
更换	gēnghuàn
固定	gùdìng
欢乐	huānlè
稿	gǎo
稿子	gǎozi
教练	jiàoliàn
大肆	dàsì
肆	sì
媽	-
寶	-
寶媽	-
南方	nánfāng
俱乐部	jùlèbù
领导	lǐngdǎo
没错	méicuò
只好	zhǐhǎo
名额	míng’é
爆表	bào biǎo
稿件	gǎojiàn
随手	suíshǒu
特征	tèzhēng
上台	shàngtái
熟肉	shú ròu
完了	wánle
叨逼叨	dāo bī dāo
遗传	yíchuán
线路	xiànlù
關	-
取關	-
约束	yuēshù
多元	duōyuán
萌芽	méngyá
芽	yá
抄袭	chāoxí
热泪盈眶	rèlèi-yíngkuàng
眶	kuàng
人性	rénxìng
神态	shéntài
使命	shǐmìng
释放	shìfàng
喜闻乐见	xǐwénlèjiàn
涌现	yǒngxiàn
半天	bàntiān
不如	bùrú
上班	shàngbān
觉得	juédé
关上	guānshàng
冲击	chōngjī
复制	fùzhì
不愧	búkuì
黨	-
抖腿黨	-
对抗	duìkàng
高等	gāoděng
贡	gòng
贡献	gòngxiàn
戚	qī
亲戚	qīnqi
开展	kāizhǎn
撞	zhuàng
提前	tíqián
请客	qǐngkè
随时	suíshí
优点	yōudiǎn
手欠	shǒu qiàn
錢	-
錢妞	-
妞	niū
权利	quánlì
懟	-
搜索	sōusuǒ
顾虑	gùlǜ
总统	zǒngtǒng
蛇精病	shé jīng bìng
计较	jìjiào
较	jiào
早晚	zǎowǎn
莫名其妙	mòmíng-qímiào
莫	mò
窍门	qiàomén
窍	qiào
上游	shàngyóu
提炼	tíliàn
炼	liàn
惋	wǎn
惋惜	wǎnxī
遥控	yáokòng
多少	duōshǎo
本来	běnlái
变化	biànhuà
成绩	chéngjì
绩	jì
绑架	bǎngjià
变换	biànhuàn
说话	shuōhuà
查询	cháxún
廠	-
廠牌	-
创业	chuàngyè
辩护	biànhù
首选	shǒuxuǎn
结构	jiégòu
老人	lǎorén
交通	jiāotōng
结论	jiélùn
時	-
高光時刻	-
关怀	guānhuái
晚饭	wǎnfàn
那会儿	nàhuìr
开发	kāifā
弓	gōng
硕士	shuòshì
硕	shuò
实验	shíyàn
说服	shuōfú
动静	dòngjing
面积	miànjī
尬聊	gà liáo
试验	shìyàn
恨不得	hènbude
覺	-
愛	-
累覺不愛	-
针对	zhēnduì
奇葩	qí pā
葩	pā
一贯	yíguàn
正宗	zhèngzōng
内幕	nèimù
融化	rónghuà
惮	dàn
肆无忌惮	sìwújìdàn
瓦	wǎ
瓦解	wǎjiě
兆	zhào
预兆	yùzhào
再接再厉	zàijiēzàilì
琢磨	zhuómó
琢	zhuózuó
按照	ànzhào
比赛	bǐsài
包括	bāokuò
差不多	chàbuduō
当然	dāngrán
表明	biǎomíng
准备	zhǔnbèi
传说	chuánshuō
播种	bōzhòng
搭配	dāpèi
技术	jìshù
分配	fēnpèi
开心	kāixīn
功课	gōngkè
洗白	xǐ bái
秘密	mìmì
好友	hǎoyǒu
合成	héchéng
笑话	xiàohuà
攻击	gōngjī
高原反应	gāoyuán fǎnyìng
名誉	míngyù
深度	shēndù
区分	qūfēn
耽美	dān měi
剩女	shèng nǚ
关照	guānzhào
现场	xiànchǎng
限制	xiànzhì
研究所	yánjiūsuǒ
压迫	yāpò
召开	zhàokāi
教养	jiàoyǎng
游玩	yóuwán
最初	zuìchū
咨询	zīxún
立足	lìzú
拆二代	chāi èrdài
受罪	shòuzuì
陷害	xiànhài
烟花爆竹	yānhuābàozhú
引用	yǐnyòng
阵容	zhènróng
保存	bǎocún
北方	běifāng
不幸	bùxìng
畫	-
入畫	-
大量	dàliàng
尺寸	chǐcun
情况	qíngkuàng
刹	chàshā
刹那	chànà
纪念	jìniàn
圖	-
地圖炮	-
客厅	kètīng
酒店	jiǔdiàn
照顾	zhàogu
落后	luòhòu
考生	kǎoshēng
灰色	huīsè
机构	jīgòu
得罪	dézuì
随便	suíbiàn
禽	qín
飞禽走兽	fēiqínzǒushòu
业余	yèyú
楼房	lóufáng
梅花	méihuā
梅	méi
尊重	zūnzhòng
周到	zhōudào
柚子	yòuzi
幻灯片	huàndēngpiàn
点心	diǎnxin
天下	tiānxià
向上	xiàngshàng
影子	yǐngzi
信用	xìnyòng
一模一样	yīmúyīyàng
展览	zhǎnlǎn
开采	kāicǎi
照样	zhàoyàng
枯萎	kūwěi
萎	wěi
冷漠	lěngmò
携带	xiédài
携	xié
抱怨	bàoyuàn
保险	bǎoxiǎn
超市	chāoshì
大楼	dàlóu
出口	chūkǒu
层次	céngcì
颜色	yánsè
刺激	cìjī
躺平	tǎngpíng
大会	dàhuì
大爷	dàyédàye
认真	rènzhēn
计划	jìhuà
叔叔	shūshu
叔	shū
中介	zhōngjiè
衬托	chèntuō
一会儿	yíhuìr
利用	lìyòng
那么	nàme
地域炮	dì yù pào
敌视	díshì
恋爱	liàn’ài
两岸	liǎngàn
象征	xiàngzhēng
声明	shēngmíng
瘩	dá
疙	gē
疙瘩	gēda
拾	shí
投诉	tóusù
酸甜苦辣	suāntiánkǔlà
推进	tuījìn
调节	tiáojié
嫁	jià
魔性	mó xìng
制度	zhìdù
医药	yīyào
津	jīn
津津有味	jīnjīnyǒuwèi
总体	zǒngtǐ
狼狈	lángbèi
狈	bèi
狼	láng
撇	piē
千方百计	qiānfāng-bǎijì
玩弄	wánnòng
朝气蓬勃	zhāoqìpéngbó
蓬	péng
背景	bèijǐng
比较	bǐjiào
采取	cǎiqǔ
地方	dìfang
道理	dàolǐ
弊端	bìduān
从事	cóngshì
词汇	cíhuì
经常	jīngcháng
观念	guānniàn
儿女	érnǚ
困难	kùnnan
动漫	dòngmàn
数量	shùliàng
递增	dìzēng
垃圾	lājī
听说	tīngshuō
约会	yuēhuì
绿化	lǜhuà
示范	shìfàn
修复	xiūfù
选修	xuǎnxiū
引导	yǐndǎo
酱紫	jiàng zǐ
征求	zhēngqiú
暂停	zàntíng
解体	jiětǐ
冷落	lěngluò
全球暖化	quánqiú nuǎnhuà
卵	luǎn
容纳	róngnà
无精打采	wújīngdǎcǎi
闭幕	bìmù
不行	bùxíng
不论	bùlùn
土味情話	-
話	-
努力	nǔlì
伍	wǔ
队伍	duìwu
一边	yìbiān
关闭	guānbì
临时	línshí
加入	jiārù
进一步	jìnyībù
短促	duǎncù
突出	tūchū
呀	ya
擦	cā
摩擦	mócā
吼	hǒu
粗來	-
來	-
之后	zhīhòu
战斗	zhàndòu
勉强	miǎnqiǎng
内向	nèixiàng
体谅	tǐliàng
无理取闹	wúlǐqǔnào
演习	yǎnxí
毕竟	bìjìng
竟	jìng
材料	cáiliào
不成	bùchéng
别扭	bièniu
马上	mǎshàng
不惜	bùxī
发送	fāsòng
小狼狗	xiǎo láng gǒu
新專	-
專	-
呈	chéng
呈现	chéngxiàn
立刻	lìkè
明确	míngquè
年代	niándài
国会	guóhuì
留下	liúxià
进口	jìnkǒu
捐款	juānkuǎn
修理	xiūlǐ
年前	niánqián
附属	fùshǔ
p	-
嗨p	hāi p
嗨	hāi
随意	suíyì
推动	tuīdòng
休闲	xiūxián
要好	yàohǎo
之一	zhīyī
狼吞虎咽	lángtūnhǔyàn
咽	yānyèyàn
牵制	qiānzhì
心甘情愿	xīngānqíngyuàn
保证	bǎozhèng
背包	bēi bāo
本人	běnrén
背心	bèixīn
对不起	duìbùqǐ
倒是	dàoshi
二手	èrshǒu
阐	chǎn
阐述	chǎnshù
一直	yīzhí
构成	gòuchéng
另外	lìngwài
论文	lùnwén
木头	mùtou
脹	-
膨脹	-
事实上	shìshíshàng
留学生	liúxuéshēng
劝	quàn
克服	kèfú
盯	dīng
反面	fǎnmiàn
优惠	yōuhuì
复活	fùhuó
收获	shōuhuò
谈话	tánhuà
套路	tào lù
危害	wēihài
溺	nì
寵溺	-
寵	-
学会	xuéhuì
有关	yǒuguān
酒精	jiǔjīng
清淡	qīngdàn
进取	jìnqǔ
包容	bāoróng
岭	línglǐng
翻山越岭	fānshānyuèlǐng
嚷	rǎng
让步	ràngbù
伤脑筋	shāngnǎojīn
示威	shìwēi
嵌	kǎnqiàn
镶嵌	xiāngqiàn
镶	xiāng
循序渐进	xúnxùjiànjìn
冤枉	yuānwang
冤	yuān
枉	wǎng
啊	a
傍	bàng
傍晚	bàngwǎn
姑娘	gūniang
层出不穷	céngchūbùqióng
搀	chān
交换	jiāohuàn
校长	xiàozhǎng
经典	jīngdiǎn
过渡	guòdù
继承	jìchéng
颠倒	diāndǎo
颠	diān
堕落	duòluò
决策	juécè
意见	yìjiàn
泛滥	fànlàn
滥	làn
直接	zhíjiē
母鸡	mǔjī
嘴炮	zuǐ pào
全力	quánlì
圈粉	quān fěn
中医	zhōngyī
下去	xiàqù
踢	tī
缓和	huǎnhé
先后	xiānhòu
也好	yěhǎo
匀	yún
均匀	jūnyún
鐘	-
分分鐘	-
指定	zhǐdìng
甩	shuǎi
命名	mìngmíng
实事求是	shíshìqiúshì
闲话	xiánhuà
争先恐后	zhēngxiānkǒnghòu
除非	chúfēi
比喻	bǐyù
贬低	biǎndī
结果	jiéguǒ
家长	jiāzhǎng
过度	guòdù
小学生	xiǎoxuéshēng
加盟	jiāméng
温柔	wēnróu
文具	wénjù
分寸	fēncùn
左右	zuǒyòu
组织	zǔzhī
有人	yǒurén
合算	hésuàn
相关	xiāngguān
昏迷	hūnmí
过期	guòqī
心态	xīntài
养老	yǎnglǎo
這	-
這貨	-
貨	-
应急	yìngjí
专辑	zhuānjí
扩张	kuòzhāng
穿不出去	chuān bù chūqù
扭转	niǔzhuǎn
颇	pō
陶醉	táozuì
媳妇	xífu
媳	xí
倍	bèi
作业	zuòyè
打算	dǎsuàn
编制	biānzhì
补贴	bǔtiē
发现	fāxiàn
同学	tóngxué
低分飄過	-
飄	-
過	-
畅通	chàngtōng
吃力	chīlì
果实	guǒshí
买卖	mǎimài
波恩	bōēn
赶上	gǎnshàng
恢	huī
恢复	huīfù
大不了	dàbuliǎo
题目	tímù
疗养	liáoyǎng
冬令时	dōnglìng shí
母子	mǔzǐ
入学	rùxué
轰	hōng
轰动	hōngdòng
通报	tōngbào
铜牌	tóngpái
自律	zìlǜ
指挥	zhǐhuī
精华	jīnghuá
麻痹	mábì
痹	bì
人为	rénwéi
朋友圈	péngyouquān
翼	yì
小心翼翼	xiǎoxīnyìyì
疑惑	yíhuò
周折	zhōuzhé
周转	zhōuzhuǎn
报名	bàomíng
服务员	fúwùyuán
先生	xiānsheng
答应	dāying
策划	cèhuà
长短	chángduǎn
方案	fāng’àn
估计	gūjì
大妈	dàmā
规律	guīlǜ
集体	jítǐ
胡子	húzi
加上	jiāshàng
叼	diāo
痛快	tòngkuài
相当	xiāngdāng
想法	xiǎngfǎ
脫線	-
線	-
西藏	xīzàng
先进	xiānjìn
心疼	xīnténg
增值	zēngzhí
立方	lìfāng
相对	xiāngduì
强制	qiángzhì
日益	rìyì
衰退	shuāituì
成分	chéngfèn
大众	dàzhòng
根本	gēnběn
广大	guǎngdà
点名	diǎnmíng
动摇	dòngyáo
到期	dàoqī
纪录	jìlù
充实	chōngshí
殘	-
腦殘粉	-
腦	-
迷路	mílù
空降	kōng jiàng
捣乱	dǎoluàn
捣	dǎo
得天独厚	détiāndúhòu
路线	lùxiàn
黑草	hēi cǎo
用功	yònggōng
娱乐	yúlè
气象	qìxiàng
恰好	qiàhǎo
设想	shèxiǎng
议题	yìtí
转身	zhuǎnshēn
指示	zhǐshì
你呀	nǐ ya
埋没	máimò
慢性	mànxìng
涂抹	túmǒ
抹	māmǒmò
争气	zhēngqì
正在	zhèngzài
对面	duìmiàn
常规	chángguī
电台	diàntái
沉闷	chénmèn
喘	chuǎn
喘气	chuǎnqì
目录	mùlù
实在	shízài
数字	shùzì
名胜	míngshèng
上市	shàngshì
胡乱	húluàn
转动	zhuǎndòngzhuàndòng
灵感	línggǎn
掐	qiā
师范	shīfàn
压抑	yāyì
抑	yì
打扮	dǎban
反应	fǎnyìng
管理	guǎnlǐ
骨头	gǔtou
分成	fēnchéng
消化	xiāohuà
披	pī
区别	qūbié
过时	guòshí
失败	shībài
抵制	dǐzhì
考核	kǎohé
填空	tiánkòng
球场	qiúchǎng
原来	yuánlái
分歧	fēnqí
资料	zīliào
好客	hàokè
夹杂	jiāzá
刹车	shāchē
以至	yǐzhì
执着	zhízhuó
不得不	bùdébù
西皮	xī pí
不要紧	búyàojǐn
车号	chēhào
没事儿	méishìr
具备	jùbèi
回报	huíbào
回收	huíshōu
地步	dìbù
颗	kē
截止	jiézhǐ
进攻	jìngōng
模样	múyàng
愉快	yúkuài
寝	qǐn
废寝忘食	fèiqǐnwàngshí
时刻	shíkè
套餐	tàocān
黑暗料理	hēi àn liào lǐ
同期	tóngqī
各種	-
種	-
过节	guòjié
刻薄	kèbó
事务	shìwù
淘汰	táotài
大方	dàfang
史詩級	-
級	-
詩	-
瘦	shòu
工夫	gōngfūgōngfu
姨母笑	yí mǔ xiào
姨	yí
讲究	jiǎngjiu
指导	zhǐdǎo
认同	rèntóng
推广	tuīguǎng
假设	jiǎshè
抓紧	zhuājǐn
用得着	yòngdezháo
有事	yǒushì
指标	zhǐbiāo
再说	zàishuō
利害	lìhài
耍	shuǎ
安检	ānjiǎn
出圈	chū quān
补充	bǔchōng
不好意思	bùhǎoyìsi
到底	dàodǐ
运动	yùndòng
发票	fāpiào
汉字	hànzì
出行	chūxíng
称心如意	chènxīnrúyì
可见	kějiàn
工程	gōngchéng
改装	gǎizhuāng
光线	guāngxiàn
含义	hányì
回复	huífù
收拾	shōushi
空间	kōngjiān
流动	liúdòng
停车	tíngchē
支持	zhīchí
公安局	gōng’ānjú
使得	shǐde
提示	tíshì
做法	zuòfǎ
相处	xiāngchǔ
还原	huányuán
物业	wùyè
嬌羞	-
嬌	-
急功近利	jígōngjìnlì
家伙	jiāhuo
终点	zhōngdiǎn
转化	zhuǎnhuà
论证	lùnzhèng
确信	quèxìn
报销	bàoxiāo
大小	dàxiǎo
交流	jiāoliú
集中	jízhōng
紧张	jǐnzhāng
复苏	fùsū
露馅	lòuxiàn
上边	shàngbian
背鍋俠	-
鍋	-
俠	-
阳光	yángguāng
反思	fǎnsī
失误	shīwù
实践	shíjiàn
伟大	wěidà
想不到	xiǎngbudào
空前绝后	kōngqiánjuéhòu
名副其实	míngfùqíshí
徘	pái
徘徊	páihuái
徊	huái
贫乏	pínfá
上进	shàngjìn
把握	bǎwò
安置	ānzhì
不敢当	bùgǎndāng
工作	gōngzuò
负责	fùzé
感情	gǎnqíng
单元	dānyuán
联系	liánxì
记录	jìlù
打量	dǎliang
遏制	èzhì
遏	è
秩	zhì
秩序	zhìxù
综	zèngzōng
综合	zōnghé
收养	shōuyǎng
狠	hěn
狠心	hěnxīn
废话	fèihuà
哏	gén
牺牲	xīshēng
牺	xī
新兴	xīnxīng
节制	jiézhì
一时	yīshí
资源	zīyuán
拘束	jūshù
开朗	kāilǎng
侠	xiá
武侠	wǔxiá
宝贝	bǎobèi
不仅	bùjǐn
变质	biànzhì
冲突	chōngtū
决定	juédìng
读音	dúyīn
影响	yǐngxiǎng
理发	lǐfà
過氣網紅	-
目光	mùguāng
舌头	shétou
文字	wénzì
筒	tǒng
话筒	huàtǒng
唸	-
碎碎唸	-
机动	jīdòng
较量	jiàoliàng
灭亡	mièwáng
屈服	qūfú
泰斗	tàidǒu
心眼儿	xīnyǎnr
隐患	yǐnhuàn
包袱	bāofu
后面	hòumiàn
冬叔	dōng shū
处分	chǔfèn
后边	hòubian
贷款	dàikuǎn
贷	dài
口语	kǒuyǔ
科学	kēxué
一定	yídìng
炸裂	zhà liè
中间	zhōngjiān
私貨	-
磋	cuō
磋商	cuōshāng
就是	jiùshì
辛苦	xīnkǔ
群嘲	qún cháo
以外	yǐwài
又叒叕	yòu ruò zhuó
叕	zhuó
叒	ruò
外面	wàimiàn
现实	xiànshí
疼痛	téngtòng
五星	wǔxīng
晶	jīng
结晶	jiéjīng
椎	chuízhuī
颈椎	jǐngzhuī
颈	gěngjǐng
元素	yuánsù
专利	zhuānlì
招待	zhāodài
日新月异	rìxīn-yuèyì
应酬	yìngchou
沾光	zhānguāng
沾	zhān
周边	zhōubiān
表演	biǎoyǎn
不通	bùtōng
曾经	céngjīng
层面	céngmiàn
池子	chízi
广播	guǎngbō
要求	yāoqiú
反问	fǎnwèn
风暴	fēngbào
文章	wénzhāng
虽然	suīrán
腾	téng
沸腾	fèiténg
沸	fèi
嘛	ma
哎	āi
去掉	qùdiào
撞臉	-
团长	tuánzhǎng
歇	xiē
占有	zhànyǒu
开支	kāizhī
指数	zhǐshù
抹杀	mǒshā
内涵	nèihán
涵	hán
忍耐	rěnnài
书记	shūjì
爱好	àihào
标准	biāozhǔn
磚	-
拍磚	-
不足	bùzú
干杯	gānbēi
反复	fǎnfù
更新	gēngxīn
联络	liánluò
生词	shēngcí
強排	-
反射	fǎnshè
栏目	lánmù
栏	lán
剩男	shèng nán
襲	-
逆襲	-
为此	wèicǐ
凝聚	níngjù
卜	bǔbǔbó
萝卜	luóbo
眼神	yǎnshén
转折	zhuǎnzhé
着想	zhuóxiǎng
案例	ànlì
踩	cǎi
出门	chūmén
倡导	chàngdǎo
可能	kěnéng
好看	hǎokàn
浇	jiāo
闊	-
闊以	-
斷	-
斷眉	-
一旦	yīdàn
人家	rénjiā
升级	shēngjí
假一赔十	jiǎyī péishí
归纳	guīnà
蠢萌	chǔn méng
喇	lālǎ
叭	bā
喇叭	lǎba
乐意	lèyì
掷	zhì
投掷	tóuzhì
肖	xiāoxiào
肖像	xiàoxiàng
验证	yànzhèng
不怎么样	bùzěnmeyàng
承认	chéngrèn
担任	dānrèn
配一臉	-
憋	biē
空调	kōngtiáo
得以	déyǐ
持久	chíjiǔ
商场	shāngchǎng
轻松	qīngsōng
吊打	diào dǎ
E神	E shén
E	-
密切	mìqiè
重点	zhòngdiǎn
鍾黑	-
鍾	-
奈	nài
无奈	wúnài
协调	xiétiáo
撕逼	sī bī
运作	yùnzuò
要命	yàomìng
出入	chūrù
定期	dìngqī
进行	jìnxíng
映	yìng
反映	fǎnyìng
粑粑	bǎ bá
粑	bā
膩	-
膩害	-
阴暗	yīnàn
降温	jiàngwēn
对照	duìzhào
民间	mínjiān
普及	pǔjí
背鍋	-
帶	-
狗帶	-
体会	tǐhuì
愣	lèng
流浪	liúlàng
浓厚	nónghòu
亲热	qīnrè
介绍	jièshào
绍	shào
毒唯	dú wéi
尼	ní
迪士尼	díshìní
迪	dí
拿出	náchū
决心	juéxīn
完善	wánshàn
追星狗	zhuī xīng gǒu
夸张	kuāzhāng
闯	chuǎng
聲控	-
聲	-
不得已	bùdéyǐ
调动	diàodòng
可怕	kěpà
环保	huánbǎo
白起	bái qǐ
听写	tīngxiě
標	-
雙標	-
雙	-
启动	qǐdòng
入门	rùmén
荤	hūn
急于求成	jíyúqiúchéng
只见	zhǐjiàn
粒	lì
蓬荜生辉	péngbìshēnghuī
荜	bì
体面	tǐmiàn
胸怀	xiōnghuái
出来	chūláichulai
闭塞	bìsè
解决	jiějué
放下	fàngxià
淀	diàn
沉淀	chéndiàn
普通话	pǔtōnghuà
生命	shēngmìng
閃	-
男友力	nán yǒu lì
燒	-
燒腦	-
節	-
節操	-
礼尚往来	lǐshàngwǎnglái
力所能及	lìsuǒnéngjí
履	lǚ
履行	lǚxíng
職業假笑	-
職	-
编织	biānzhī
怀疑	huáiyí
着急	zháojí
麻烦	máfan
气候	qìhòu
甜茶	tián chá
两手	liǎngshǒu
简体字	jiǎntǐzì
碾壓	-
碾	niǎn
壓	-
中华民族	zhōnghuámínzú
浮	fú
漂浮	piāofú
发病	fābìng
會	-
社會	-
撩騷	-
騷	-
师傅	shīfu
傅	fù
受到	shòudào
外卖	wàimài
和解	héjiě
踏实	tāshi
腐女	fǔ nǚ
主张	zhǔzhāng
游行	yóuxíng
只顾	zhǐgù
启示	qǐshì
帆	fān
一帆风顺	yìfānfēngshùn
保养	bǎoyǎng
分组	fēnzǔ
定位	dìngwèi
麻麻	mǎ má
故障	gùzhàng
十分	shífēn
启事	qǐshì
相机	xiàngjī
懶癌	-
懶	-
微信	wēixìn
一路	yīlù
争论	zhēnglùn
蹋	tà
糟蹋	zāotà
爱不释手	àibúshìshǒu
哪儿	nǎr
保管	bǎoguǎn
调查	diàochá
出路	chūlù
建议	jiànyì
垮	kuǎ
整段垮掉	zhěng duàn kuǎ diào
没什么	méishénme
封闭	fēngbì
初代	chū dài
下课	xiàkè
胖友	pàng yǒu
预防	yùfáng
画蛇添足	huàshétiānzú
齐心协力	qíxīn-xiélì
深沉	shēnchén
聊騷	-
作天作地	zuō tiān zuō dì
部位	bùwèi
成就	chéngjiù
打击	dǎjī
教训	jiàoxùn
金拱門	-
拱	gǒng
門	-
劇	-
追劇	-
脱离	tuōlí
新人	xīnrén
间隔	jiàngé
再生	zàishēng
公寓	gōngyù
死宅	sǐ zhái
幹	-
幹得漂亮	-
好人	hǎorén
仙	xiān
小仙女	xiǎo xiān nǚ
清明节	qīngmíngjié
舔屏	tiǎn píng
兴趣	xìngqù
想方设法	xiǎngfāngshèfǎ
苟	gǒu
一丝不苟	yìsībùgǒu
音响	yīnxiǎng
白酒	báijiǔ
次数	cìshù
发出	fāchū
天命圈	tiān mìng quān
关注	guānzhù
凑	còu
凑合	còuhuo
悄	qiāoqiǎo
悄悄	qiāoqiāo
开关	kāiguān
出坑	chū kēng
小白	xiǎo bái
实惠	shíhuì
內個	-
個	-
內	-
抬头	táitóu
提升	tíshēng
飯隨愛豆	-
隨	-
直播	zhíbō
招呼	zhāohu
苦尽甘来	kǔjìngānlái
笔记	bǐjì
曝光	bàoguāng
曝	pù
陽	-
太陽女神	-
行人	xíngrén
甩鍋	-
死忠粉	sǐ zhōng fěn
消灭	xiāomiè
尖端	jiānduān
组合	zǔhé
人事	rénshì
气质	qì zhì
裁判	cáipàn
分布	fēnbù
画面	huàmiàn
沙发	shāfā
提出	tíchū
臉大	-
正好	zhènghǎo
在乎	zàihu
生成	shēngchéng
投入	tóurù
过瘾	guòyǐn
为止	wéizhǐ
落水	luò shuǐ
生肖	shēngxiào
弦	xián
斩钉截铁	zhǎndīngjiétiě
钉	dīngdìng
斩	zhǎn
背着	bēizhebèizhe
打工	dǎgōng
吐血	tù xiě
竟然	jìngrán
规范	guīfàn
说明	shuōmíng
床上運動	-
動	-
運	-
台阶	táijiē
对联	duìlián
辜负	gūfù
主流	zhǔliú
理所当然	lǐsuǒdāngrán
算数	suànshù
报告	bàogào
风光	fēngguāng
回避	huíbì
构思	gòusī
拼命	pīnmìng
出轨	chūguǐ
轨	guǐ
祖先	zǔxiān
大哥	dàgē
感受	gǎnshòu
肯定	kěndìng
开机	kāijī
开学	kāixué
觉悟	juéwù
说明书	shuōmíngshū
锲	qiè
锲而不舍	qiè’érbùshě
表示	biǎoshì
高甜	gāo tián
代理	dàilǐ
高潮	gāocháo
花瓶	huāpíng
蹬	dēng
看起来	kànqǐlai
米叔	mǐ shū
证明	zhèngmíng
公知	gōng zhī
沒	-
並沒有	-
並	-
攀登	pāndēng
保留	bǎoliú
词语	cíyǔ
处理	chǔlǐ
房子	fángzi
辩解	biànjiě
出名	chūmíng
对立	duìlì
对了	duì le
演出	yǎnchū
虐腹	nüè fù
演绎	yǎnyì
宵	xiāo
元宵节	yuánxiāojié
正气	zhèngqì
本子	běnzi
专业	zhuānyè
乖	guāi
們	-
乃	nǎi
乃們	-
網綠	-
哈尔滨	hāěrbīn
融合	rónghé
科普	kē pǔ
退步	tuìbù
叙述	xùshù
叙	xù
失事	shīshì
爱心	àixīn
翻译	fānyì
启发	qǐfā
流行	liúxíng
兄弟	xiōngdì
兄	xiōng
扑	pū
私人	sīrén
型号	xínghào
隔壁老王	gé bì lǎo wáng
一向	yíxiàng
行程	xíngchéng
尊敬	zūnjìng
儒家	rújiā
儒	rú
神仙	shénxiān
吞吞吐吐	tūntūntǔtǔ
酝	yùn
酿	niàng
酝酿	yùnniàng
方便	fāngbiàn
沒眼看	-
鵝	-
鵝廠	-
救救孩子	jiù jiù hái zi
发射	fāshè
開封菜	-
開	-
美容	měiróng
全场	quánchǎng
吃亏	chīkuī
说法	shuōfǎshuōfa
寄	jì
寄托	jìtuō
伪装	wěizhuāng
保安	bǎoān
鎮魂女孩	-
鎮	-
代表	dàibiǎo
墻	-
扶我上墻	-
女司機	-
機	-
彩蛋	cǎi dàn
大写加粗	dà xiě jiā cū
在于	zàiyú
通电	tōngdiàn
鸦雀无声	yāquèwúshēng
鸦	yā
寄己	jì jǐ
黑出翔	hēi chū xiáng
總	-
炮總	-
接收	jiēshōu
借鉴	jièjiàn
推坑	tuī kēng
有意义	yǒu yìyì
收藏	shōucáng
買買買	-
专题	zhuāntí
流露	liúlù
泄气	xièqì
发达	fādá
哪里	nǎlǐ
发起	fāqǐ
親	-
親測有效	-
測	-
解放	jiěfàng
太极拳	tàijíquán
为难	wéinán
充电	chōngdiàn
辫子	biànzi
辫	biàn
奶奶	nǎinai
卷西	juǎn xī
纷纷	fēnfēn
C	-
C位	C weì
頻	-
男頻	-
圓	-
土肥圓	-
經	-
神經病啊	-
应用	yìngyòng
應援	-
應	-
烫	tàng
便是	biànshì
锻炼	duànliàn
锻	duàn
賽	-
賽高	-
霧草	-
霧	-
開畫	-
打包	dǎbāo
品味	pǐnwèi
瞎说	xiāshuō
塑造	sùzào
不过	búguò
部长	bùzhǎng
认识	rènshi
然鵝	-
将军	jiāngjūn
突破	tūpò
整治	zhěngzhì
打发	dǎfa
智商稅	-
稅	-
寡姐	guǎ jiě
寡	guǎ
味道	wèidào
同人	tóng rén
空闲	kòngxián
排放	páifàng
任重道远	rènzhòng-dàoyuǎn
宁可	nìngkě
囧	jiǒng
囧司徒	jiǒng sī tú
挖坑	wā kēng
矩	jǔ
规矩	guīju
转移	zhuǎnyí
麻醉	mázuì
G點	-
點	-
G	-
测试	cèshì
大姐	dàjiě
规定	guīdìng
霸	bà
滅霸	-
滅	-
賣腐	-
綠綠	-
白蓮花	-
蓮	-
讨好	tǎohǎo
心得	xīndé
沙雕	shā diāo
戾氣	-
戾	lì
条件	tiáojiàn
新番	xīn fān
粘	zhān
粘贴	zhāntiē
墻內	-
提起	tíqǐ
小确幸	xiǎo què xìng
觉醒	juéxǐng
走漏	zǒulòu
舔屏向	tiǎn píng xiàng
錘	-
實	-
實錘	-
馬路殺手	-
殺	-
馬	-
整理	zhěnglǐ
面向	miànxiàng
民工	míngōng
拓	tuòtàtuò
开拓	kāituò
调和	tiáohé
表现	biǎoxiàn
一丟丟	-
丟	-
出台	chūtái
伯母	bómǔ
伯	bǎibó
槽	cáo
滿	-
槽點滿滿	-
緊	-
緊臟	-
对付	duìfu
交往	jiāowǎng
加油	jiāyóu
炸號	-
號	-
解除	jiěchú
通过	tōngguò
品质	pǐnzhì
枪手	qiāngshǒu
靈魂舞者	-
靈	-
新冠病毒	xīnguān bìngdú
嗔	chēn
嬌嗔	-
白古	bái gǔ
培养	péiyǎng
登陆	dēnglù
灣	-
灣灣	-
相应	xiāngyìng
體	-
肉體飯	-
特别	tèbié
壯士	-
壯	-
究竟	jiūjìng
收圖	-
挫折	cuòzhé
挫	cuò
佛系玩家	fó xì wán jiā
嘿嘿嘿	hēi hēi hēi
华侨	huáqiáo
侨	qiáo
似曾相识	sìcéngxiāngshí
吃土	chī tǔ
株	zhū
白人饭	báirén fàn
湯	-
湯老濕	-
濕	-
塞皇	sài huáng
女頻	-
气功	qìgōng
吸血鬼	xīxuèguǐ
腻	nì
油腻	yóunì
大厦	dàshà
伐木累	fá mù leì
墻外	-
釦釦熊	-
釦	-
逢	féng
極	-
細	-
細思恐極	-
跳水	tiàoshuǐ
孕育	yùnyù
一下	yīxià
古風	-
風	-
天菜	tiān cài
盆栽精	pén zāi jīng
整体	zhěngtǐ
口耐	kǒu nài
走心	zǒu xīn
富二代	fù èrdài
設	-
人設已崩	-
搬運	-
顏狗	-
神同步	shén tóng bù
佛系	fó xì
旁友	páng yǒu
以上	yǐshàng
腦殘	-
孝	xiào
孝顺	xiàoshun
起到	qǐdào
書	-
黃	-
小黃書	-
通用	tōngyòng
軟妹	-
軟	-
菇	gū
菇涼	-
涼	-
化解	huàjiě
題	-
送分題	-
簸	bǒbò
颠簸	diānbǒ
开花	kāihuā
粉丝	fěnsī
见义勇为	jiànyìyǒngwéi
养活	yǎnghuo
产生	chǎnshēng
急诊	jízhěn
录取	lùqǔ
打臉	-
甜寵	-
附件	fùjiàn
澄清	chéngqīng
澄	chéngchéngdèng
绿茶	lǜchá
抖森	dǒu sēn
与其	yǔqí
人道	réndào
折腾	zhēteng
届	jiè
鬥	-
鬥圖	-
霾	mái
吸霾	xī mái
泥萌	ní méng
無感	-
無	-
感冒	gǎnmào
不服憋著	bù fú biē zhe
科恩嫂	kē ēn sǎo
流量	liúliàng
怪我咯	guài wǒ lo
咯	gēloluò
秃	tū
阿姨	āyí
机场	jīchǎng
能打	néng dǎ
奔現	-
現	-
佛系青年	fó xì qīng nián
茄子	qiézi
总监	zǒngjiān
慰安妇	wèiānfù
窝	wō
多么	duōme
w	-
o	-
low	lōu
l	-
单位	dānwèi
尽管	jǐnguǎn
画风	huàfēng
四字弟弟	sì zì dì di
偉光正	-
偉	-
卷福	juǎn fú
喪	-
喪心病狂	-
干燥	gānzào
都教授	dū jiào shòu
带有	dàiyǒu
分别	fēnbié
翻紅	-
邊	-
周邊	-
上门	shàngmén
霸屏	bà píng
重口味	zhòng kǒu wèi
站台	zhàn tái
沖	-
沖鴨	-
鴨	-
走腎	-
腎	-
问候	wènhòu
我宣你	wǒ xuān nǐ
虐狗	nüè gǒu
章程	zhāngchéng
不喜勿噴	-
噴	-
主持	zhǔchí
活久見	-
主动	zhǔdòng
灰常	huī cháng
人物	rénwù
情懷	-
懷	-
歷	-
黑歷史	-
噴子	-
原著黨	-
上网	shàngwǎng
諾蘭黑	-
蘭	-
諾	-
讚	-
點讚之交	-
放空	fàng kōng
本寶寶	-
掀起	xiānqǐ
掀	xiān
摆脱	bǎituō
发挥	fāhuī
鸟	niǎo
小透明	xiǎo tòu míng
大表姐	dà biǎo jiě
理直气壮	lǐzhíqìzhuàng
長	-
逆生長	-
黃桑	-
民宿	mínsù
扶墻	-
老濕	-
大事	dàshì
花式虐狗	huā shì nüè gǒu
大表哥	dà biǎo gē
咱们	zánmen
逗	dòu
符合	fúhé
尬舞	gà wǔ
狼系男	láng xì nán
雙標狗	-
戰	-
不服來戰	-
抖機靈	-
鼓动	gǔdòng
不要不要	bú yào bú yào
锦上添花	jǐnshàngtiānhuā
锦	jǐn
開車	-
躁起來	-
衍	yǎn
敷	fū
敷衍	fūyǎn
污力滔滔	wū lì tāo tāo
作为	zuòwéi
大体	dàtǐ
戲精	-
戲	-
雞	-
麻辣雞	-
單	-
熱	-
熱單	-
只管	zhǐguǎn
渗透	shèntòu
渗	shèn
接着	jiēzhe
开放	kāifàng
濾	-
自帶濾鏡	-
鏡	-
母上大人	mǔ shàng dà rén
囧雪诺	jiǒng xuě nuò
不忘初心	bú wàng chū xīn
单身狗	dānshēngǒu
激烈	jīliè
父上大人	fù shàng dà rén
没法儿	méifǎr
高司令	gāo sī lìng
斯巴達	-
達	-
油管	yóu guǎn
不忍直視	-
視	-
姬	jī
司姬	sī jī
女權婊	-
權	-
阿姨粉	ā yí fěn
綠光	-
糧	-
撒狗糧	-
枚	méi
摩擦摩擦	mó cā mó cā
傻麅子	shǎ páo zi
麅	páo
女權癌	-
沒節操	-
机关	jīguān
彈	-
第X彈	-
联想	liánxiǎng
掌握	zhǎngwò
汪	wāng
單身汪	-
你國	-
科學上網	-
學	-
圍	-
圍笑	-
以为	yǐwéi
相愛相殺	-
老幹部	-
成语	chéngyǔ
运行	yùnxíng
窗口	chuāngkǒu
咆哮教主	páo xiào jiào zhǔ
哮	xiào
咆	páo
腦斧	-
斧	fǔ
寄刀片	jì dāo piàn
怎麼破	-
麼	-
作用	zuòyòng
顏藝	-
藝	-
致辞	zhìcí
盛世美顏	-
陳	-
師	-
陳老師	-
认定	rèndìng
花路	huā lù
犀利哥	xī lì gē
活捉一只	huó zhuō yì zhī
黑古	hēi gǔ
貓	-
雲	-
雲吸貓	-
教科書般	-
乾	qián
乾貨	-
人設	-
內心戲	-
语音	yǔyīn
有没有	yǒuméiyǒu
中央空調	-
調	-
犬系男	quǎn xì nán
土酷	tǔ kù
棄坑	-
棄	-
事业	shìyè
之间	zhījiān
哦	o
斜杠青年	xié gàng qīng nián
可以說是	-
說	-
补刀	bǔ dāo
意思	yìsi
鋼	-
鋼鐵直男	-
某寶	-
絲	-
粉絲濾鏡	-
y	-
a	-
Gay蜜	Gay mì
簡	-
砸簡歷	-
院长	yuànzhǎng
小鮮肉	-
鮮	-
懟天懟地	-
啾咪	jiū mī
咪	mī
啾	jiū
今日份	jīn rì fèn
廢柴	-
廢	-
森女	sēn nǚ
機智如我	-
隐藏	yǐncáng
我們家	-
麻竹	má zhú
五毛黨	-
媽賣批	-
臺	-
站臺	-
錘哥	-
黑化	hēi huà
菊外人	jú wài rén
菊	jú
洗地	xǐ dì
眾	-
朝陽群眾	-
貓奴	-
霸道	bàdào
王之蔑視	-
慈母笑	cí mǔ xiào
初心	chū xīn
標題黨	-
活动	huódòng
抓馬	-
确定	quèdìng
手賤	-
賤	-
灌水	guàn shuǐ
新技能	xīn jì néng
韭菜	jiǔcài
韭	jiǔ
連	-
三連	-
雨神	yǔ shén
毀童年	-
毀	-
為	-
夢	-
以夢為馬	-
放飛自我	-
飛	-
三石弟弟	sān shí dì dì
大清已亡	dà qīng yǐ wáng
狗糧	-
擦媽	-
丙	bǐng
卓伟视角	zhuó wěi shì jiǎo
后天	hòutiān
渣渣輝	-
輝	-
人畜无害	rén chù wú hài
觀	-
暗中觀察	-
F	-
早F晚E	zǎo f wǎn e
原地爆炸	yuán dì bào zhà
尬吹	gà chuī
貓系男	-
佛系分手	fó xì fēn shǒu
科科	kē kē
舉高高	-
舉	-
轟	-
轟趴	-
水果姐	shuǐ guǒ jiě
血槽已空	xuè cháo yǐ kōng
出场	chūchǎng
耐撕	nài sī
何老師	-
小李子	xiào lǐ zi
交代	jiāodài
A	-
早C晚A	zǎo c wǎn a
先森	xiān sēn
馬殺雞	-
好奇寶寶	-
鹽	-
可鹽可甜	-
入手	rù shǒu
肝	gān
環	-
主角光環	-
求錘得錘	-
启蒙	qǐméng
岔	chà
环节	huánjié
齡	-
暴露年齡	-
在家	zàijiā
目測要火	-
炒雞	-
碎成渣渣	suì chéng zhàn zhā
后顾之忧	hòugùzhīyōu
狼民	láng mín
滞留	zhìliú
自幹五	-
筆	-
煞筆	-
煞	shāshà
範	-
有範	-
霑	-
雨露均霑	yǔ lù jūn zhān
親媽粉	-
狗頭	-
丁日	dīng rì
霉霉	méi méi
字典	zìdiǎn
霸气外露	bà qì wài lù
賽金花	-
禁慾系	-
慾	-
制服	zhìfú
陪跑	péi pǎo
囧瑟夫	jiǒng sè fū
然並卵	-
粗線	-
自戳雙目	-
戳	chuō
勞模姐	-
勞	-
配合	pèihé
轨道	guǐdào
水逆	shuǐ nì
宰	zǎi
瑪麗蘇	-
瑪	-
蘇	-
麗	-
處女臉	-
處	-
總攻本攻	-
咆哮体	páo xiào tǐ
補檔	-
補	-
顏控	-
前方高能	qián fāng gāo néng
現充	-
城會玩	-
滾	-
滾床單	-
重叠	chóngdié
叠	dié
喪文化	-
轉	-
反轉	-
回憶殺	-
憶	-
傳	-
傳送門	-
清流	qīng liú
上頭	-
戰鬥民族	-
次元壁	cì yuán bì
風騷走位	-
水軍	-
軍	-
近代	jìndài
謝	-
謝耳朵	-
求生欲	qiú shēng yù
肥宅	féi zhái
票圈	piào quān
樓主	-
樓	-
地区	dìqū
老白	lǎo bái
腦子瓦特	-
照騙	-
騙	-
跪舔	guì tiǎn
身份	shēnfèn
熊本熊	xióng běn xióng
加以	jiāyǐ
蠢哭	chǔn kū
漢	-
癡漢臉	-
癡	-
尬黑	gà hēi
真愛粉	-
歪個樓	-
亂	-
亂入	-
發	-
發糖	-
纵横	zònghéng
貴	-
貴圈真亂	-
喜大普奔	xǐ dà pǔ bēn
用力過猛	-
刮鍋底笑	-
奶凶奶凶	nǎi xiōng nǎi xiōng
後	-
先馬後看	-
小奶狗	xiǎo nǎi gǒu
黑花	hēi huā
姦	-
視姦	-
小公舉	-
國民老公	-
杏紅	-
送命題	-
革命	gémìng
鏟	-
屎	shǐ
鏟屎官	-
葛優癱	-
葛	gěgé
癱	-
優	-
養	-
養成系	-
側	-
霸氣側漏	-
結石姐	-
結	-
藍	-
藍瘦香菇	-
掛	-
開掛	-
土偶	tǔ ǒu
兒	-
蛋妞兒	-
雅蠛蝶	yǎ miè dié
蠛	miè
油菜花	yóu cài huā
武术	wǔshù
陳大發	-
高考	gāokǎo
敲黑板	qiāo hēi bǎn
涼涼	-
剁	duò
剁手族	duò shǒu zú
M	-
抖M	dǒu m
心大	xīn dà
不會聊天	-
霸道總裁	-
既視感	-
戀	-
生無可戀	-
習大大	-
習	-
炒CP	chǎo CP
P	-
招黑體質	-
質	-
日了狗	rì le gǒu
拉仇恨	lā chóu hèn
公開處刑	-
蹭	cèng
蹭熱度	-
挽尊	wǎn zūn
義	-
顏即正義	-
暴擊	-
擊	-
起来	qǐlái
問	-
黑人問號	-
攤手	-
攤	-
種草	-
聊聊人生	liáo liáo rén shēng
咚	dōng
壁咚	bì dōng
已婚少女	yǐ hūn shào nǚ
領盒飯	-
領	-
A站	A zhàn
協	-
外貌協會	-
居老師	-
開黑	-
腦洞	-
綠茶婊	-
自來水	-
深柜男	shēn guì nán
癮	-
網癮少女	-
洗腦神曲	-
在線	-
直女癌	zhí nǚ ái
贏	-
人生贏家	-
约定	yuēdìng
備	-
備胎	-
翻墻	-
墻裂	-
負	-
負能量	-
宇宙觀	-
鬼畜	guǐ chù
作出	zuòchū
I	-
为I做E	wéi i zuò e
什麼鬼	-
老总	lǎozǒng
磚家	-
下来	xiàlai
趕	-
趕腳	-
腳	-
卵巢彩票	luǎn cháo cǎi piào
抱緊我	-
獨	-
陳獨秀	-
画风突变	huà fēng tū biàn​
魚	-
鱸	-
鱸魚	-
凰	huáng
鳳	-
鳳凰男	-
本命	běn mìng
S	-
抖S	dǒu s
我想靜靜	-
靜	-
傲嬌	-
保持围笑	bǎo chí wéi xiào
翻牌	fān pái
佛系追星	fó xì zhuì xīng
串	chuàn
鍵盤俠	-
鍵	-
盤	-
確	-
小確喪	-
摸頭殺	-
澤	-
李澤言	-
了解一下	liǎo jiě yí xià
道友	dào yǒu
抗日神劇	-
偏偏	piānpiān
表情管理	biǎo qíng guǎn lǐ
課	-
課代表	-
擔	-
擔當	-
當	-
叫獸	-
獸	-
輕拍	-
輕	-
吸貓	-
逆天改命	nì tiān gǎi mìng
秒刪	-
刪	-
會聊天	-
麼麼噠	-
豬精女孩	-
豬	-
總攻	-
網感	-
盡	-
友盡	-
母職懲罰	-
罰	-
懲	-
碰瓷	pèng cí
大豬蹄子	-
蹄	tí
厉害	lìhai
約炮	-
約	-
洪荒之力	hóng huāng zhī lì
跳戲	-
微博淪陷	-
淪	-
劃掉	-
劃	-
反差萌	fǎn chā méng
愛無能	-
土創	-
創	-
白嫖飯	-
嫖	piáo
鎖場	-
場	-
天仙攻	tiān xiān gōng
躺槍	-
槍	-
送你上墻	-
塘主	táng zhǔ
帶節奏	-
少女心	shào nǚ xīn
黑科技	hēi kē jì
土嗨	tǔ hāi
手撕鬼子	shǒu sī guǐ zi
實力	-
蛙	wā
蛙哥	wā gē
高仿號	-
歲	-
三歲	-
鹿	lù
蹣	-
跚	shān
老鹿蹣跚	-
反向育儿	fǎnxiàng yùér
妖	yāo
妖艷賤貨	-
艷	-
遠	-
詩和遠方	-
殺馬特	-
只有	zhǐyǒu
油膩	-
老司機	-
吃瓜群眾	-
種子	-
高級臉	-
不但……而且……	búdàn…érqiě…
（	-
过（动词）	guò
）	-
花（动词）	huā
花（名词）	huā
还（动词）	huán
长（动词）	zhǎng
只（量词）	zhī
只（副词）	zhǐ
只有……才……	zhǐyǒu…cái…
纽扣儿	niǔkòur
喂（叹词）	wèi
小孩哥/姐	xiǎohái gē / jiě
/	-
特种兵式旅游	tèzhǒngbīng shì lǚyóu
Gap Day	gap   day
 	-
D	-
脆皮大学生	cuìpí dàxuéshēng
电子呕吐物	diànzǐ ǒutùwù
猫奴	māo nú
铲屎官	chǎn shǐ guān
铲	chǎn
国漫	guó màn
上头姐妹	shàng tóu jiě mèi
上头	shàng tóu
甜宠	tián chǒng
根本停不下来	gēn běn tíng bú xià lái
s	-
g	-
m	-
n	-
<	-
q	-
zqsg <Acronym> 真情实感	zhēn qíng shí gǎn
r	-
>	-
z	-
c	-
xswl <Acronym> 笑死我了	xiào sǐ wǒ le
x	-
271	èr qī yī
7	-
1	-
2	-
d	-
b	-
dbq <Acronym> 对不起	duì bù qǐ
h	-
bhys <Acronym> 不好意思	bù hǎo yì si
sjb <Acronym> 神经病	shén jīng bìng
j	-
djll <Acronym> 顶级流量	dǐng jí liú liàng
拍砖	pāi zhuān
轻拍	qīng pāi
。	-
这是。。。被黑得最惨的一次	zhè shì…beì hēi de zuì cǎn de yí cì
原著党	yuán zhù dǎng
G点	G diǎn
技术宅	jì shù zhái
聊骚	liáo sāo
自带BGM	Zì dài BGM
B	-
大猪蹄子	dà zhū tí zi
暴击	bào jī
，	-
一方有难，八方点赞	yì fāng yǒu nàn, bā fāng diǎn zàn
你国	nǐ guó
楼主	lóu zhǔ
人设已崩	rén shè yǐ bēng
王之蔑视	wáng zhī miè shì
领盒饭	lǐng hé fàn
黄桑	huáng sāng
怼天怼地	duǐ tiān duǐ dì
怼	duǐ
人民币玩家	rén mín bì wán jiā
叫兽	jiào shòu
软妹	ruǎn meì
笑著活下去	xiào zhe huó xià qù
刮锅底笑	guā guō dǐ xiào
陌上人如玉，公子世无双	mò shàng rén rú yù, gōng zǐ shì wú shuāng
定一个小目标	dìng gè xiǎo mù biāo
脱饭	tuō fàn
凉凉	liáng liáng
赛高	sài gāo
粉头	fěn tóu
雾草	wù cǎo
居老师	jū lǎo shī
入画	rù huà
镇魂女孩	zhèn hún nǚ hái
定档	dìng dǎng
擦妈	cā mā
母职惩罚	mǔ zhí chěng fá
地表最强	dì biǎo zuì qiáng
可盐可甜	kě yán kě tián
沦	lún
微博沦陷	wēi bó lún xiàn
谁还不是小公主咋的	shuí hái bú shì xiǎo gōng zhǔ zǎ di
6	-
6 (=666)	liù (liù liù liù)
=	-
)	-
(	-
一丢丢	yì diū diū
灵魂舞者	líng hún wǔ zhě
处女脸	chù nǚ liǎn
职业假笑	zhí yè jiǎ xiào
全靠同行衬托	quán kào tóng háng chèn tuō
开画	kāi huà
自带热搜体质	zì dài rè sōu tǐ zhì
厂牌	chǎng pái
汤老湿	tāng lǎo shī
老湿	lǎo shī
低分飘过	dī fēn piāo guò
冲鸭	chōng yā
聊天终结者	liáo tiān zhōng jié zhě
sk <Acronym> 生快	shēng kuài
k	-
养成系	yǎng chéng xì
粉丝滤镜	fěn sī lǜ jìng
太阳女神	tài yáng nǚ shén
:	-
pyq: Acronym for 朋友圈	péng yǒu quān
f	-
盛世美颜	shèng shì měi yán
我就笑笑不说话	wǒ jiù xiào xiào bù shuō huà
史上最。。。	shǐ shàng zuì
NTR <Acronym>	NTR
R	-
N	-
公开处刑	gōng kāi chǔ xíng
配一脸	pèi yì liǎn
不按套路出牌	bú àn tào lù chū fā
声控	shēng kòng
娇嗔	jiāo chēn
红红火火恍恍惚惚	hóng hóng huǒ huǒ huǎng huǎng hū hū
惚	hū
一步两步， 是魔鬼的步伐	yī bù liǎng bù, shì mó guǐ de bù fá
全程无尿点	quán chéng wú niào diǎn
嫉妒使我质壁分离	jì dù shǐ wǒ zhì bì fēn lí
风骚走位	fēng sāo zǒu weì
土味情话	tǔ weì qíng huà
搬运	bān yùn
颜狗	yán gǒu
肉体饭	ròu tǐ fàn
赛金花	sài jīn huā
没眼看	méi yǎn kàn
愿你出走半生，归来仍是少年	yuàn nǐ chū zǒu bàn shēng, guī lái réng shì shào nián
流量才是王道	liú liáng cái shì wáng dào
是有多。。。	shì yǒu duō…
鹅	é
然鹅	rán é
槽点满满	cáo diǎn mǎn mǎn
狗粮猝不及防	gǒu liáng cù bù jí fáng
猝	cù
元气	yuán qì
首先你要有个。。。	shǒu xiān nǐ yào yǒu gè…
自干五	zì gàn wǔ
五毛党	wǔ máo dǎng
老鹿蹒跚	lǎo lù pán shān
蹒	pán
老夫的少女心	lǎo fū de shào nǚ xīn
一本正经地胡说八道	yì běn zhèng jǐng de hú shuō bā dào
不能同意更多	bù néng tóng yì gèng duō
不转不是中国人	bù zhuǎn bú shì zhōng guó rén
标题党	biāo tí dǎng
是中国人就转	shì zhōng guó rén jiù zhuǎn
钢铁直男	gāng tiě zhí nán
激情小短片	jī qíng xiǎo duǎn pian
520	wǔ èr líng
5	-
0	-
秒删	miǎo shān
中央空调	zhōng yāng kōng tiáo
众人皆醉我独醒	zhòng rén jiē zuì wǒ dú xǐng
脑子瓦特了	nǎo zi wǎ tè le
糟了，是心动的感觉	zāo le, shì xīn dòng de gǎn jué
得罪造型师	dé zuì zào xíng shī
皮一下很开心	pí yí xià hěn kāi xīn
总攻	zǒng gōng
总攻本攻	zǒng gōng běn gōng
歪个楼	wāi gè lóu
现充	xiàn chōng
史诗级	shǐ shī jí
鹅厂	é chǎng
亲亲抱抱举高高	qīn qīn bào bào jǔ gāo gāo
自戳双目	zì chuō shuāng mù
紧脏	jǐn zāng
干得漂亮	gàn de piào liang
我们家	wǒ men jiā
陈大发	chén dà fā
装完逼就跑	zhuāng wán bī jiù pǎo
某宝	mǒu bǎo
嫁给了爱情的模样	jià gěi le ài qíng de mú yàng
灭霸	miè bà
壮士	zhuàng shì
隐形贫困人口	yǐn xíng pín kùn rén kǒu
脱粉	tuō fěn
抖腿党	dǒu tuǐ dǎng
戾气	lì qì
结石姐	jié shí jiě
好看的皮囊千篇一律，有趣的灵魂万里挑一	hǎo kàn de pí náng qiān piān yí lǜ, yǒu qù de líng hún wàn lǐ tiāo yī
囊	náng
磨人的小妖精	mó rén de xiǎo yāo jing
举高高	jǔ gāo gāo
送你上热评	sòng nǐ shàng rè píng
送你上墙	sòng nǐ shàng qiáng
i	-
Q	-
QAQ <Emoticon>	QAQ
t	-
猫系男	māo xì nán
这种男友不分留著过年么	zhè zhǒng nán yǒu bù fēn liú zhe guò nián ma
这位同学，我装逼的时候，请你不要说话	zhè weì tóng xué, wǒ zhuāng bī de shí hou, qǐng nǐ bú yào shuō huà
杏红	xìng hóng
新专	xīn zhuān
地图炮	dì tú pào
土创	tǔ chuàng
斯巴达	sī bā dá
煞笔	shā bǐ
不喜勿喷	bù xǐ wù pēn
何老师	hé lǎo shī
陈老师	chén lǎo shī
脑斧	nǎo fǔ
战斗民族	zhàn dòu mín zú
意不意外？惊不惊喜？	yì bú yì wài? jīng bù jīng xǐ?
招黑体质	zhāo hēi tǐ zhì
双标狗	shuāng biāo gǒu
建国后不许成精	jiàn guó hòu bù xǔ chéng jīng
女权癌	nǚ quán ái
女权婊	nǚ quán biǎo
中华田园女权	zhōng huá tián yuán nǚ quán
跳戏	tiào xì
越努力，越幸运	yuè nǔ lì, yuè xìng yùn
菇凉	gū liáng
课代表	kè dài biǎo
渣渣辉	zhā zhā huī
社会我X哥/姐	shè huì wǒ X gē/jiě
谢耳朵	xiè ěr duo
大清早亡了	dà qīng zǎo wáng le
马杀鸡	mǎ shā jī
确认过眼神	què rèn guò yǎn shén
贤者时间 (=贤者模式)	xián zhě shí jiān
没节操	méi jié cāo
高光时刻	gāo guāng shí kè
锤哥	chuí gē
脑残粉	nǎo cán fěn
暗中观察	àn zhōng guān chá
这届…不行	zhè jiè…bù xíng
智商税	zhì shāng shuì
伟光正	wěi guāng zhèng
不服来战	bù fú lái zhàn
杠铃般的笑声	gàng líng bān de xiào shēng
乃们	nǎi men
赶脚	gǎn jiǎo
收图	shōu tú
私货	sī huò
正在提刀赶来的路上	zhèng zài tí dāo gǎn lái de lù shàng
这是一道超纲题	zhè shì yí dào chāo gāng tí
自带滤镜	zì dài lǜ jìng
撩骚	liáo sāo
亲妈粉	qīn mā fěn
阔以	kuò yǐ
旋转跳跃闭著眼	xuán zhuǎn tiào yuè bì zhe yǎn
划掉	huà diào
开心到飞起	kāi xīn dào fēi qǐ
扶墙	fú qiáng
扶我上墙	fú wǒ shàng qiáng
不扶墙就服你	bù fú qiáng jiù fú nǐ
奔现	bēn xiàn
膨胀	péng zhàng
网绿	wǎng lǜ
李泽言	lǐ zé yán
土木三班陈同学	tǔ mù sān bān chén tóng xué
陈独秀	chén dú xiù
诺兰黑	nuò lán hēi
卖腐	mài fǔ
古风	gǔ fēng
炸号	zhà hào
活好不粘人	huó hǎo bù nián rén
三连	sān lián
白嫖饭	bái piáo fàn
地主家的傻儿子	dì zhǔ jiā de shǎ ér zi
请开始你的表演	qǐng kāi shǐ nǐ de biǎo yǎn
腻害	nì hài
亲测有效	qīn cè yǒu xiào
云吸猫	yún xī māo
主角光环	zhǔ jué guāng huán
狗头	gǒu tóu
世界那么大，我想去看看	shì jiè nà me dà, wǒ xiǎng qù kàn kàn
.	-
每一个抖腿爱好者的心里. 大概都住著一台缝纫机	měi gè dǒu tuǐ ài hào zhě de xīn lǐ, dà gài dōu zhù zhe yì tái féng rèn jī
纫	rèn
诗和远方	shī hé yuǎn fāng
双标	shuāng biāo
暴露年龄	bào lù nián líng
塑料花姐妹情	sù liào huā jiě meì qíng
背锅侠	bēi guō xiá
过气网红	guò qì wǎng hóng
宝妈	bǎo mā
送分题	sòng fēn tí
送命题	sòng mìng tí
不可描述之事	bù kě miáo shù zhī shì
口嫌体正直	kǒu xián tǐ zhèng zhí
嘴上说不要，身体却很诚实	zuǐ shàng shuō bú yào, shēn tǐ què hěn zhèng zhí
逃离北上广	táo lí běi shàng guǎng
鲈	lú
鲈鱼	lú yú
脑子瓦特	nǎo zi wǎ tè
装逼犯	zhuāng bī fàn
躁起来	zào qǐ lai
炮总	pào zǒng
可以说是	kě yǐ shuō shì
网瘾少女	wǎng yǐn shào nǚ
我下面给你吃	wǒ xià miàn gěi nǐ chī
脏辫	zāng biàn
床上运动	chuáng shàng yùn dòng
网感	wǎng gǎn
杀马特	shā mǎ tè
大吉大利，今晚吃鸡	dà jí dà lì, jīn wǎn chī jī
高级脸	gāo jí liǎn
男频	nán pín
女频	nǚ pín
补档	bǔ dǎng
第X弹	dì n dàn
备胎	bèi tāi
周冬雨式凝视	zhōu dōng yǔ shì níng shì
绿光	lǜ guāng
头顶一片草原	tóu dǐng yí piàn cǎo yuán
岛国	dǎo guó
科学上网	kē xué shàng wǎng
脑回路清奇	nǎo huí lù qīng qí
翻红	fān hóng
走肾	zǒu shèn
肾	shèn
社会主义巨婴	shè huì zhǔ yì jù yīng
遇见更好的自己	yù jiàn gèng hǎo de zì jǐ
实锤	qiú chuí
求锤得锤	qiú chuí dé chuí
土肥圆	tǔ féi yuán
乱入	luàn rù
斗图	dòu tú
做一个精致的猪猪女孩	zuǒ yí gè jīng zhì de zhū zhū nǚ hái
v	-
+	-
我+可能+ v.+的是假+n.	wǒ kě néng v. de shì jiǎ n.
粉丝行为，偶像买单	fěn sī xíng wéi, ǒu xiàng mǎi dān
开黑	kāi hēi
目测要火	mù cè yào huǒ
立flag	lì flag
开封菜	kāi fēng cài
金拱门	jīn gǒng mén
这盛世如你所愿	zhè shèng shì rú nǐ suǒ yuàn
劳模姐	láo mó jiě
L	-
母胎SOLO	mǔ tāi SOLO
?	-
!	-
我能怎么办? 我也很绝望啊!	wǒ néng zěn me bàn? wǒ yě hěn jué wàng a
吸猫	xī māo
强排	qiáng pái
爱无能	ài wú néng
解锁技能	jiě suǒ jì néng
带节奏	dài jié zòu
照骗	zhào piàn
猪精女孩	zhū jīng nǚ hái
抖机灵	dǒu jī ling
断眉	duàn méi
妈卖批	mā mài pī
神经病啊	shén jīng bìng a
我不要面子的啊	wǒ bú yào miàn zi de a
高仿号	gāo fǎng hào
霸气侧漏	bà qì cè lòu
放飞自我	fàng fēi zì wǒ
普天同庆	pǔ tiān tóng qìng
围笑	wéi xiào
戏精	xì jīng
颜即正义	yán jì zhèng yì
虾	háxiā
皮皮虾，我们走	pí pí xiā, wǒ men zǒu
锁场	suǒ chǎng
把我炸出来	bǎ wǒ zhà chū lái
情怀	qíng huái
丧文化	sàng wén huà
小确丧	xiǎo què sàng
打Call	dǎ call
女司机	nǚ sī jī
马路杀手	mǎ lù shā shǒu
扎心了，老铁	zhā xīn le, lǎo tiě
还有这种操作	hái yǒu zhè zhǒng cāo zuò
黑人问号	hēi rén wèn hào
站队	zhàn duì
砸简历	zá jiǎn lì
绿绿	lǜ lǜ
翻墙	fān qiáng
墙内	qiáng nèi
墙外	qiáng wài
爱笑的女孩运气不会太差	ài xiào de nǚ hái yùn qi bú huì tài chà
撒狗粮	sǎ gǒu liáng
回忆杀	huí yì shā
摸头杀	mō tóu shā
三岁	sān suì
劳资 (=老子)	láo zī (=lǎo zi)
抗日神剧	kàng rì shén jù
脸大	liǎn dà
你的良心不会痛吗	nǐ de liáng xīn bú huì tòng ma
葛优瘫	gě yōu tān
别说话，吻我	bié shuō huà, wěn wǒ
厉害了word…	lì hài le word…
点赞之交	diǎn zàn zhī jiāo
这样的。。。给我来一打	zhè yàng de…gěi wǒ lái yì dá
鬼知道我经历了什么	guǐ zhī dào wǒ jīng lì le shén me
什么仇什么怨	shén me chóu, shén me yuàn
废柴	fèi chái
黑历史	hēi lì shǐ
钱妞	qián niū
吉米肥伦秀	jí mǐ féi lún xiù
吉米鸡毛秀	jí mǐ jī máo xiù
扣扣熊	kòu kòu xióng
付兰兰 / 腐兰兰	fù lán lán / fǔ lán lán
麻辣鸡	má là jī
蛋妞儿	dàn niū er
宇宙观	yǔ zhòu guān
怎么破	zěn me pò
丧心病狂	sàng xīn bìng kuáng
传送门	chuán sòng mén
摊手	tān shǒu
热单	rè dān
你还记得大明湖畔的。。。吗	nǐ hái jì dé dà míng hú pàn de…ma
教科书般	jiào kē shū bān
不装逼我们还是好朋友	bù zhuāng bī wǒ men hái shì hǎo péng yǒu
弃坑	qì kēng
吓尿	xià niào
禁欲系	jìn yù xì
然并卵	rán bīng luǎn
追剧	zhuī jù
视奸	shī jiān
砖家	zhuān jiā
干了这碗毒鸡汤	gān le zhè wǎn dú jī tāng
细思恐极	xì sī kǒng jí
请收下我的膝盖	qǐng shōu xià wǒ de xī gài
蹭热度	cèng rè dù
单身汪	dān shēn wāng
天啦噜	tiān la lu
噜	lū
你这是在搞事情	nǐ zhè shì zài gǎo shì qing
相爱相杀	xiāng ài xiāng shā
你咋不上天呢	nǐ zǎ bú shàng tiān ne
来啊，互相伤害啊	lái a, hù xiāng shāng hài a
先马后看	xiān mǎ hòu kàn
蓝瘦香菇	lán shòu xiāng gū
种草	zhòng cǎo
男神经 /女神经	nán shén jīng / nǚ shén jīng
炒鸡	chǎo jī
有范	yǒu fàn
厉害了我的哥	lì hài le wǒ de gē
此处应有掌声	cǐ chù yīng yǒu zhǎng shēng
感觉身体被掏空	gǎn jué shēn tǐ bèi tāo kōng
脱线	tuō xiàn
始于颜值，陷于才华，忠于人品	shǐ yú yán zhí, xiàn yú cái huá, zhōng yú rén pǐn
痴汉脸	chī hàn liǎn
痴	chī
湾湾	wān wān
墙裂	qiáng liè
霍比特人 (=哈比人)	huò bǐ tè rén (=hā bǐ rén)
拗	àoniù
凹造型 (=拗造型 )	āo zào xíng (=ǎo zào xíng)
担当	dān dāng
尴尬症	gān gà zhèng
尴尬癌	gān gà ái
懒癌	lǎn ái
在线	zài xiàn
粗线	cū xiàn
钟黑	zhōng hēi
老干部	lǎo gàn bu
碾压	niǎn yā
喷子	pēn zi
芯	xīnxìn
比心 /笔芯	bǐ xīn
贱	jiàn
妖艳贱货	yāo yàn jiàn huò
好单纯好不做作	hǎo dān chún hǎo bú zuò zuò
迷之=蜜汁	mí zhī/mì zhī
白莲花	bái lián huā
莲	lián
吃瓜群众	chī guā qún zhòng
对方不想和你说话并向你扔了一只狗	duì fāng bù xiǎng hé nǐ shuō huà bìng xiàng nǐ rēng le yì zhī gǒu
背锅	bēi guō
甩锅	shuǎi guō
一言不合就。。。	yì yán bù hé jiù…
约炮	yuē pào
饭制	fàn zhì
饭拍	fàn pāi
毁童年	huǐ tóng nián
干货	gān huò
荷	héhéhè
行走的荷尔蒙	xíng zǒu de hé ěr méng
内个	nèi ge
狗带	gǒu dài
撞脸	zhuàng liǎn
没想到你是这样的。。。	méi xiǎng dào nǐ shì zhè yàng de…
老司机	lǎo sī jī
不能我一个人瞎	bù néng wǒ yí gè rén xiā
手贱	shǒu jiàn
人设	rén shè
小黄书	xiǎo huáng shū
爱情动作片	ài qíng dòng zuò pian
船戏 (=床戏)	chuán xì/chuáng xì
滚床单	gǔn chuáng dān
发糖	fā táng
好奇宝宝	háo qí bǎo bao
撸	lū
LOL=撸啊撸	lū a lū
颜艺	yán yì
苏 (=酥)	sū
酥	sū
,	-
放开他, 让我来	fàng kāi tā, ràng wǒ lái
无感	wú gǎn
生无可恋	shēng wú kě liàn
我走过最远的路，是你的套路	wǒ zǒu guò zuì yuǎn de lù, shì nǐ de tào lù
少一点套路，多一点真诚	shǎo yì diǎn tào lù, duō yì diǎn zhēn chéng
发动洪荒之力	fā dǒng hóng huāng zhī lǐ
抵挡不住体内的洪荒之力	dǐ dǎng bú zhù tǐ nèi de hóng huāng zhī lì
哒	dā
么么哒	mē mē da
这句话我给满分	zhè jù huà wǒ gěi mǎn fēn
会聊天	huì liáo tiān
不会聊天	bú huì liáo tiān
应援	yìng yuán
男友力MAX	nán yǒu lì MAX
本宝宝	běn bǎo bao
明明可以靠脸吃饭, 偏偏要靠才华	míng míng kě yǐ kào liǎn chī fàn, piān piān yào kào cái huá
节操掉了一地	jié cāo diào le yí dì
巅	diān
颜值巅峰	yán zhí diān fēng
洗脑神曲	xǐ nǎo shén qǔ
活久见	huó jiǔ jiàn
烧脑	shāo nǎo
蒙圈 (=懵圈=懵逼 )	mēng quān (=měng bī)
懵	měng
凤	fèng
凤凰男	fèng huáng nán
键盘侠	jiàn pán xiá
狗粮	gǒu liáng
瞎逼逼=瞎BB	xiā bī bī
你行你上，不行别瞎BB	nǐ xíng nǐ shàng, bù xíng bié xiā bī bī
调戏=TX	tiáo xì
开挂	kāi guà
朝阳群众	cháo yáng qún zhòng
我伙呆 (=我和小伙伴都惊呆了)	wǒ huǒ dāi (=wǒ hé xiǎo huǒ bàn men dōu jīng dāi le)
节操	jié cāo
从此节操是路人	cóng cǐ jié cāo shì lù rén
城会玩	chéng huì wán
心机boy/girl	xīn jī boy/girl
粗来	cū lái
严肃脸	yán sù liǎn
。。。不是高冷，只是暖的不是你	。。。bú shì gāo lěng, zhǐ shì nuǎn de bú shì nǐ
妈妈问我为什么跪著看。。。	mā ma wèn wǒ wèi shén me guì zhe kàn。。。
没sei了 (= 没谁了)	méi séi le (méi shuí le)
e	-
圣诞趴	shèng dàn pā
轰趴	hōng pā
卖家秀	mài jiā xiù
买家秀	mǎi jiā xiù
买买买	mǎi mǎi mǎi
弧	hú
反射弧过长	fǎn shè hú guò cháng
陪伴，是最长情的告白	péi bàn, shì zuì cháng qíng de gào bái
车震	chē zhèn
娇羞	jiāo xiū
……的正确打开方式	……de zhèng què dǎ kāi fāng shì
机智如我	jī zhì rú wǒ
以梦为马	yǐ mèng wéi mǎ
自己挖的坑，跪著也要填完	zì jǐ wā de kēng, guì zhe yě yào tián wán
上辈子拯救了银河系	shàng bèi zi zhěng jiù le yín hé xì
拯	zhěng
讲真	jiǎng zhēn
一大波僵尸正在接近	yí dà bō jiāng shī zhèng zài jiē jìn
反转	fǎn zhuǎn
抱紧我	bào jǐn wǒ
哏 (=梗)	gén (=gěng)
气场两米八	qì chǎng liǎng mǐ bā
-	-
vegan-dish带感	dài gǎn
内心戏	nèi xīn xì
宠溺	chǒng nì
习大大	xí dà dà
小公举	xiǎo gōng jǔ
碎碎念	suì suì niàn
用生命在……	yòng shēng mìng zài
鸡冻 (=激动)	jī dòng
霸道总裁爱上我	bà dào zǒng cái ài shàng wǒ
霸道总裁	bà dào zǒng cái
人生赢家	rén shēng yíng jiā
YY=歪歪	wāi wāi
Y	-
求……的心理阴影面积	qiú…de xīn lǐ yīn yǐng miàn ji
既视感	jì shì gǎn
看脸的世界	kàn liǎn de shì jiè
颜控	yán kòng
我想静静	wǒ xiǎng jìng jìng
外貌协会	wài mào xié huì
用力过猛	yòng lì guò měng
花式秀恩爱	huā shì xiù ēn ài
不忍直视	bù rěn zhí shì
男神/女神	nán shén / nǚ shén
负能量	fù néng liàng
逆袭	nì xí
并没有	bìng méi yǒu
什么鬼	shén me guǐ
深夜发吃，报复社会	shēn yè fā chī, bào fù shè huì
吓出翔	xià chū xiáng
国民老公	guó mín lǎo gōng
打脸	dǎ liǎn
绿茶婊	lǜ chá biǎo
友尽	yǒu jìn
水军	shuǐ jūn
贵圈真乱	guì quān zhēn luàn
壕 (=土豪 )	háo (=tǔ háo)
网红	wǎng hóng
业界良心	yè jiè liáng xīn
怒刷存在感	nù shuā cún zài gǎn
累觉不爱	lèi jué bú ài
笑得像钟汉良一样	xiào de xiàng zhōng hàn liáng yí yàng
傲娇	ào jiāo
玛	mǎ
玛丽苏	mǎ lì sū
真爱粉	zhēn ài fěn
饭随爱豆	fàn suí ài dòu
被自己帅醒	bèi zì jǐ shuài xǐng
LM=良民	liáng mín
萌萌哒	méng méng da
路(人)转粉	lù (rén) zhuǎn fěn
逆生长	nì shēng zhǎng
​	-
画风​	huà fēng
脑洞	nǎo dòng
少女心收割机	shào nǚ xīn shōu gē jī
取关	qǔ guān
3	-
装13 (=装逼=装B)	zhuāng shí sān (=zhuāng bī)
颜值爆表	yán zhí bào biǎo
单身​狗	dān shēn gǒu
闺	guī
男闺蜜	nán guī mì
逗逼=逗比	dòu bī
你们感受下	nǐ men gǎn shòu xià
我也是醉了	wǒ yě shì zuì le
还能不能愉快地玩耍了	hái néng bù néng yú kuài de wán shuǎ le
小鲜肉	xiǎo xiān ròu
Z	-
u	-
不作死就不会死 (No Zuo No Die)	bù zuō sǐ jiù bú huì sǐ (no zuō no die)
感觉自己萌萌哒	gǎn jué zì jǐ méng méng da
-_-||=黑线	hēi xiàn
|	-
_	-
分分钟	fēn fēn zhōng
脑残	nǎo cán
这货	zhè huò
躺枪	tǎng qiāng
人生苦短，必须性感	rén shēng kǔ duǎn bì xū xìng gǎn
高手在民间	gāo shǒu zài mín jiān
这 (这儿)	zhè ( zhèr)
那 (那儿)	nà (nàr)
得（助动词）	děi
等 （动）	děng
叫...做...	jiào ... zuò ...
我叫女朋友教我中文。	wǒ jiào nǚpéngyou jiào wǒ zhōngwén 。
我的女朋友让我喝酒。	wǒ de nǚpéngyou ràng wǒ hējiǔ 。
她让我帮她搬很重的东西。	tā ràng wǒ bāng tā bān hěn zhòng de dōngxi 。
看我的小猫让我很开心。	kàn wǒ de xiǎomāo ràng wǒ hěn kāixīn 。
给她买一个包包	gěi tā mǎi yīgè bāobāo
看我的妈妈	kàn wǒ de māma
陪女朋友吃饭	péi nǚpéngyou chīfàn
这个房间很黑。	zhège fángjiān hěn hēi 。
百分之二十	bǎifēnzhīèrshí
喂猫吃猫粮	wèi māo chī māo liáng
让我看起来不错	ràng wǒ kànqǐlai bùcuò
对他有礼貌	duì tā yǒu lǐmào
那句话的意思	nàjùhuà de yìsi
看见/ 听见	kànjiàn /   tīngjiàn
看懂/ 听懂	kàn dǒng /   tīngdǒng
看完一本书	kàn wányī běnshū
看到/ 听到	kàndào /   tīngdào
她没做完作业。	tā méi zuòwánzuòyè 。
你怎么知道...?	nǐ zěnme zhīdào ... ?
要么...要么...	yàome ... yàome ...
这样做/ 这样想/ 这样说	zhèyàng zuò /   zhèyàng xiǎng /   zhèyàng shuō
从...开始	cóng ... kāishǐ
她让我别说谎	tā ràng wǒbié shuōhuǎng
迟到十分钟	chídào shífēnzhōng
对...很失望	duì ... hěn shīwàng
对...很满意	duì ... hěn mǎnyì
对...很感兴趣	duì ... hěngǎnxīngqù
对...感到很开心	duì ... gǎndào hěn kāixīn
对...好	duì ... hǎo
对...有帮助/ 没帮助	duì ... yǒu bāngzhù /   méi bāngzhù
对...有影响/ 有好的影响	duì ... yǒu yǐngxiǎng /   yǒu hǎo de yǐngxiǎng
鸡蛋碰石头	jīdàn pèng shítou
躺平的韭菜不好割	tǎngpíng de jiǔcài bùhǎo gē
药店离我家走路五分钟	yàodiàn lí wǒjiā zǒulù wǔfēnzhōng
对...满意	duì ... mǎnyì
觉得很满足	juéde hěn mǎnzú
成为+noun	chéngwéi + noun
成为一个医生	chéngwéi yīgè yīshēng
用手机打电话	yòng shǒujī dǎdiànhuà
用电脑工作	yòng diànnǎo gōngzuò
我个人觉得	wǒ gèrén juéde
跟...比起来	gēn ... bǐ qǐlai
周年纪念日	zhōunián jìniànrì
一切皆有可能	yīqiè jiē yǒu kěnéng
放一首歌/ 播一首歌	fàng yīshǒugē /   bō yīshǒugē
放一部电影/ 播一部电影	fàng yībù diànyǐng /   bō yībù diànyǐng
发一张照片给她	fā yīzhāng zhàopiàn gěi tā
拍照片/ 拍照	pāizhàopiàn /   pāizhào
欧洲的水电费比美国的要贵	ōuzhōu de shuǐdiànfèi bǐ měiguó de yào guì
我说得不太好	wǒ shuō dé bùtàihǎo
完美主义者	wánměi zhǔyìzhě
我昨天作业没写得很好	wǒ zuótiān zuòyè méixiě dé hěn hǎo
跟...一样/ 不一样	gēn ... yīyàng /   bù yīyàng
她德语比我说得好	tā déyǔ bǐ wǒ shuōdéhǎo
她德语比我说得好得多	tā déyǔ bǐ wǒ shuō dé hǎodeduō
她德语说得比我好	tā déyǔ shuō dé bǐ wǒ hǎo
她德语说得比我好得多	tā déyǔ shuō dé bǐ wǒ hǎodeduō
小明花钱花得非常多	xiǎomíng huāqián huādé fēicháng duō
小明钱比小李花得多得多	xiǎomíng qián bǐ xiǎo lǐhuā dé duōdéduō
丈夫和妻子	zhàngfu hé qīzi
先生和太太	xiānsheng hé tàitai
老公和老婆	lǎogong hé lǎopó
戴帽子/口罩/手表/围巾/眼镜	dàimàozi / kǒuzhào / shǒubiǎo / wéijīn / yǎnjìng
穿衣服/ 裤子/ 鞋子/ 袜子	chuānyīfú /   kùzi /   xiézi /   wàzi
在这个情况下	zài zhège qíngkuàng xià
在这张照片里	zài zhèzhāng zhàopiàn lǐ
休闲的衣服	xiūxián de yīfú
带...来	dài ... lái
带...去	dài ... qù
拿咖啡/ 签证/ 车/ 外卖	ná kāfēi /   qiānzhèng /   chē /   wàimài
你拿一本书来	nǐ ná yī běnshū lái
我有一些饼干，你拿去吧	wǒ yǒu yīxiē bǐnggān ， nǐ ná qù bā
进来吧，随便坐吧	jìnlái bā ， suíbiàn zuò bā
莉莎比我爱干净	lì shā bǐ wǒ ài gānjìng
莉莎很爱干净	lì shā hěn ài gānjìng
高强度间歇训练	gāoqiángdù jiànxiē xùnliàn
虽然...但是...	suīrán ... dànshì ...
即使...也...	jíshǐ ... yě ...
即使我学一门很简单的语言，也需要很长时间。	jíshǐ wǒxué yīmén hěn jiǎndān de yǔyán ， yě xūyào hěn chángshíjiān 。
...还可以，就是...	... huán kěyǐ ， jiùshì ...
《	-
《北京遇上西雅图》	《 běijīng yùshàng xīyǎtú 》
》	-
《离婚律师》	《 líhūn lǜshī 》
他们下个星期就要结婚了。	tāmen xiàgèxīngqī jiùyào jiéhūn le 。
他们快要/就要结婚了。	tāmen kuàiyào / jiùyào jiéhūn le 。
我不喝酒了。	wǒ bù hējiǔ le 。
我不想再喝酒了。	wǒ bùxiǎng zài hējiǔ le 。
已经...了	yǐjīng ... le
都...了	dōu... le
早就...了	zǎojiù ... le
大家都是成年人了，...	dàjiā dōu shì chéngniánrén le ， ...
我快要生气了	wǒ kuàiyào shēngqì le
我快要疯了	wǒ kuàiyào fēng le
谢谢你的帮助	xièxie nǐ de bāngzhù
打扫（一个空间）	dǎsǎo （ yīgè kōngjiān ）
刘	liú
劉	-
刘明苏 (劉明蘇)	liú míngsū   (lau4 ming4sou1)
感到很大的压力	gǎndào hěndà de yālì
准备好/ 买好票	zhǔnbèi hǎo /   mǎihǎo piào
跟我抱怨她的工作	gēn wǒ bàoyuàn tā de gōngzuò
这件事很急	zhèjiàn shì hěn jí
对...着迷	duì ... zháomí
我控制不住地	wǒ kòngzhì bùzhù de
不是每个美国人都喜欢吃比萨饼。	bùshì měige měiguó rén dū xǐhuan chī bǐsàbǐng 。
每个美国人都不喜欢吃比萨饼。	měige měiguó rén dū bù xǐhuan chī bǐsàbǐng 。
门儿都没有/ 没门儿	ménr dōu méiyǒu/ méi ménr
对自己的能力很自信	duì zìjǐ de nénglì hěn zìxìn
...的时候	... de shíhou
什么时候？	shénme shíhou ？
杭	háng
下有苏杭，上有天堂	xiàyǒusūháng ， shàngyǒutiāntáng
大众点评app	dàzhòng diǎnpíng app
搬...到...	bān ... dào ...
早日康复！	zǎorìkāngfù ！
！	-
无伴奏合唱	wú bànzòu héchàng
至少我是这么认为的	zhìshǎo wǒ shì zhème rènwéi de
它们有什么一样的地方？	tāmen yǒu shénme yīyàng de dìfāng ？
你觉得这件事有什么好的地方？	nǐ juéde zhèjiàn shìyǒu shénme hǎo de dìfāng ？
我很心疼她	wǒ hěn xīnténg tā
我爸爸去世了，我很心痛	wǒ bàba qùshì le ， wǒ hěn xīntòng
容易+verb/ adj.	róngyì + verb /   adj .
中文很容易学	zhōngwén hěn róngyì xué
白色的衣服很容易脏	báisè de yīfú hěn róngyì zāng
过朋友家去	guò péngyǒujiā qù
工作上的工作	gōngzuò shàng de gōngzuò
带一本书到中国去	dài yī běnshū dào zhōngguó qù
我走到公司去	wǒ zǒu dào gōngsī qù
我走到公司来了	wǒ zǒu dào gōngsī lái le
未婚夫和未婚妻	wèihūnfū hé wèihūnqī
吃了睡睡了吃	chī le shuìshuì le chī
妈妈一起床就做早饭	māma yī qǐchuáng jiù zuò zǎofàn
一...就...	yī ... jiù ...
看一场电影	kàn yīcháng diànyǐng
一辆自行车	yīliàng zìxíngchē
只有...才...	zhǐyǒu ... cái ...
在她的情况里	zài tā de qíngkuàng lǐ
吃的（东西）	chī de （ dōngxi ）
（街头）小吃	（ jiētóu ） xiǎochī
心情很复杂	xīnqíng hěn fùzá
朋友对我说	péngyou duì wǒ shuō
很近的地方	hěnjìn de dìfāng
附近的地方	fùjìn de dìfāng
我藏我的钱在床下	wǒcáng wǒ de qián zài chuáng xià
我躲在床下	wǒ duǒ zài chuáng xià
我记得有一次...	wǒ jìde yǒu yīcì ...
我在想...	wǒ zài xiǎng ...
很高的地位	hěn gāo de dìwèi
我想着...	wǒ xiǎngzhe ...
我觉着...	wǒ juézhe ...
球芽甘蓝/抱子甘蓝	qiú yágānlán / bàozigānlán
顺便说一下	shùnbiàn shuō yīxià
白天的时候	báitiān de shíhou
我不学中文了！	wǒ bùxué zhōngwén le ！
即使... 也...	jíshǐ ...   yě ...
人生的酸甜苦辣	rénshēng de suāntiánkǔlà
心里不舒服	xīnli bù shūfu
让我想起了	ràng wǒ xiǎngqǐ le
表情很丰富	biǎoqíng hěn fēngfù
找到一个方法	zhǎodào yīgè fāngfǎ
有规律的生活	yǒu guīlǜ de shēnghuó
给你留下了...的印象	gěi nǐ liúxià le ... de yìnxiàng
颜色很深/ 浅	yánsè hěnshēn /   qiǎn
对...很熟悉	duì ... hěn shúxī
打哈欠🥱	dǎhāqian 🥱
🥱	-
开过分的玩笑	kāi guòfèn de wánxiào
要想...	yào xiǎng ...
能接受新的想法	néng jiēshòu xīn de xiǎngfǎ
有很好的关系	yǒu hěn hǎo de guānxi
对。。。感兴趣	duì 。 。 。 gǎnxìngqù
他已经付钱了。	tā yǐjīng fùqián le 。
很会过日子	hěnhuì guòrìzi
每个人都是一个孤独的岛	měige rén dōu shì yīgè gūdú de dǎo
对。。。失望	duì 。 。 。 shīwàng
对。。。满意	duì 。 。 。 mǎnyì
对。。。感到很开心	duì 。 。 。 gǎndào hěn kāixīn
对。。。有帮助/没帮助	duì 。 。 。 yǒu bāngzhù / méi bāngzhù
对。。。有影响/有好的影响	duì 。 。 。 yǒu yǐngxiǎng / yǒu hǎo de yǐngxiǎng
一直往前走	yīzhí wǎngqiánzǒu
哪儿穿得(?)出去呀？	nǎr chuān dé ( ? ) chūqù ya ？
会被别人笑话	huì bèi biéren xiàohuà
我们要互相学习，互相帮助。	wǒmen yào hùxiāngxuéxí ， hùxiāngbāngzhù 。
在当地时间	zài dāngdì shíjiān
让我印象深刻	ràng wǒ yìnxiàng shēnkè
提高汉语水平	tígāo hànyǔ shuǐpíng
提高说话能力	tígāo shuōhuà nénglì
改善生活习惯	gǎishànshēnghuó xíguàn
改良一个产品	gǎiliáng yīgè chǎnpǐn
希望的灯塔	xīwàng de dēngtǎ
对...好奇	duì ... hàoqí
“双十一”	“ shuāngshí yī ”
性少数群体	xìng shǎoshù qúntǐ
几个星期前	jǐge xīngqī qián
稍微等一下	shāowēi děng yīxià
稍微有点儿冷	shāowēi yǒudiǎnr lěng
处理一些事情	chǔlǐ yīxiē shìqing
对付一个人	duìfu yīgè rén
生活要有仪式感	shēnghuó yào yǒu yíshì gǎn
当...的时候	dāng ... de shíhou
把...放进去	bǎ ... fàngjìnqù
把...拿出来	bǎ ... ná chūlái
社交尴尬症	shèjiāo gāngà zhèng
让我好尴尬	ràng wǒ hǎo gāngà
游泳运动员	yóuyǒng yùndòngyuán
打扮（成）	dǎbàn （ chéng ）
打扮 (成)	dǎbàn   ( chéng )
身材没有曲线	shēncái méiyǒu qūxiàn
人不可貌相	rénbùkěmào xiāng
内在(美)	nèizài ( měi )
你太过分了	nǐ tàiguòfēn le
这么说太过分了	zhème shuō tàiguòfēn le
玩笑开大了	wánxiào kāidà le
著名编剧谈抄袭	zhùmíng biānjù tán chāoxí
在你们行业中	zài nǐmen hángyè zhōng
以...为生	yǐ ... wéishēng
在他成名前，他曾以卖艺为生	zài tā chéngmíng qián ， tā zēng yǐ màiyì wéishēng
你怎么看？	nǐ zěnme kàn ？
你觉得呢？	nǐ juéde ne ？
你的看法是什么？	nǐ de kànfǎ shì shénme ？
扩大社交圈	kuòdà shèjiāoquān
互相问问题	hùxiāng wèn wèntí
对她耍脾气	duì tā shuǎpíqì
给...丢脸	gěi ... diūliǎn
随便扔垃圾	suíbiàn rēng lājī
变得很健忘	biànde hěn jiànwàng
未来的十年	wèilái de shínián
后果很严重	hòuguǒ hěn yánzhòng
精致的生活	jīngzhì de shēnghuó
精致的晚餐	jīngzhì de wǎncān
住在Airbnb	zhù zài airbnb
我的偶像塌房了	wǒ de ǒuxiàng tāfáng le
对...讲究	duì ... jiǎngjiu
酒香不怕巷子深	jiǔxiāng bùpà xiàngzishēn
拉斯维加斯	lāsīwéijiāsī
最后一根稻草	zuìhòu yīgēn dàocǎo
因为……所以……	yīnwèi…suǒyǐ…
虽然……但是……	suīrán…dànshì…
踢足球	tīzúqiú
打篮球	dǎlánqiú
系领带	jìlǐngdài
