麻辣雞	n. Spicy+chick. This Internet slang term is a nickname for Nicki Minaj because it sounds like her last name “Minaj” and compliments her voluptuous figure.
熱單	n. 【Music】Hot+single. Short for 熱門單曲 [rè mén dān qǔ] “hit single.”  This Internet slang term usually refers to European and American pop songs in English.
只管	solely engrossed in one thing; just (one thing, no need to worry about the rest); simply; by all means; please feel free; do not hesitate (to ask for sth)
渗透	(lit. and fig.) to permeate; to seep into; (of a product, idea etc) to penetrate (in a population); (of hostile forces) to infiltrate; (chemistry) osmosis
接着	to catch and hold on; to continue; to go on to do sth; to follow; to carry on; then; after that; subsequently; to proceed; to ensue; in turn; in one's turn
开放	to bloom; to open; to be open (to the public); to open up (to the outside); to be open-minded; unrestrained by convention; unconstrained in one's sexuality
自帶濾鏡	n. Pre-installed filters. This Internet slang term is often used to describe someone who looks beautiful as if he or she carries filters of his or her own.
母上大人	n. Mother+Her Excellency. Derived from the Japanese honorific title ” haha-ue” (ははうえ), this Internet slang term is used humorously to address one’s mother.
囧雪诺	n. Awkward+Snow. This Internet slang term is an affectionate nickname for Jon Snow, a character in Game of Thrones, because of 囧 [jiǒng] sounds like “Jon.”
不忘初心	<Expression> Do not forget the original aspiration. This expression is used to remind oneself or to commend others for sticking to one’s beliefs or dreams.
单身狗	n. Literally “single dog”, this Internet slang term refers to single people who are eager to enter a relationship but find it difficult to achieve the goal
顿	to stop; to pause; to arrange; to lay out; to kowtow; to stamp (one's foot); at once; classifier for meals, beatings, scoldings etc: time, bout, spell, meal
激烈	(of competition or fighting) intense; fierce; (of pain) acute; (of an expression of opinion) impassioned; vehement; (of a course of action) drastic; extreme
父上大人	n. Father+His Majesty. Derived from the Japanese honorific title “chichi-ue”  (ちちうえ) ,  this Internet slang term is used humorously to address one’s father.
没法儿	(coll.) can't do anything about it; (coll.) there's no way that ...; it's simply not credible that ...; (coll.) couldn't be (better) (i.e. simply wonderful)
高司令	n. Commander Gao. This Internet slang term is a nickname for Ryan Gosling because it sounds like the Chinese translation of his last name: 高斯林 [gāo sī lín].
摘	to take; to pick (flowers, fruit etc); to pluck; to remove; to take off (glasses, hat etc); to select; to pick out; to borrow money at a time of urgent need
园	land used for growing plants; site used for public recreation; abbr. for a place ending in 園|园, such as a botanical garden 植物園|植物园, kindergarten 幼兒園|幼儿园 etc
票	ticket; ballot; banknote; CL:張|张[zhang1]; person held for ransom; amateur performance of Chinese opera; classifier for groups, batches, business transactions
斯巴達	adj. Sparta. Crazy. [Of a person] going nuts. This Internet slang term comes from the video “This Is Sparta,” a parody of the movie Meet the Spartans (2008).
油管	n. Gas pipeline. This Internet slang term is a nickname for YouTube. 油 [yóu] “oil or gas” sounds like “you” while 管 [guǎn] “pipe” is a translation of “tube.”
不忍直視	<Expression> Cannot bear to look at [someone or something] straight in the eye. This Internet slang term is used when you find it hard to accept a situation.
比	to compare; (followed by a noun and adjective) more {adj.} than {noun}; ratio; to gesture; (Taiwan pr. [bi4] in some compounds derived from Classical Chinese)
司姬	n. Female driver. A female who is skilled in things such as gaming and telling dirty jokes. This Internet slang term is the female version of 老司機 [lǎo sī jī].
女權婊	n. Feminism+bitch. Feminist bitch. This Internet slang term is a derogatory term for feminists. It is often used by people who loathe feminism and  feminists.
浮	to float; superficial; floating; unstable; movable; provisional; temporary; transient; impetuous; hollow; inflated; to exceed; superfluous; excessive; surplus
阿姨粉	n. Auntie fans. This Internet slang term refers to female fans who are much older than their male idol. They tend to look at the idol as a cute little nephew.
綠光	n. Green light. This Internet slang terms comes from Stephanie Sun’s song “Green Light” but is now used to mock people whom were cheated on by their partners.
撒狗糧	v. To pour dog food. (Of a couple) to show affection toward each other online or offline, which may trigger envy, jealousy, and self-pity among single people.
追	to chase; to pursue; to look into; to investigate; to reminisce; to recall; to court (one's beloved); to binge-watch (a TV drama); retroactively; posthumously
枚	classifier for coins, rings, badges, pearls, sporting medals, rockets, satellites etc; tree trunk; whip; wooden peg, used as a gag for marching soldiers (old)
离	to leave; to part from; to be away from; (in giving distances) from; without (sth); independent of; one of the Eight Trigrams 八卦[ba1 gua4], symbolizing fire; ☲
摩擦摩擦	v. Friction friction. This expression comes from the widely ridiculed 2014 song “My Skating Shoes” by Pang Mailang. It is now often a euphemism for having sex.
傻麅子	n. Silly roe deer. A kind of roe deer found in north China. This Internet slang term refers to the roe deer. It is also a nickname for singer and actor Lu Han.
女權癌	n. Feminism+cancer. Feminist cancer. This Internet slang term is a derogatory term for feminists. It is often used by people who loathe feminism and feminists.
沒節操	adj. [Of someone] stooping low and doing unethical things. This Internet slang term is closely related to 節操 [jié cāo] “scruples, moral principles, integrity.”
机关	mechanism; gear; machine-operated; office; agency; organ; organization; establishment; institution; body; stratagem; scheme; intrigue; plot; trick; CL:個|个[ge4]
第X彈	n. No. X shot. Derived from the Japanese culture, this Internet slang term is used to introduce a new piece of work (article, illustration, video) in a series.
联想	to associate (cognitively); to make an associative connection; mental association; word prediction and auto-complete functions of input method editing programs
冒	to emit; to give off; to send out (or up, forth); to brave; to face; (bound form) reckless; to falsely adopt (sb's identity etc); to feign; (literary) to cover
掌握	to grasp (often fig.); to control; to seize (initiative, opportunity, destiny); to master; to know well; to understand sth well and know how to use it; fluency
單身汪	n. Single+woof. Single+woof.  This Internet slang term refers to single people who are eager to enter a relationship but find it difficult to achieve the goal.
装	adornment; to adorn; dress; clothing; costume (of an actor in a play); to play a role; to pretend; to install; to fix; to wrap (sth in a bag); to load; to pack
你國	n. Your country. China. This Internet slang term is often used negatively and satirically, implying one’s unwillingness to side with the government on an issue.
科學上網	<Expression> Surf the web scientifically. This expression is a euphemism for accessing the blocked non-Chinese websites using VPNs. A synonym is 翻墻 [fān qiáng].
圍笑	v. & n. Surround+smile. Smile. This Internet slang term, an alternative of 微笑 [wēi xiào] “smile” because they sound alike, mimics the Taiwanese Mandarin accent.
以为	to think (i.e. to take it to be true that ...) (Usually there is an implication that the notion is mistaken – except when expressing one's own current opinion.)
相愛相殺	<Expression> To love and kill each other. This Internet slang term humorously describes a de facto or assumptive love-hate relationship between two individuals.
老幹部	n. Old cadres. An “old cadre” is a male actor whose gravitas in conduct and speech seems a little outdated but is still very adorable for his crazy female fans.
他	he; him (used for either sex when the sex is unknown or unimportant); (used before sb's name for emphasis); (used as a meaningless mock object); (literary) other
成语	Chinese set expression, typically of 4 characters, often alluding to a story or historical quotation; idiom; proverb; saying; adage; CL:條|条[tiao2],本[ben3],句[ju4]
定	to fix; to set; to make definite; to subscribe to (a newspaper etc); to book (tickets etc); to order (goods etc); to congeal; to coagulate; (literary) definitely
省	(bound form) to scrutinize; (bound form) to reflect (on one's conduct); (bound form) to come to realize; (bound form) to pay a visit (to one's parents or elders)
运行	(of celestial bodies etc) to move along one's course; (fig.) to function; to be in operation; (of a train service etc) to operate; to run; (of a computer) to run
窗口	window; opening providing restricted access (e.g. customer service window); computer operating system window; fig. medium; intermediary; showpiece; testing ground
咆哮教主	n. Roaring hierarch. This Internet slang term is a nickname for Taiwanese actor Steve Ma because of his hysterical acting style at the early stages of his career.
腦斧	n. Brain+ax. Tiger. This Internet slang term mimics the pronunciation of 老虎 [lǎo hǔ] “tiger” with accents that do not differentiate between “h” and “f” in Pinyin.
寄刀片	v. To mail blades [to the screenwriter]. <ACG> This Internet slang term is often used to imply the audience’s dissatisfaction with the development of a storyline.
圆	circle; round; circular; spherical; (of the moon) full; unit of Chinese currency (yuan); tactful; to make consistent and whole (the narrative of a dream or a lie)
怎麼破	Expression. How to+break. How can we solve [a problem]? How should I deal with [a situation]? This expression is used to play cute and provide/ask for a solution.
作用	to act on; to affect; action; function; activity; impact; result; effect; purpose; intent; (suffix) -ation, -tion etc, as in 抑制作用[yi4 zhi4 zuo4 yong4], inhibition
顏藝	n. The art of facial expression, especially the acting style featuring contorted facial expressions. This Internet slang term comes from the Japanese ACG culture.
致辞	to express in words or writing; to make a speech (esp. short introduction, vote of thanks, afterword, funeral homily etc); to address (an audience); same as 致詞|致词
盛世美顏	n. Prosperous era+beautiful face. Incredibly gorgeous good looks. This Internet slang term is often used to describe idols, but sometimes it is used sarcastically.
陳老師	n. Teacher Chen. This Internet slang term is a nickname for Hong Kong actor Edison Chan aka Chen Guanxi and Taiwanese singer-songwriter Cheer Chen aka Chen Qizhen.
认定	to maintain (that sth is true); to determine (a fact); determination (of an amount); of the firm opinion; to believe firmly; to set one's mind on; to identify with
花路	n. Flower+road. Borrowed from Korean pop culture, this Internet slang term is widely used by fans to wish their idols good luck—a smooth and successful career path.
犀利哥	n. Brother Incisive. A homeless man called Cheng Guorong who was dubbed “Brother Incisive” on China’s Internet in 2010 for his piercing gaze and outlandish outfits.
活捉一只	v. To catch a [cute person, animal, or thing] alive. This Internet slang term is often used humorously to describe a happy encounter or discovery online or offline.
秀	(bound form) refined; elegant; graceful; beautiful; (bound form) superior; excellent; (loanword) show; (literary) to grow; to bloom; (of grain crops) to produce ears
黑古	n. Black+Gu. The black Louis Koo. This Internet slang term is the nickname for Hong Kong actor Louis Koo after he deliberately got tanned to avoid putting on makeup.
雲吸貓	n. Cloud+sniff+cat. Related to 吸貓 [xī māo] “raise a pet cat,” this Internet slang term refers to cat lovers’ enjoying the cat pictures posted online by other people.
令	to order; to command; an order; warrant; writ; to cause; to make sth happen; virtuous; honorific title; season; government position (old); type of short song or poem
教科書般	adj. Textbook. Meeting the standards set by authorities or experts in the field. 教科書般的吻戏 [jiào kē shū bān de wěn xì] Textbook kissing scenes. Amazing kissing scenes.
乾貨	n. Dry+goods. Originated from the old-school robber vernacular referring to valuables, this Internet slang term now refers to valuable information or helpful advice.
人設	n. Short for 人物設定 [rén wù shè dìng] character design. This internet meme is typically used in the discussion of characters in Internet novels, TV series, and movies.
內心戲	n. The inner drama. This Internet slang term describes the unsaid thoughts and feelings that one has. The inner drama is often communicated through microexpressions.
语音	speech sounds; pronunciation; colloquial (rather than literary) pronunciation of a Chinese character; phonetic; audio; voice; (Internet) to voice chat; voice message
有没有	(before a noun) Do (you, they etc) have ...?; Is there a ...?; (before a verb) Did (you, they etc) (verb, infinitive)?; Have (you, they etc) (verb, past participle)?
中央空調	n. Central air conditioning and heating system. This Internet slang term refers to a man who behaves like a casanova while claiming to be in a committed relationship.
犬系男	n. Doglike man. A doglike man is athletic, outgoing, fun-loving, and a bit needy. This slang term comes from Japanese and is often used to label a type of boyfriends.
土酷	adj. Provincial+cool. This Internet slang term sounds like “too cool.” It refers to the style that accentuates the humor of mundane and unrefined clothes and objects.
棄坑	v. To abandon a pit. To stop posting new chapters of an Internet novel and leave it unfinished; to stop playing an online game; to give up a hobby because of boredom.
事业	undertaking; project; activity; (charitable, political or revolutionary) cause; publicly funded institution, enterprise or foundation; career; occupation; CL:個|个[ge4]
之间	(after a noun) between; among; amid; (used after certain bisyllabic words to form expressions indicating a short period of time, e.g. 彈指之間|弹指之间[tan2 zhi3 zhi1 jian1])
哦	sentence-final particle that conveys informality, warmth, friendliness or intimacy; may also indicate that one is stating a fact that the other person is not aware of
斜杠青年	n. Slash youth. Young people with multiple careers or identities. [Self-proclaimed] versatile young people. This Internet slang term is often used in self description.
可以說是	<Expression> It can be said that [very adj. ].  You can say it’s [very adj.]This expression became popular in 2017 to express one’s opinion about something or someone.
补刀	(gaming) to finish off a wounded combatant; (fig.) to attack sb who is already under fire; to pile on; (sphragistics) to retouch a seal after taking a first impression
直	straight; to straighten; fair and reasonable; frank; straightforward; (indicates continuing motion or action); vertical; vertical downward stroke in Chinese characters
意思	idea; opinion; meaning; wish; desire; interest; fun; token of appreciation, affection etc; CL:個|个[ge4]; to give as a small token; to do sth as a gesture of goodwill etc
鋼鐵直男	n. Steel+iron+straight+male. Iron straight men. This Internet slang term refers to heterosexual men who constantly fail to grasp their female partners’ emotional needs.
某寶	n. Some+treasure. This Internet slang term is a euphemism for Taobao. It is often used sarcastically or humorously without openly advertising the Alibaba shopping site.
硬	hard; stiff; solid; (fig.) strong; firm; resolutely; uncompromisingly; laboriously; with great difficulty; good (quality); able (person); (of food) filling; substantial
支	to support; to sustain; to erect; to raise; branch; division; to draw money; classifier for rods such as pens and guns, for army divisions and for songs or compositions
带	band; belt; girdle; ribbon; tire; area; zone; region; CL:條|条[tiao2]; to wear; to carry; to take along; to bear (i.e. to have); to lead; to bring; to look after; to raise
刀	knife; blade; single-edged sword; cutlass; CL:把[ba3]; (slang) dollar (loanword); classifier for sets of one hundred sheets (of paper); classifier for knife cuts or stabs
粉絲濾鏡	n. Fan filter. Rose-tinted glasses. This Internet slang term describes the phenomenon of seeing only the good things in one’s idols because you are infatuated with them.
Gay蜜	n. Gay+honey. [A woman’s] best gay friend. This Internet slang term is often used positively to describe a woman’s sophisticated and compassionate homosexual guy friend.
破	broken; damaged; worn out; lousy; rotten; to break, split or cleave; to get rid of; to destroy; to break with; to defeat; to capture (a city etc); to expose the truth of
砸簡歷	Smash+resumes. Expression. Smash [us with your] resumes. This Internet slang term is used by employers on social media to invite job applicants to email resumes to them.
院长	the head of an institution whose name ends in 院[yuan4]; chair of a board; president of a university; department head; dean; premier of the Republic of China; CL:個|个[ge4]
小鮮肉	n. Little+fresh+flesh. Spring chicken. This Internet slang term refers to teens or young adults who are nice-looking (especially with impeccable skin) and look innocent.
懟天懟地	v. Diss+sky+diss+ground. To lash out at one’s opponents or detractors fearlessly. This Internet slang term is often used positively to praise one’s courage and eloquence.
啾咪	This Internet slang term is widely used in “啾咪^. <” by Taiwanese entertainers to act cute. The body language includes winking and the deaf’s gesture meaning “I love you.”
今日份	n. Today’s share [of something]. This Internet slang term is used as a cute alternative of “today’s…” or “…of the day.” It looks like a Japanese term but is actually not.
挺	straight; erect; to stick out (a part of the body); to (physically) straighten up; to support; to withstand; outstanding; (coll.) quite; very; classifier for machine guns
廢柴	n. Trashy+firewood. Loser. Schmuck. This Internet slang term describes a loser or worthless person who has the potential to be rich and realize his or her dreams one day.
挺	straight; erect; to stick out (a part of the body); to (physically) straighten up; to support; to withstand; outstanding; (coll.) quite; very; classifier for machine guns
森女	n. Mori (Forest) girl. In Japanese, a mori girl is a girl who looks like she lives in forests. She is dressed in earthy colors and pursues a simple and natural lifestyle.
機智如我	adv. Witty like me. This Internet slang term is used to precede crediting oneself with accomplishing a task or avoiding a contretemps. This term is often used ironically.
隐藏	to hide; to conceal; to mask; to shelter; to harbor (i.e. keep sth hidden); to hide oneself; to lie low; to nestle; hidden; implicit; private; covert; recessed (lighting)
打	to beat; to strike; to hit; to break; to type; to mix up; to build; to fight; to fetch; to make; to tie up; to issue; to shoot; to calculate; to play (a game); since; from
我們家	n./adj. […Of] our home. This Internet slang term is often used before a star’s name. Fans often use the term to describe their idolset and/or the fan group they belong to.
麻竹	v. Sweet bamboo. Bookmarked. Saved. This Internet slang term is used when you save a social media post for later perusal. 麻竹 [má zhú] sounds like 碼住 [mǎ zhù] “bookmarked.”
流	to flow; to disseminate; to circulate or spread; to move or drift; to degenerate; to banish or send into exile; stream of water or sth resembling one; class, rate or grade
作	to do; to engage in; to write; to compose; to pretend; to feign; to regard as; to consider to be; to be; to act the part of; to feel (itchy, nauseous etc); writings; works
五毛黨	n. The 50 Cent Party. Internet  commentators who are rumored to be hired by Chinese authorities in an attempt to manipulate public opinion to the benefit of the government.
媽賣批	<Expletive>This is a sexist expletive phrase from the Chongqing dialect. It means “Your mom is a prostitute.” The alternatives are mmp [pinyin acronym] and X賣批 [mā mài pī].
站臺	v. Stand+stage. To campaign for [someone/something]. This Internet slang term is often used in sentences like “A person appeared at the event to root for someone/something.”
錘哥	n. Hammer+brother. Brother Hammer. This Internet slang term is an affectionate nickname for Australian actor Chris Hemsworth because of his titular role in the movie “Thor.”
黑化	v. To become black. (Of one’s public image) to deteriorate as negative news surfaces. This Internet slang term also refers to a good guy turning into a bad guy in a TV show.
雷	thunder; (bound form) (military) mine, as in 地雷[di4 lei2] land mine; (coll.) to shock; to stun; to astound; (Tw) (coll.) spoiler; (Tw) (coll.) to reveal plot details to (sb)
这	(pronoun) this; these; (bound form) this; the (followed by a noun); (bound form) this; these (followed by a classifier) (in this sense, commonly pr. [zhei4], esp. in Beijing)
菊外人	n. Ju+outside+person. The outsiders. People who don’t know who Wang Ju (trainee on Produce 101 (China)) is but have been surrounded by messages about voting for Wang Ju. 
洗地	to clean the floor; (Internet slang) (lit.) to wash (the blood) off the floor; (fig.) to cover up evidence of sb's wrongdoing; to defend (a wrongdoer); (coll.) to carpet-bomb
这	(pronoun) this; these; (bound form) this; the (followed by a noun); (bound form) this; these (followed by a classifier) (in this sense, commonly pr. [zhei4], esp. in Beijing)
朝陽群眾	n. People of Chaoyang District [in Beijing]. Residents of this area are famous crime-busters who actively report suspicious activity to the police to ensure community safety.
貓奴	n. Cat+slave. This Internet slang term is a playful nickname for cat owners because they sweat and toil to serve their pet cats. It is often used self-mockingly by cat owners.
包	to cover; to wrap; to hold; to include; to take charge of; to contract (to or for); package; wrapper; container; bag; to hold or embrace; bundle; packet; CL:個|个[ge4],隻|只[zhi1]
霸道	the Way of the Hegemon; abbr. for 霸王之道; despotic rule; rule by might; evil as opposed to the Way of the King 王道; overbearing; tyranny; (of liquor, medicine etc) strong; potent
王之蔑視	n. The King’s contempt. This Internet slang term is often used to describe one’s righteous expression of contempt, usually coupled with a picture or emoji of the same caption.
慈母笑	n. The smile of a warm and caring mother. This Internet slang term is often used to describe a fan’s indulging smile at the idol or a celebrity’s indulging smile at a co-star.
初心	(one's) original intention, aspiration etc; (Buddhism) "beginner's mind" (i.e. having an attitude of openness when studying a subject just as a beginner in that subject would)
標題黨	n. Title+party. Clickbait titles. Sensational article titles whose main purpose is to attract clicks or reads. Such titles may not be very relevant to content of the articles.
活动	to exercise; to move about; to operate; to use connections (personal influence); loose; shaky; active; movable; activity; campaign; maneuver; behavior; CL:項|项[xiang4],個|个[ge4]
乱	in confusion or disorder; in a confused state of mind; disorder; upheaval; riot; illicit sexual relations; to throw into disorder; to mix up; indiscriminate; random; arbitrary
抓馬	adj. Dramatic. This Internet slang term sounds like the English word “drama.” It is often used to describe someone who habitually responds to situations in a melodramatic way.
确定	definite; certain; fixed; to fix (on sth); to determine; to be sure; to ensure; to make certain; to ascertain; to clinch; to recognize; to confirm; OK (on computer dialog box)
座	seat; base; stand; (archaic) suffix used in a respectful form of address, e.g. 师座|师座[shi1 zuo4]; CL:個|个[ge4]; classifier for buildings, mountains and similar immovable objects
手賤	adj. Hand+base. (Of hands) base. You chastise your hand or fingers for being base because you clicked on something that is so gross or scary that you regret being inquisitive.
灌水	to irrigate; to pour water into; to inject water into meat to increase its weight (plumping); to cook the books; to post low-value messages (small talk etc) on Internet forums
新技能	n. New skill. This Internet slang term is often followed by “快get” [kuài get] which means “get [the new skill] quickly”. The skills discussed are often inspired by creativity.
韭菜	garlic chives (Allium tuberosum), aka Chinese chives; (fig.) retail investors who lose their money to more experienced operators (i.e. they are "harvested" like garlic chives)
帮	to help; to assist; to support; for sb (i.e. as a help); hired (as worker); side (of pail, boat etc); outer layer; upper (of a shoe); group; gang; clique; party; secret society
三連	n. A string of three [things]. This Internet slang term is used to describe a string of three things. For example, 素質三連 [sù zhì sān lián] means “a string of three curse words.”
雨神	n. Rain God. This Internet slang term is a nickname for Jam Hsiao or Xiao Jingteng because his presence in new cities during the concert tour tended to coincide with downpours.
毀童年	adj. Destroy+childhood. (Of things) leading to the disillusionment about childhood. This Internet slang term is often used to describe a parody of childhood idols or favorites.
以夢為馬	<Expression> [With one’s] dream as a horse. Originally the title of a poem by Hai Zi, this Internet slang term is now used by hipsters to show their dedication to their dreams.
倒	to invert; to place upside down or frontside back; to pour out; to tip out; to dump; inverted; upside down; reversed; to go backward; contrary to what one might expect; but; yet
金	gold; chemical element Au; generic term for lustrous and ductile metals; money; golden; highly respected; one of the eight categories of ancient musical instruments 八音[ba1 yin1]
放飛自我	<Expression> Allow oneself to take off. This Internet slang term is used humorously to describe someone who behaves with careless abandon. It can be either positive or negative.
三石弟弟	n. Three-stone Brother. This Internet slang term is an affectionate nickname for Chinese actor Wu Lei because the character Lei (磊 [lěi]) consists of three stones (石 [shí]). 
大清已亡	<Expression> The Qing dynasty has already perished. This expression is often used to criticize outmoded ways of thinking and behaving, such as authoritarianism and misogyny. 
狗糧	n. Dog food. This neologism refers to the self-pity of single people (humorously dubbed “single dogs“) triggered by the public displays of affection by couples online or offline.
擦媽	n. Mother Swipe. This Internet slang term is a nickname for American entertainer Christina Aguilera because her initials are CA. The Chinese character 擦 [cā] means “to swipe.” 
丙	third of the ten Heavenly Stems 十天干[shi2 tian1 gan1]; third in order; letter "C" or Roman "III" in list "A, B, C", or "I, II, III" etc; ancient Chinese compass point: 165°; propyl
卓伟视角	n. Zhuo Wei’s perspective. [Seen from] Zhuo Wei’s perspective. Zhuo Wei is a Chinese paparazzo. This Internet slang term is used to describe a photo or video shot from a distance.
后天	the day after tomorrow; life after birth (the period in which one develops through experiences, contrasted with 先天[xian1 tian1]); acquired (not innate or congenital); a posteriori
渣渣輝	n. Trashy+Hui. Trashy Hui. This Internet slang term is a nickname for Hong Kong actor Nick Cheung Ka Fai or Zhang Jiahui because that’s the way he pronounced his name in Mandarin.
靠	to lean against or on; to stand by the side of; to come near to; to depend on; to trust; to fuck (vulgar); traditional military costume drama where the performers wear armor (old)
手	hand; (formal) to hold; person engaged in certain types of work; person skilled in certain types of work; personal(ly); convenient; classifier for skill; CL:雙|双[shuang1],隻|只[zhi1]
人畜无害	adj. Doesn’t not do harm to either human beings or animals. Innocuous. This Internet slang term is used to describe a person who is kind and innocent and maybe occasionally naive.
暗中觀察	v. To observe furtively. This Internet slang term is widely seen in stickers to reveal that one is a lurker and to remind others to behave themselves (such as not being too cocky).
早F晚E	Fighting in the Morning, Emo in the Evening. Waking up dedicated to “fighting” for a better life, by bedtime they’re so exhausted they just want to lie down and listen to sad music.
再	again; once more; re-; second; another; then (after sth, and not until then); no matter how ... (followed by an adjective or verb, and then (usually) 也[ye3] or 都[dou1] for emphasis)
原地爆炸	Expression. Implode right where you are. This expression is used to indicate one’s dissatisfaction with or anger at a person’s statement or action. It is a euphemism for “Get lost.”
尬吹	v. To laud lavishly to the point where even the audience feel embarrassed. This Internet slang term describes some fans’ fulsome praises of their idols in order to convert outsiders.
拨	to push aside with the hand, foot, a stick etc; to dial; to allocate; to set aside (money); to poke (the fire); to pluck (a string instrument); to turn round; classifier: group, batch
反	contrary; in reverse; inside out or upside down; to reverse; to return; to oppose; opposite; against; anti-; to rebel; to use analogy; instead; abbr. for 反切[fan3 qie4] phonetic system
貓系男	n. Catlike man. A catlike man is independent, artistic, gentle, and a bit effeminate. This slang term comes from Japanese. This slang term is often used to label a type of boyfriends.
佛系分手	n. Buddhist+sect+breakup. The Buddhist breakup. This Internet term refers to the painless and peaceful breakup. The couple do not experience nervous breakdowns or hostile retribution.
科科	n. Taiwanese Internet slang term meaning 呵呵 [hē hē], the sound of a smirk or an adorable giggle. Also, the term recently became the nickname of Chinese table tennis player Zhang Jike.
舉高高	v. Hoist+high+high. To hoist [often one’s intimate partner] with both hands above one’s head to show affection. This Internet slang term is often used humorously to express one’s love.
贴	to stick; to paste; to post (e.g. on a blog); to keep close to; to fit snugly; to subsidize; allowance (e.g. money for food or housing); sticker; classifier for sticking plaster: strip
轟趴	n. Bomb+lie on one’s stomach. Home party. This Internet slang term is a translation of the English term “home party” because 轟 [hōng] sounds like “home” and 趴 [pā] sounds like “party.”
进	to go forward; to advance; to go in; to enter; to put in; to submit; to take in; to admit; (math.) base of a number system; classifier for sections in a building or residential compound
提	to carry (hanging down from the hand); to lift; to put forward; to mention; to raise (an issue); upwards character stroke; lifting brush stroke (in painting); scoop for measuring liquid
水果姐	n. Fruit+sister. This Internet slang term is a nickname for Katy Perry because of her colorful wardrobe. She is also famous for the fruity outfit in the Super Bowl halftime performance.
血槽已空	<Video game terminology> The blood groove is already empty. Death. This Internet slang term is often used to describe how people are swept off their feet by the pictures of their idols.
上	(bound form) up; upper; above; previous; first (of multiple parts); to climb; to get onto; to go up; to attend (class or university); (directional complement) up; (noun suffix) on; above
出场	(of a performer) to come onto the stage to perform; (of an athlete) to enter the arena to compete; (fig.) to enter the scene (e.g. a new product); (of an examinee etc) to leave the venue
耐撕	adj. Able to endure tearing. 1) Nice; 2) resilient. This Internet slang term was made popular by Chinese reality TV show Keep Running which is famous for its game of “tearing name tags.”
何老師	n. Teacher He. This Internet slang term is a nickname for He Jiong, a Chinese television host, singer, actor, director and a former Arabic lecturer in Beijing Foreign Studies University.
科	branch of study; administrative section; division; field; branch; stage directions; family (taxonomy); rules; laws; to mete out (punishment); to levy (taxes etc); to fine sb; CL:個|个[ge4]
小李子	Little Lee, an affectionate nickname for Leonardo Dicaprio. It is also a common nickname for an eunuch whose family name is Li in TV series about the imperial palace of the Qing dynasty.
交代	to transfer (duties to sb else); to give instructions; to tell (sb to do sth); to explain; to give an account; to brief; to confess; to account for oneself; (jocular) to come to a bad end
精	essence; extract; vitality; energy; semen; sperm; mythical goblin spirit; highly perfected; elite; the pick of sth; proficient (refined ability); extremely (fine); selected rice (archaic)
按	to press; to push; to leave aside or shelve; to control; to restrain; to keep one's hand on; to check or refer to; according to; in the light of; (of an editor or author) to make a comment
早C晚A	a popular skincare routine involving the application of vitamin C in the morning and vitamin A at night, and which is sometimes also used to mean “coffee in the morning, alcohol at night.”
先森	n. First+forest. Sir, mister. This Internet slang term is a phonetic deviation of 先生 [xiān shēng] with a southern accent. The use of this slang term indicates playfulness and/or affection.
搭	to put up; to build (scaffolding); to hang (clothes on a pole); to connect; to join; to arrange in pairs; to match; to add; to throw in (resources); to take (boat, train); variant of 褡[da1]
馬殺雞	n. Horse+kill+chicken. Massage. This Internet slang term mimics the pronunciation of the English word “massage.” It is also a funny translation of the Japanese word  マッサージ “masaji/masachi.”
好奇寶寶	n. Curious baby. This Internet slang term is often used to describe an adult (often one’s idol) of boundless curiosity. The childlike quality is celebrated and adored.  #520告白钟汉良##科沃斯管家机器人#
可鹽可甜	adj. Can+salt+can+sweet. Able to be cool and imposing as well as gentle and adorable. This Internet slang term is used to describe celebrities who are able to display a wide range of styles.
入手	to begin (with ...) (typically used in a structure such as 從|从[cong2] + {noun} + 入手[ru4 shou3]: "to begin with {noun}; to take {noun} as one's starting point"); to receive; to obtain; to buy
走	to walk; to go; to run; to move (of vehicle); to visit; to leave; to go away; to die (euph.); from; through; away (in compound verbs, such as 撤走[che4 zou3]); to change (shape, form, meaning)
肝	liver; CL:葉|叶[ye4],個|个[ge4]; (slang) to put in long hours, typically late into the night, playing (a video game); (of a video game) involving a lot of repetition in order to progress; grindy
主角光環	n. Main character+halo. The halo of the main character. This Internet slang term refers to the pattern in games, films and TV shows that the main characters are unusually lucky in adversity.
求錘得錘	. Beg+hammer+get+hammer. This expression means “if you ask for a hammer [evidence], you will get a hammer [evidence].” It is often used before revealing the irrefutable evidence for a rumor.
启蒙	to instruct the young; to initiate; to awake sb from ignorance; to free sb from prejudice or superstition; primer; enlightened; the Enlightenment; Western learning from the late Qing dynasty
次	next in sequence; second; the second (day, time etc); secondary; vice-; sub-; infra-; inferior quality; substandard; order; sequence; hypo- (chemistry); classifier for enumerated events: time
岔	fork in road; bifurcation; branch in road, river, mountain range etc; to branch off; to turn off; to diverge; to stray (from the path); to change the subject; to interrupt; to stagger (times)
环节	(zoology) segment (of the body of a worm, centipede etc); (fig.) a part of an integrated whole: aspect (of a project), element (of a policy), sector (of the economy), stage (of a process) etc
暴露年齡	v. To give away one’s age. This Internet slang term is often used when mentioning something that happened a long time ago and pokes fun at the speaker’s age. It is often used in self-mockery.
在家	to be at home; (at a workplace) to be in (as opposed to being away on official business 出差[chu1chai1]); (Buddhism etc) to remain a layman (as opposed to becoming a monk or a nun 出家[chu1jia1])
目測要火	<Expression> Visual estimate+will go viral. By visual estimate, this will go viral. This expression is often used humorously to discuss how likely something will cause a stir on the Internet.
炒雞	adj. Stir-fry+chicken. This Internet slang term means 超級 [chāo jí] “super, extremely.” Since the vegetarians and vegans in China don’t eat chicken anymore, they put the dish name to good use…
碎成渣渣	v. To break into smithereens. This Internet slang term is often used to describe a broken heart or the challenged worldview, but exaggeration, humor, and/or sarcasm are involved in the usage.
后顾之忧	fears of trouble in the rear (idiom); family worries (obstructing freedom of action); worries about the future consequences; often in negative expressions, meaning "no worries about anything"
狼民	n. Wolf+people. Lustful citizens. A nickname for Wallace Chung’s fans 良民 “good citizens”. The nickname was created based on some Wallace fans’ unapologetic vehement admiration for their idol.
滞留	(of a person) to remain in (a place) (due to circumstances that prevent one leaving); to be stranded; (of sth that would typically dissipate, e.g. floodwater, pollutants) to remain; to linger
下	down; downwards; below; lower; later; next (week etc); second (of two parts); to decline; to go down; to arrive at (a decision, conclusion etc); measure word to show the frequency of an action
自幹五	n. Self+do+five. The self-motivated 50 Cent Party. Self-motivated Internet commentators who defend the government. This Internet slang term is related to 五毛黨 [wǔ máo dǎng] “The 50 Cent Party.”
煞筆	n. While the original meaning of the word is “ending of a piece of writing;concluding line of an article,” as an Internet slang term, it means “jackass. ” It is a euphemism for SB/傻逼 [shǎ bī].
下	down; downwards; below; lower; later; next (week etc); second (of two parts); to decline; to go down; to arrive at (a decision, conclusion etc); measure word to show the frequency of an action
有範	adj. Having great panache, radiant with confidence, displaying distinctive and stylish elegance. This Internet slang term praises one’s appearance, fashion sense, mannerisms, and/or character.
雨露均霑	v. To bestow benefits equally. Do not play favorites. This Internet slang term is used to 1) resist unwanted attention, 2) request equal treatment, or 3) brag about the attention one receives.
親媽粉	n. Birth mother fans. This Internet slang term refers to female fans who are significantly older than their male idol or who are concerned about their idol’s well-being as if they were his mom.
狗頭	n. Dog+head. This Internet slang term refers to the emoticons featuring the head of a dog. The emoticon is often used at the end of a sentence to signify that the remark is ironic or sarcastic.
尖	pointed; tapering; sharp; (of a sound) shrill; piercing; (of one's hearing, sight etc) sharp; acute; keen; to make (one's voice) shrill; sharp point; tip; the best of sth; the cream of the crop
丁日	n. Dick+fxxk. This Internet slang term is a derogatory nickname for Justin Biber because the two Chinese characters look like his initials JB which is the Pinyin acronym for 雞巴 [jī bā] “penis.”
鬼	disembodied spirit; ghost; devil; (suffix) person with a certain vice or addiction etc; sly; crafty; resourceful (variant of 詭|诡[gui3]); one of the 28 constellations of ancient Chinese astronomy
霉霉	n. Mold Mold or Bummed Bummed. This Internet slang term is a loving nickname for Taylor Swift. Her Chinese fans feel sorry for her because her hits used to peak at No.2 on the Billboard Hot 100.
字典	Chinese character dictionary (containing entries for single characters, contrasted with a 詞典|词典[ci2 dian3], which has entries for words of one or more characters); (coll.) dictionary; CL:本[ben3]
霸气外露	v. To be brimming with swagger. This Internet slang term is sometimes used sarcastically to refer to someone who blatantly violates social norms or makes a showy display of his or her abilities.
到	to reach; to arrive; to leave for; to go to; to (a place); until (a time); up to (a point); (verb complement indicating arriving at a place or reaching a point); considerate; thoughtful; thorough
賽金花	n. Surpass+gold flower. Surpass the gold flower. This Internet slang term is an affectionate nickname for American comedian, writer, political commentator, actor, and television host Seth Meyers.
赶	to overtake; to catch up with; to hurry; to rush; to try to catch (the bus etc); to drive (cattle etc) forward; to drive (sb) away; to avail oneself of (an opportunity); until; by (a certain time)
禁慾系	n. Abstinent+sect. This Internet slang term describes the nice-looking and refined heterosexual male celebrities whose aloofness and reticence make them look as if they were not interested in sex.
制服	to subdue; to check; to bring under control; (in former times) what one is allowed to wear depending on social status; uniform (army, party, school etc); livery (for company employees); CL:套[tao4]
性	nature; character; property; quality; attribute; sexuality; sex; gender; suffix forming adjective from verb; suffix forming noun from adjective, corresponding to -ness or -ity; essence; CL:個|个[ge4]
号	ordinal number; day of a month; mark; sign; business establishment; size; ship suffix; horn (wind instrument); bugle call; assumed name; to take a pulse; classifier used to indicate number of people
陪跑	v. Accompany+run. To be nominated for an award that one is not to win. This Internet slang term often describes an actor or singer who never wins an award that he or she is constantly nominated for.
囧瑟夫	n. Awkward+[Jo]seph. This Internet slang term is an affectionate nickname for Joseph Leonard Gordon-Levitt, because his facial features look like the Chinese Internet slang term 囧 [jiǒng] “awkward.”
然並卵	Expression. Short for 然而並沒有什麽卵用 [rán ér bìng méi yǒu shén me luǎn yòng] “But it is useless” or “But it doesn’t make any difference.” This expression is used to express one’s frustration or contempt.
粗線	v. Bold+line. To appear, to show up. This Internet slang term and 出現 [chū xiàn] “come up, show up” are homophones. This term is a humorous way of saying “to appear” with a Taiwanese Mandarin accent.
自戳雙目	<Expression> To poke one’s own eyes. To blind oneself (because you can’t bear seeing something) . This expression is often used to comment on artworks that are visually appalling or extremely shoddy.
落	to fall or drop; (of the sun) to set; (of a tide) to go out; to lower; to decline or sink; to lag or fall behind; to fall onto; to rest with; to get or receive; to write down; whereabouts; settlement
勞模姐	n. Model worker+ sister. Sister model worker. This Internet slang term is an affectionate nickname for Jessica Chastain to show the fans’ admiration for her productivity and the quality of her works.
弹	to pluck (a string); to play (a string instrument); to spring or leap; to shoot (e.g. with a catapult); (of cotton) to fluff or tease; to flick; to flip; to accuse; to impeach; elastic (of materials)
则	(literary) (conjunction used to express contrast with a previous clause) but; then; (bound form) standard; norm; (bound form) principle; (literary) to imitate; to follow; classifier for written items
配合	matching; fitting in with; compatible with; to correspond; to fit; to conform to; rapport; to coordinate with; to act in concert with; to cooperate; to become man and wife; to combine parts of machine
轨道	track (for trains etc); orbit (of a satellite); (fig.) a person's established path in life; desired trajectory (of a business or other endeavor); (audio engineering) track; (quantum mechanics) orbital
水逆	(astrology) Mercury retrograde (abbr. for 水星逆行[shui3 xing1 ni4 xing2]); (coll.) to have a period of bad luck; (TCM) water retention in the abdomen causing the vomiting of liquids as soon as one drinks
宰	to slaughter; to butcher; to kill (animals etc); (coll.) to fleece; to rip off; to overcharge; (bound form) to govern; to rule; (bound form) (a title for certain government officials in ancient China)
瑪麗蘇	n. [Fan fiction terminology] Mary Sue, an idealized character. The male equivalent is Gary Stu or Marty Stu. A a poorly developed female character, too perfect and lacking in realism to be interesting.
一	one; single; a (article); as soon as; entire; whole; all; throughout; "one" radical in Chinese characters (Kangxi radical 1); also pr. [yao1] for greater clarity when spelling out numbers digit by digit
處女臉	n. Virgin+face. Virgin face. This Internet slang term refers to the appearance of the typical female lead in Chinese TV dramas which favor innocent young female characters with little dating experience.
總攻本攻	n. Attack all around+oneself. This Internet slang term has the same meaning as 總攻 [zǒng gōng]. It is often used to emphasize the leadership role in a group or a romantic relationship that one possesses.
咆哮体	n. Roaring style. This Internet slang term refers to an Internet writing style which is replete with exclamation marks and expressions like 有木有 [yǒu mù yǒu] “Correct?” to strongly express one’s thought.
補檔	v. Repair+document. To re-upload a shared file to the Internet after a previously created link expired. This Internet slang term is often used in the context of sharing movies or videos on the Internet.
顏控	n. Face+freak. A person who is obsessed with good-looking people and believes that beauty can give one a head start in life. They might have a conscious or unconscious bias against plain-looking people.
前方高能	(slang) Something awesome is about to happen! (originally, in a Japanese space battleship anime, it meant "Danger! High energy up ahead!" — a warning to either prepare for battle or take evasive action)
里	li, ancient measure of length, approx. 500 m; neighborhood; ancient administrative unit of 25 families; (Tw) borough, administrative unit between the township 鎮|镇[zhen4] and neighborhood 鄰|邻[lin2] levels
于	(of time or place) in; at; on; (indicating any indirect relation) to; toward; vis-à-vis; with regard to; for; (indicating a source) from; out of; (used in comparison) than; (used in the passive voice) by
現充	adj./n. Reality+fulfilling. This Internet slang term comes from the Japanese Internet slang term “リア充” and refers to people who live a fulfilling life without ACG (Anime, Comic and Games) or the Internet.
城會玩	City+can+play. This Internet slang term is short for “urban residents know how to have fun”. You use it when you are amused by people’s attempt to entertain themselves. Sometimes it is used sarcastically.
总	general; overall; to sum up; in every case; always; invariably; anyway; after all; eventually; sooner or later; surely; (after a person's name) abbr. for 總經理|总经理[zong3 jing1 li3] or 總編|总编[zong3 bian1] etc
滾床單	v. roll+bed sheets. Originating from a sexist belief in Northeast China that having a little boy roll on a wedding bed will help the couple conceive sons, this Internet slang term now refers to having sex.
重叠	to overlap; to superimpose; to telescope; to run together; to duplicate; one over another; superposition; an overlap; redundancy; reduplication (in Chinese grammar, e.g. 散散步[san4 san4 bu4] to have a stroll)
喪文化	n. The subculture of vegetating. This Internet slang term refers to a collection of beliefs and behaviors that enable the working-class youth in China to express their pessimism about life and their future.
泡	bubble; foam; blister; to soak; to steep; to infuse; to dawdle; to loiter; to pick up (a girl); to get off with (a sexual partner); classifier for occurrences of an action; classifier for number of infusions
帅	(bound form) commander-in-chief; (bound form) to lead; to command; handsome; graceful; dashing; elegant; (coll.) cool!; sweet!; (Chinese chess) general (on the red side, equivalent to a king in Western chess)
念	to read; to study (a subject); to attend (a school); to read aloud; to give (sb) a tongue-lashing (CL:頓|顿[dun4]); to miss (sb); idea; remembrance; twenty (banker's anti-fraud numeral corresponding to 廿[nian4])
理	texture; grain (of wood); inner essence; intrinsic order; reason; logic; truth; science; natural science (esp. physics); to manage; to pay attention to; to run (affairs); to handle; to put in order; to tidy up
反轉	n. Turnover, an abrupt change; a reversal. 劇情反轉 [jù qíng fǎn zhuǎn] n. Plot twist. A plot twist is an unexpected change in the storyline of a novel, film, television series, comic, video game, news story, etc.
画	to draw; to paint; picture; painting (CL:幅[fu2],張|张[zhang1]); to draw (a line) (variant of 劃|划[hua4]); stroke of a Chinese character (variant of 劃|划[hua4]); (calligraphy) horizontal stroke (variant of 劃|划[hua4])
听	to listen to; to hear; to heed; to obey; a can (loanword from English "tin"); classifier for canned beverages; to let be; to allow (Taiwan pr. [ting4]); (literary) to administer; to deal with (Taiwan pr. [ting4])
回憶殺	n. Memory+kill. In the Japanese comic book series Naruto, killing scenes tend to begin with flashbacks of incidents from the past. As an Internet slang term, it refers to the emotional reminiscing about the past.
傳送門	n. Convey+door. Door-shaped teleporter.【Computing】Portal, the link to a website. This Internet slang term often precedes a website link. It is also often used to request the link to more information on a subject.
清流	clean flowing water; (fig.) (literary) honorable person, untainted by association with disreputable influences; scholars who (in former times) kept themselves aloof from the corrupting influence of those in power
上頭	means “(of alcohol) to go to one’s head. ” Intoxicated sisters refer to female fans who are so psyched about the sweet romantic scenes in Internet novels, idol dramas and online photos that they simply go bananas!
戰鬥民族	n. Fighting+ethnic group. The fighting nation. Russia, Russian people. This Internet slang term emphasizes Russians’ gallantry and the mind-boggling humor resulting from their bravery. It is often used humorously.
次元壁	n. Dimension+wall. The boundaries of different fields. This Internet slang term stemmed from 次元 [cì yuán]. It is often used humorously and admirably to describe the unexpected connections between disparate fields.
丁	male adult; the 4th of the 10 Heavenly Stems 天干[tian1 gan1]; fourth (used like "4" or "D"); small cube of meat or vegetable; (literary) to encounter; (archaic) ancient Chinese compass point: 195°; (chemistry) butyl
看	to see; to look at; to read; to watch; to visit; to call on; to consider; to regard as; to look after; to treat (a patient or illness); to depend on; to feel (that); (after a verb) to give it a try; to watch out for
風騷走位	n. Flirtatious+walk. <Gaming> This Internet slang term originally referred to the control of the movement of video game characters to avoid attacks or elimination.  It also refers to people’s comic walking movement.
水軍	v. Literally “waterborne troops,” this Internet slang term refer to the rumored people hired by PR firms for online marketing purposes. They post online to either support a brand or sabotage the brand’s competition.
近代	the not-very-distant past; modern times, excluding recent decades; (in the context of Chinese history) the period from the Opium Wars until the May 4th Movement (mid-19th century to 1919); capitalist times (pre-1949)
謝耳朵	n. Xie+ear. Xie Ear. This Internet slang term combines the Chinese last name Xie and the word ear. It is an affectionate nickname for American actor Jim Parsons and his role Sheldon Lee Cooper in The Big Bang Theory.
任	to assign; to appoint; to take up a post; office; responsibility; to let; to allow; to give free rein to; no matter (how, what etc); classifier for terms served in office, or for spouses, girlfriends etc (as in 前任男友)
求生欲	n. The will to live. This Internet slang term is often used to describe men’s will to please their intimate partners through sweet talk. It is a sexist term that reflects the stereotype of women being easily offended.
肥宅	adj./n. Fat+indoorsy. 1) Fat and inactive. 2) A fat and indoorsy person who prefers watching movies or TV dramas or playing video games instead of going out. This Internet slang term is often used to describe oneself.
票圈	n. Ticket+circle. 1) Friends. 2) [WeChat] Moments, the WeChat news feeds which demonstrate what your friends are up to lately. 票 [piào] mimics the Taiwanese  Mandarin accent and is short for 朋友 [péng yǒu] “friend(s).”
樓主	n. Building owner. This Internet slang term refers to the person who starts a thread in an online forum, because a string of threads looks like a building and the author of the first post of that string is the “owner”.
地区	local; regional; district (not necessarily formal administrative unit); region; area; as suffix to city name, means prefecture or county (area administered by a prefecture-level city or, county-level city); CL:個|个[ge4]
元	currency unit (esp. Chinese yuan); (bound form) first; original; primary; (bound form) basic; fundamental; (bound form) constituent; part; (prefix) meta-; (math.) argument; variable; era (of a reign); (Tw) (geology) eon
老白	n. Old+White. This Internet slang term is a nickname for American actor Bryan Cranston, because 白 [bái] “White” is his last name on Breaking Bad. He gained popularity in China because of his performance on Breaking Bad.
腦子瓦特	<Expression> Brain+Watt. The brain is damaged. 瓦特 [wǎ tè] means “damaged” in the Shanghai dialect. This expression is used to lambaste someone. The meaning is similar to “[someone] is going nuts” or “[someone] is stupid.”
照騙	n. Photo+deception. [Inaccurate] photo. This Internet slang term refers to a photo that does not truthfully reflect a person’s appearance. It is usually over-photoshopped. This term and 照片 [zhào piàn/pian] are homophones.
跪舔	v. Kneel+lick. To suck up to someone; to treat someone with a servile attitude; to blindly admire someone or something. This Internet slang term also humorously describes one’s fervent admiration for someone or something.
身份	identity; aspect of one's identity (i.e. sth that one is – mayor, father, permanent resident etc); role; capacity (as in "in his capacity as a ..." 以…的身份[yi3 xx5 de5 shen1 fen4]); status (social, legal etc); position; rank
熊本熊	n. Kumamon, a mascot created by the government of Kumamoto Prefecture, Japan in 2010 for a campaign to draw tourists to the region. A number of emojis have been circulated on China’s Internet based on the image of Kumamon.
加以	in addition; moreover; (used before a disyllabic verb to indicate that the action of the verb is applied to sth or sb previously mentioned); to apply (restrictions etc) to (sb); to give (support, consideration etc) to (sth)
蠢哭	v. Foolish+cry. (Of behavior) so asinine that it brought me to tears. This Internet slang term is a common quibble about something and someone that does not live up to one’s expectation. Hyperbole is involved in this usage.
癡漢臉	n. Infatuated man’s face. This Internet slang term is used to describe one’s ardent admiration for someone or something. It is very often seen in the humorous depiction of one’s adoration for an idol’s looks and/or talents.
尬黑	v. Embarrassed+vilify. To slander [a celebrity]. This Internet slang term means to suddenly spread rumors about a celebrity who rarely has scandals. The rumors are usually considered so outlandish that they are embarrassing.
真愛粉	n. True love+fan. Fanatic fans whose love for the idol stands the test of time. They often regard the idol as a mentor and major influence, express their devotion creatively, and strive to become a better person as a result.
晒	(of the sun) to shine on; to bask in (the sunshine); to dry (clothes, grain etc) in the sun; (fig.) to expose and share (one's experiences and thoughts) on the Web (loanword from "share"); (coll.) to give the cold shoulder to
行	to walk; to go; to travel; a visit; temporary; makeshift; current; in circulation; to do; to perform; capable; competent; effective; all right; OK!; will do; behavior; conduct; Taiwan pr. [xing4] for the behavior-conduct sense
歪個樓	<Expression> Slant the building. Let me digress. 樓 [lóu] as an Internet slang term refers to a post and its replies in online discussions. When you want to digress, you use this expression as a reminder to other Internet users.
亂入	v. Randon+enter. Derived from the Japanese phrase  “乱入 らんにゅう”, this Internet slang term refers to an unexpected appearance that is often hilarious. It is often used to describe an interruption in a presentation or conversation.
發糖	v. To give out candies. This Internet slang term stems from the ritual of giving out sweets as wedding favors. Now it refers to a couple displaying affection in public or sharing details about their love. It is a positive term.
纵横	lit. warp and weft in weaving; vertically and horizontal; length and breadth; criss-crossed; able to move unhindered; abbr. for 合縱連橫|合纵连横[He2 zong4 Lian2 heng2], School of Diplomacy during the Warring States Period (475-221 BC)
貴圈真亂	<Expression> Your distinguished field is so chaotic. This Internet slang term is often used to describe the entertainment industry which is believed to be fraught with unspoken rules regarding power struggle for fame and fortune.
喜大普奔	(of news etc) so thrilling that everyone is rejoicing and spreading the word (Internet slang); acronym from 喜聞樂見|喜闻乐见[xi3 wen2 le4 jian4], 大快人心[da4 kuai4 ren2 xin1], 普天同慶|普天同庆[pu3 tian1 tong2 qing4] and 奔走相告[ben1 zou3 xiang1 gao4]
用力過猛	v. To use too much strength. A Chinese equivalent of the idiom “cross the line” in English. This Internet slang term describes well-intended yet inappropriate efforts that turn out to be counterproductive or socially unacceptable.
刮鍋底笑	n. Scratch or brush the bottom of a wok+laugh. [Wallace Chung’s] chortle that sounds like the sound of scratching the bottom of a wok. This Internet slang term is used lovingly by the fans to describe Wallace Chung’s famous guffaw.
奶凶奶凶	<Expression> Adorably mad. This expression describe the way a cute little child or a young person whose appearance or personality resembles a cute little child’s gets mad. You think it is cute not scary when such a person gets mad.
先馬後看	<Expression> First+bookmark+later+read. Since 馬 [mǎ]=馬克 [mǎ kè]=Mark=Bookmark, this phrase means “Bookmark it for later perusal.” It is used when you re-share something you like and want to read more closely when you have a moment.
小奶狗	n. Little puppy. Toy boy. This Internet slang term refers to a young male that is the love interest of the opposite sex. It is often used to describe a cute young male idol. Some men protest that the term is sexist and degrades men.
黑花	n. Black+flower. Hey Wow. This Internet slang term is the name of Wallace Chung’s stuffed panda doll aka his “daughter.” Wallace Chung later developed spin-offs like caps, shoes, dolls, backpacks, etc. based on the image of Hey Wow.
視姦	v. Visually+rape. This Internet slang term originated in Japan to describe sexual objectification of women in photography, but now in China it means: 1) to stare at women in a lewd way; 2) to annoy others online through oversharing.
小公舉	n. A phonetic variation of 小公主 [xiǎo gōng zhǔ] “the little princess”. This Internet slang term refers to a man who does not follow the traditional gender role as a macho guy. He is not afraid to display the “feminine” body language.
等	to wait for; to await; by the time; when; till; and so on; etc.; et al.; (bound form) class; rank; grade; (bound form) equal to; same as; (used to end an enumeration); (literary) (plural suffix attached to a personal pronoun or noun)
盘	plate; dish; tray; board; hard drive (computing); to build; to coil; to check; to examine; to transfer (property); to make over; classifier for food: dish, helping; to coil; classifier for coils of wire; classifier for games of chess
胜	victory; success; to beat; to defeat; to surpass; victorious; superior to; to get the better of; better than; surpassing; superb (of vista); beautiful (scenery); wonderful (view); (Taiwan pr. [sheng1]) able to bear; equal to (a task)
國民老公	n. The national husband of China. This Internet slang term usually refers to Wang Sicong. The 27-year-old man is the son of Wang Jianlin, a Chinese businessman and philanthropist who is currently the richest person in China and Asia.
杏紅	n. Apricot pink, yellowish pink. This Internet slang term is an affectionate nickname for Ashin or Chen Hsin-hung or Chen Xinhong, the vocalist of the Taiwanese band Mayday. The nickname and his Chinese first name are semi-homophones.
送命題	n. Send+life+problem. Dangerous question that could get you killed if you didn’t answer it correctly. This Internet slang term refers to a tricky question raised by someone who expects you to answer it exactly the way he or she wants.
革命	to withdraw the mandate of heaven (and transition to a new dynasty) (original meaning); revolution; revolutionary; to revolt (against sb or sth); to revolutionize (sth); (separable verb sometimes used in the pattern 革noun的命); CL:次[ci4]
鏟屎官	n. Scoop+poo+official. The poo-scooping official. This Internet slang term is a playful nickname for cat owners because that’s what they do for their pet cats every day.  It is often used self-mockingly and rather proudly by cat owners.
葛優癱	n. Ge You slouch. This Internet slang term referring to the sitting posture of actor Ge You’s role in the classic sitcom I Love My Family (1993-1994). It became popular in summer 2016 to describe how people relax in the sweltering heat.
第	(prefix indicating ordinal number, as in 第六[di4 liu4] "sixth"); (literary) grades in which successful candidates in the imperial examinations were placed; (old) residence of a high official; (literary) but; however; (literary) only; just
養成系	n. Cultivate/develop+series. The developing type. This Internet slang term describes a type of idols that sharpen their skills with the support of their fans along the way. They tend to start out as young trainees and grow with the fans.
公	public; collectively owned; common; international (e.g. high seas, metric system, calendar); make public; fair; just; Duke, highest of five orders of nobility 五等爵位[wu3 deng3 jue2 wei4]; honorable (gentlemen); father-in-law; male (animal)
霸氣側漏	<Expression> Swag+side leakage [as of sanitary towels]. This expression humorously describes a person’s excessive domineering presence or pompous display of expertise or fortune that makes people around him or her slightly uncomfortable.
闪	to dodge; to duck out of the way; to beat it; shaken (by a fall); to sprain; to pull a muscle; lightning; spark; a flash; to flash (across one's mind); to leave behind; (Internet slang) (of a display of affection) "dazzlingly" saccharine
結石姐	n. Sister Calculus. Here, “calculus” means a concretion of minerals formed within the body, especially in the kidney or gallbladder. This Internet slang term is a nickname for Jessie J because 結石 [jié shí] “calculus” sounds like “Jessie.”
藍瘦香菇	n. Blue+slim+shiitake mushroom. This Internet slang term is how a 24-year-old man from Nanning, Guangxi said 難受想哭 [nán shòu xiǎng kū] “Sad, want to cry” in the Nanning dialect. His teary monologue made him an Internet sensation overnight.
開掛	v. Originally referring to playing dirty in video games through a cheat code or a cheat cartridge, this Internet slang term is an alternative way of saying “[someone] is on fire/doing an incredibly great job as if she or he were cheating”
土偶	n. Indigenous & Unrefined+idol. Indigenous & Unrefined Idol. This Internet slang term is a nickname for Idol Producer, a Chinese reality boy group survival show produced by iQiyi.  The show was criticized for copying Produce 101 illegally.
蛋妞兒	n. Egg+lass. This Internet slang term is a nickname for the hunky Daniel Wu Yin-cho or Wu Yanzu. The slang term sounds like a nickname for a country girl in North China but it is adapted from the pronunciation of his English name “Daniel.”
雅蠛蝶	n. Literally “small elegant butterfly,” this Internet meme became popular around 2009. It sounds like the Japanese word yamete (止めて) “stop,” which is a stereotypical female line in Japanese porn movies. The butterfly species doesn’t exist.
油菜花	n. Canola flower/rape flower. This term is popular among Wallace Chung’s mainland fans and refers to talented fans who are creative, artistic, and/or tech-savvy. The namesake was created because it sounds like 有才華 [yǒu cái huá] “talented.”
武术	military skill or technique (in former times); all kinds of martial art sports (some claiming spiritual development); self-defense; tradition of choreographed fights from opera and film (recent usage); also called kungfu 功夫; CL:種|种[zhong3]
登	to scale (a height); to ascend; to mount; to publish or record; to enter (e.g. in a register); to press down with the foot; to step or tread on; to put on (shoes or trousers) (dialect); to be gathered and taken to the threshing ground (old)
陳大發	n. Chen+make a big fortune. Chen Dafa. This Internet slang term is a nickname for Taiwanese actress Ivy Chen or Chen Yihan. She gave the nickname to herself. It is a nickname given to her by her, because she thought it was a funny nickname.
高考	college entrance exam (especially as abbr. for 普通高等學校招生全國統一考試|普通高等学校招生全国统一考试[Pu3 tong1 Gao1 deng3 Xue2 xiao4 Zhao1 sheng1 Quan2 guo2 Tong3 yi1 Kao3 shi4]); (Tw) entrance exam for senior government service posts (abbr. for 公務人員高等考試|公务人员高等考试)
品	(bound form) article; commodity; product; goods; (bound form) grade; rank; kind; type; variety; character; disposition; nature; temperament; to taste sth; to sample; to criticize; to comment; to judge; to size up; fret (on a guitar or lute)
敲黑板	V. To strike the blackboard with one’s knuckles or hand (to ask the students to pay attention). This Internet slang term is reminiscent of the teaching style of many Chinese teachers. This Internet slang term is used to emphasize something.
涼涼	adj./v. Cool, chilled. Originally the title of the theme song of the 2017 Chinese TV drama Eternal Love, this Internet slang term is now widely used humorously to describe someone or something that went downhill or became a complete failure.
剁手族	n. Hand-chopping gang. White-collar consumers whose obsessive online shopping sprees result in long bills. In hindsight, they are so guilty that they want to chop off their own hands to prevent themselves from placing orders on the Internet.
抖M	adj./n. Shake+M. Seriously masochistic. A seriously masochistic person. Derived from the Japanese wordドM in the ACG subculture, this Internet slang term refers to the tendency to derive sexual gratification from one’s own pain or humiliation.
心大	adj. Heart+big. This Internet slang term describes people who are so careless that they may put themselves or others in danger. It also describes people who are less susceptible to criticism or personal attacks because they don’t give a damn.
不會聊天	v. To not know how to chat. A person who doesn’t know how to chat tends to offend others intentionally or unintentionally. This Internet slang term is often used humorously as a mild criticism of the lack of consideration of others’ feelings.
霸道總裁	n. Imperious+executive. This Internet slang term refers to a chauvinist male character in romance novels and TV shows—he is a rich, powerful, and fatally attractive control freak who has a soft spot for a rather unlikely female love interest.
管	to take care (of); to control; to manage; to be in charge of; to look after; to run; to care about; tube; pipe; woodwind; classifier for tube-shaped objects; particle similar to 把[ba3] in 管...叫 constructions; writing brush; (coll.) to; towards
归	to return; to go back to; to give back to; (of a responsibility) to be taken care of by; to belong to; to gather together; (used between two identical verbs) despite; to marry (of a woman) (old); division on the abacus with a one-digit divisor
既視感	n. Originally きしかん in Japanese meaning “déjà vu”, the illusion of having previously experienced something actually being encountered for the first time. As an Internet slang term, it simply means “[someone or something] looks like/feels like…”
白	white; snowy; pure; bright; empty; blank; plain; clear; to make clear; in vain; gratuitous; free of charge; reactionary; anti-communist; funeral; to stare coldly; to write wrong character; to state; to explain; vernacular; spoken lines in opera
生無可戀	<Expression> There is nothing in life to long for. This Internet meme is a humorous alternative to words like “distraught,” “bummed out,” and “speechless.” A typical facial expression is actually an impassive one due to utmost frustration. 
習大大	n. Uncle Xi. This Internet slang term was created by 張洪銘 Zhang Hongming as a nickname for Xi Jinping, the President of China. Zhang explained that 大大 [dà dà] is a way of addressing a paternal uncle younger than one’s father in Shaanxi dialects.
零	zero; nought; zero sign; fractional; fragmentary; odd (of numbers); (placed between two numbers to indicate a smaller quantity followed by a larger one); fraction; (in mathematics) remainder (after division); extra; to wither and fall; to wither
炒CP	v. Hype+CP [Couple]. [Of the media] to hype two entertainers of either opposite sexes or the same sex as a couple, often for business purposes. Many TV dramas, films, and reality TV shows like pairing up entertainers to attract public attention.
招黑體質	n. Beckon+black+body type. The criticism-inducing body type. This Internet slang term is often used to describe celebrities who are easy targets for criticism or vilification by Internet users. It is often used by celebrities for self abasement.
日了狗	<Expression> Boinked the dog. 我真是日了狗了 [wǒ zhēn shì rì le gǒu le] “I had boinked the dog” is a vulgar way of whining “What have I done to deserve this?” It goes well with a facepalm.The term was originally an ID on Douyu TV (live streaming site).
拉仇恨	v. Pull+hatred. [Gaming terminology] To attract the monsters to attack oneself. As an Internet slang term, it means to deliberately boast or to say potentially offensive things. It typically refers to boasting in ways that could induce jealousy.
公開處刑	<Expression> Public penalization. This expression is used to shame a person who is not as good looking as the friend he or she shows up with. Appearing with someone better looking than you are is like being openly punished. Not a nice expression.
蹭熱度	v. Cadge+heat. To freeload the popularity of a more famous celebrity for personal gain, especially public attention. This Internet slang term is often used by the fans to attack someone whom they often consider to be less popular than their idol.
挽尊	v. To save the dignity [for the original poster]. This Internet slang term is used when you leave the first comment on a post that hasn’t been replied for a long time. The purpose of leaving the comment is to cheer up the neglected original poster.
顏即正義	<Expression> Appearance is justice. This expression is used to humorously defend one’s preference for nice-looking people, to the dismay of plain-looking people and those who are against body shaming. The expression is sometimes used sarcastically.
暴擊	n. <Gaming> critical hit. Attack that will create greater harm than the displayed data. This Internet slang term is often used to describe a jeering remark that is potentially hurtful or an unexpected situation that someone doesn’t want to encounter.
起来	(after a verb) indicating the beginning and continuation of an action or a state; indicating an upward movement (e.g. after 站[zhan4]); indicating completion; (after a perception verb, e.g. 看[kan4]) expressing preliminary judgment; also pr. [qi3 lai5]
方	square; power or involution (math.); upright; honest; fair and square; direction; side; party (to a contract, dispute etc); place; method; prescription (medicine); just when; only or just; classifier for square things; abbr. for square or cubic meter
黑人問號	n. Black person+question marks. This Internet slang term derives from pictures of Nicholas Aaron “Nick” Young, an NBA player for the Los Angeles Lakers, with question marks added. This meme is used when you are perplexed, shocked, or speechless. 
攤手	v./n. To have one’s open palms face upwards. Smugshrug. This Internet slang term originally described the emoticon ¯\_(ツ)_/¯ and is now often used directly to show that you don’t give a damn about something or have to accept an unfavorable situation.
種草	v. Grow+grass. This Internet slang term compares recommending products to others to growing grass, because one plants the seeds of desire for the product in the listener’s mind. The speaker is usually a fashion blogger or a loyal consumer of a brand.
聊聊人生	v. To chat about life, a humorous euphemism for “I disagree,” “Are you kidding me,” and “Are you out of your mind. ” This Internet slang term is used when you find people’s words or actions silly or perplexing and you want to tease them a little bit.
壁咚	v. Wall+slapping sound. Originally “kabe-don” [かべドン] in the Japanese anime, this Internet slang term refers to a man forcing a woman against a wall with one hand OR leaning against a wall, making a slapping sound, and leaving the woman nowhere to go.
已婚少女	n. Married teenage girl. A married woman who still looks, thinks, and/or behaves like a teenage girl. This Internet slang term is often used by married women to describe themselves, because they want to maintain their youthful appearance or mentality.
領盒飯	v. To receive [one’s] boxed lunch. This Internet slang term describes a character exiting from a drama or movie because of death or other reasons. The term comes from the custom that actors get paid and receive boxed lunches on their last filming day.
A站	A site aka Acfun. B站 [B zhàn] B site aka bilibili. Both are interactive video sharing websites themed around anime, manga, game, movie, music, and TV fandom based in China. They also both feature “barrage,” a real-time on-screen user commentary system.
外貌協會	n. Appearance+association. The good looks club. This Internet slang term was first used to describe women who pick dates or spouses based on their looks—handsomeness outweighs everything else. Now it also refers to a preference for aesthetic qualities.
居老師	n. Teacher Ju. This Internet slang term is a nickname for Chinese actor Zhu Yilong who is most well-known for his role in the popular web series Guardian. 居 [jū] is the pronunciation of his surname 朱 [zhū] Zhu in the Wuhan dialect, his hometown dialect.
開黑	v. Open+black. <Gaming Terminology> To have audio chats or even face-to-face communication with the other players to have an edge on the opponents in a computer game. The behavior may enhance cooperation and increase the possibility of cheating as well.
腦洞	n. Brain+hole. As an Internet slang term, this is a vivid metaphor for imagination or creativity. 腦洞太大 “Having a super big hole in the brain” renders a person amusingly or ridiculously imaginative and creative. Sometimes this term is used sarcastically.
綠茶婊	n. Green tea+bitch. An ostensibly graceful and innocent young woman who is actually very calculating. This Internet slang term was created in 2013 to describe models and actresses who lead a dissipated life around the rich and powerful for personal gain.
加	to add; plus; (used after an adverb such as 不, 大, 稍 etc, and before a disyllabic verb, to indicate that the action of the verb is applied to sth or sb previously mentioned); to apply (restrictions etc) to (sb); to give (support, consideration etc) to (sth)
自來水	n. Tap water. This Internet slang term refers to the Internet users who voluntarily post laudatory remarks online to promote a brand. This term was originally used to describe the viewers of Monkey King: Hero’s Back who recommend the movie on the Internet.
深柜男	n. Deep in the closet+male. Homosexual males who haven’t come out. They claim to be heterosexual and sometimes display anti-homosexual attitudes. Some of them date and/marry the opposite sex under social pressure and keep their sexual orientation a secret.
網癮少女	Internet addiction+teenage girl. Teenage girl with an addiction to the Internet. This Internet slang term is often used to describe young women who spend way too much time on the Internet, usually because they like watching TV shows or playing mobile games.
洗腦神曲	n. Brainwashing+epic+song. A pop song whose melody and lyrics are catchy and memorable. When it is stuck in your head, it can stay there for days. Sometimes this Internet slang term is slightly negative because the music is often not considered very classy.
在線	adj. On+line. Up to scratch. This Internet slang term is a compliment for someone or something that reaches a satisfactory level. For example, you can say an actor’s acting skills are online, meaning his or her acting skills meet the audience’s expectations.
直女癌	n. Straight woman cancer. The female form of “straight man cancer,” this Internet slang term describes women who submit to sexism and actively attack women’s liberation. They deride career women, single women, childless women and mothers who don’t have sons.
做	to make; to produce; to write; to compose; to do; to engage in; to hold (a party etc); (of a person) to be (an intermediary, a good student etc); to become (husband and wife, friends etc); (of a thing) to serve as; to be used for; to assume (an air or manner)
毛	hair; feather; down; wool; mildew; mold; coarse or semifinished; young; raw; careless; unthinking; nervous; scared; (of currency) to devalue or depreciate; classifier for Chinese fractional monetary unit ( = 角[jiao3] , = one-tenth of a yuan or 10 fen 分[fen1])
人生贏家	n. A winner in life. A person who achieves or even exceeds the mainstream definition of success. In China, such a person is typically heterosexual, nice-looking, highly educated, incredibly rich and/or powerful, married, and has one or more adorable children.
本	(bound form) root; stem; (bound form) origin; source; (bound form) one's own; this; (bound form) this; the current (year etc); (bound form) original; (bound form) inherent; originally; initially; capital; principal; classifier for books, periodicals, files etc
约定	to agree on sth (after discussion); to conclude a bargain; to arrange; to promise; to stipulate; to make an appointment; stipulated (time, amount, quality etc); an arrangement; a deal; appointment; undertaking; commitment; understanding; engagement; stipulation
備胎	n. Spare tire. Back burner. This Internet slang term refers to  a person to whom one is not presently committed, and with whom one maintains some degree of communication, in order to keep or establish the possibility of future romantic and/or sexual involvement.
翻墻	v. To climb over a wall. This Internet slang term means to climb over the Great Firewall of China, a censorship and surveillance project that blocks potentially unfavorable incoming data from foreign countries. The purpose is to access blocked overseas websites.
墻裂	adj. Wall+crack. This Internet slang term and 强烈 [qiáng liè] “strongly” are homophones. This meme is often used to recommend something; the image of a cracked wall is way more vivid than the original word. Imagine someone smacking a wall and speaking effusively.
負能量	n. Negative energy. People or things that are of or cause toxic emotions like excessive and/or unnecessary guilt, shame, anger, self-loathing, depression, regret, bitterness, jealousy, and resentment. Negative energy saps people of their motivation and strength.
切	definitely; absolutely (not); (scoffing or dismissive interjection) Yeah, right.; Tut!; to grind; (bound form) close to; (bound form) eager; to correspond to; (used to indicate that the fanqie 反切[fan3 qie4] system should be applied to the previous two characters)
引	to draw (e.g. a bow); to pull; to stretch sth; to extend; to lengthen; to involve or implicate in; to attract; to lead; to guide; to leave; to provide evidence or justification for; old unit of distance equal to 10 丈[zhang4], one-thirtieth of a km or 33.33 meters
宇宙觀	n. Universe+view. Adapted from the word “worldview,” this Internet slang term is often used as a precept reminding people not to take themselves too seriously: Look at yourself from the perspective of the universe, and you’ll realize how trivial your problems are.
鬼畜	n./adj. Ghost+beast. To inflict suffering. Originally an ACG term, this neologism often refers to a video editing technique that pieces together dialogue and background music for humorous value. Some sounds are looped at a high speed, which might cause discomfort.
档	(bound form) shelves (for files); pigeonholes; (bound form) files; crosspiece (of a table etc); (bound form) (of goods) grade; vendor's open-air stall; (Tw) timeslot for a show or program; classifier for shows; classifier for events, affairs etc; Taiwan pr. [dang3]
番	(bound form) foreign (non-Chinese); barbarian; classifier for processes or actions that take time and effort; (classifier) a kind; a sort; (classifier) (used after the verb 翻[fan1] to indicate how many times a quantity doubles, as in 翻一番[fan1 yi1 fan1] "to double")
套	to cover; to encase; cover; sheath; to overlap; to interleave; to model after; to copy; formula; harness; loop of rope; (fig.) to fish for; to obtain slyly; classifier for sets, collections; bend (of a river or mountain range, in place names); tau (Greek letter Ττ)
作出	to put out; to come up with; to make (a choice, decision, proposal, response, comment etc); to issue (a permit, statement, explanation, apology, reassurance to the public etc); to draw (conclusion); to deliver (speech, judgment); to devise (explanation); to extract
为I做E	Being the Introverts’ Extrovert. e.g.  introverts talk about the times they’ve been forced into social activity by the lack of a natural extrovert in their friend group.  is also having a homosexual connotation as the slang parodizes the homophonous gay term "為愛做一.”
什麼鬼	What the devil [is that/are you talking about]? This Internet slang term is often coupled with this emoticon [笑cry] which means 笑cry [xiào cry] “laugh to the point of crying”. You don’t use this term when you are mad or upset or confused; use it when you are amused.
老总	boss; sir (person with a leading role in an organization); (after a surname) high ranking commander in the PLA; (Qing dynasty) high ranking government official; (old) courteous term used by the general populace in addressing a rank-and-file soldier or police officer
磚家	n. Brick+expert. Charlatans. This Internet slang term and 專家 [zhuān jiā] are homophones. It is a cynical nickname for bogus experts who mislead the public with irresponsible or unreliable comments. Their credibility is jeopardized by their own ignorance or depravity.
下来	to come down; (completed action marker); (after verb of motion, indicates motion down and towards us, also fig.); (indicates continuation from the past towards us); to be harvested (of crops); to be over (of a period of time); to go among the masses (said of leaders)
趕腳	n./v. Rush+feet. Feelings. While the original meaning of this word is “to hire oneself to transport goods with one’s own donkey, mule, etc.” As an Internet slang term, it means 感覺 [gǎn jué] “feeling” or “to feel.” It mimics the Northeastern accent for humorous effect.
卵巢彩票	<Expression> The ovarian lottery. This expression is quoted from Warren Buffet who attributed his success to winning the “ovarian lottery.” In China, this Internet slang term is used to lament one’s misfortune of not being born with a silver spoon in his or her mouth.
抱緊我	Hold me tight. This phrase is used after voicing an opinion to invite others to side with you. It is also used to ask others to tell you if they had the same experience as you did. It originated in a weibo uproar in February, 2015 concerning a dress of disputed colors.
陳獨秀	n. Chen Duxiu. As an Internet slang term, it does not refer to Chen Duxiu, a Chinese revolutionary socialist, educator, philosopher, and author, who co-founded the Chinese Communist Party (with Li Dazhao) in 1921, serving from 1921 to 1927 as its first General Secretary.
画风突变	A sudden change in the painting style. This Internet slang term is often used to accentuate the contrast between one’s responses in different situations. It also refers to an unexpected twist in the story. Humor is often involved in the context where this term is applied.
鱸魚	n. Bass, any of various North American freshwater fish with lean flesh (especially of the genus Micropterus). This Internet slang term is a derogatory nickname for Chinese talk show host Chen Luyu because of similar pronunciation. Sexism is evident in the use of this term.
鳳凰男	n. Phoenix man. This Internet slang term refers to self-made men of humble roots. This group has been widely discussed because of their marital conflicts typically with “peacock women” and their emotional enmeshment with their families of origin. The implication is negative.
顶	apex; crown of the head; top; roof; most; to carry on the head; to push to the top; to go against; to replace; to substitute; to be subjected to (an aerial bombing, hailstorm etc); (slang) to "bump" a forum thread to raise its profile; classifier for headwear, hats, veils etc
本命	n. Honmei. True feeling. This Internet slang term comes from the Japanese phrase “hon mei choco” (本命チョコ — true feeling chocolate — the chocolate given by women on Valentine’s Day to men whom the giver has romantic feelings for). In China, it often refers to your favorite star.
掉	to fall; to drop; to lag behind; to lose; to go missing; to reduce; fall (in prices); to lose (value, weight etc); to wag; to swing; to turn; to change; to exchange; to swap; to show off; to shed (hair); (used after certain verbs to express completion, fulfillment, removal etc)
对	right; correct; towards; at; for; concerning; regarding; to treat (sb a certain way); to face; (bound form) opposite; facing; matching; to match together; to adjust; to fit; to suit; to answer; to reply; to add; to pour in (a fluid); to check; to compare; classifier: couple; pair
抖S	adj./n. Shake+S. Seriously sadistic. A seriously sadistic person. Derived from the Japanese wordドS in the ACG subculture, this Internet slang term refers to the tendency to derive pleasure, especially sexual gratification, from inflicting pain, suffering, or humiliation on others.
我想靜靜	<Expression> I want some quiet time. This Internet slang term is used to when you are shocked. The expression is sometimes followed by 別問我靜靜是誰 [bié wèn wǒ jìng jìng shì shuí] Don’t ask me who Jingjing is, because an alternative interpretation of the expression is “I miss Jingjing.”
傲嬌	adj. Originated from the Japanese ACG [Anime, Comic and Games] sub-culture, “tsundere” [ツンデレ] describes a person who is initially cold and even hostile towards another person before gradually showing their warm and even coy side over time. Now the term is also used to mean “sassy”.
保持围笑	<Expression> Maintain the smile [to mask one’s true feelings]. This expression is often used ironically to reveal that one repressed his or her true feelings under the pressure to maintain good relationships with others. 围笑 [wéi xiào] is a phonetic deviation of 微笑 [wēi xiào] “smile.”
翻牌	n. To flip the name plates. In ancient China, the emperor chose who to serve him at night by flipping the name plates of consorts. It is now a metaphor for being responded by someone you admire (such as your favorite star) on Weibo or being chosen to meet or interact with him or her.
家	home; family; (polite) my (sister, uncle etc); classifier for families or businesses; refers to the philosophical schools of pre-Han China; noun suffix for a specialist in some activity, such as a musician or revolutionary, corresponding to English -ist, -er, -ary or -ian; CL:個|个[ge4]
佛系追星	n. Buddhist+sect+chase+stars. The Buddhist fandom. This Internet slang term refers to supporting a celebrity in a calm and peaceful way. A Buddhist fan does not engage in online battles against the fans of other celebrities. He or she is not too emotionally invested in the idol either.
串	to string together; to skewer; to connect wrongly; to gang up; to rove; string; bunch; skewer; classifier for things that are strung together, or in a bunch, or in a row: string of, bunch of, series of; to make a swift or abrupt linear movement (like a bead on an abacus); to move across
鍵盤俠	n. Keyboard+knight-errant. People who like going on a rant on the Internet. They are cynical and judgmental without the ability to make a difference through action. 噴 [pēn] v. To spurt, spout, gush. This Internet slang term means “to go on a rant,” often used to describe Internet trolls.
小確喪	n. Little+definite+frustration. A sarcastic antonym of 小确幸 [xiǎo què xìng] “Little definite happiness,” this Internet slang term was originally the title of an Internet pop song. Now it is used to describe the working-class youth’s certainty about daily nuisances and the drudgery of work.
摸頭殺	n. Gently caress and stroke the head+kill. Originating from the Japanese manga trope of a guy caressing a gloomy girl’s head to comfort her, this Internet slang term is now regarded as a favorable flirting or titillating technique (effective only when used by one’s love interest or idol).
李澤言	n. Li Zeyan, one of the main male characters in Love and Producer, a mobile game about dating and relationships. He is the CEO of Huarui in the financial services industry. His supernatural power is time manipulation. This character became popular on China’s social media in December, 2017.
了解一下	<Expression> Get to know it. This expression is used to invite or request someone to learn more about something. A level of sarcasm is present. The humor involved is that this phrase is originally used widely among sales people in sentences like “Do you want to learn more about [a product]?”
道友	n. Fellow Taoist priests. This Internet slang term is used humorously to describe people who share your hobbies or values. It is also a euphemism for drug users, because of the stereotype that they are so pale and gaunt that they look like Taoist priests who are believed to become immortals.
者	(after a verb or adjective) one who (is) ...; (after a noun) person involved in ...; -er; -ist; (used after a number or 後|后[hou4] or 前[qian2] to refer to sth mentioned previously); (used after a term, to mark a pause before defining the term); (old) (used at the end of a command); (old) this
老	prefix used before the surname of a person or a numeral indicating the order of birth of the children in a family or to indicate affection or familiarity; old (of people); venerable (person); experienced; of long standing; always; all the time; of the past; very; outdated; (of meat etc) tough
安	(bound form) calm; peaceful; to calm; to set at ease; safe; secure; in good health; content; satisfied (as in 安於|安于[an1 yu2]); to place (sb) in a suitable position (job); to install; to fix; to fit; to bring (a charge against sb); to harbor (certain intentions); ampere (abbr. for 安培[an1 pei2])
抗日神劇	n. Epic dramas of the War of Resistance against Japan. This Internet slang term mocks TV dramas that blend history with fantasy to over-glorify the Chinese army in the War of Resistance against Japan. Such dramas are widely criticized by both the media and Internet users for distorting history.
偏偏	(indicating that sth turns out just the opposite of what one would wish) unfortunately; as it happened; (indicating that sth is the opposite of what would be normal or reasonable) stubbornly; contrarily; against reason; (indicating that sb or a group is singled out) precisely; only; of all people
表情管理	n. Facial expression management. This Internet slang term refers to celebrities’ management of their facial expressions in public, especially in regards to maintaining an upbeat, pleasant personal image despite how they feel inside. This term describes the emotional labor that celebrities undertake.
課代表	n. Class representative. This Internet slang term refers to people who are good at explaining a hot topic for other Internet users. Internet users often call for a “class representative” humorously when they want to understand a complicated issue so that they don’t have to read about it on their own.
擔當	n. [Role] assumption. This Internet slang term is used after a noun to describe a task or challenge that one takes on. For example, in “Bounty Hunters”, Wallace Chung assumed the role of a jester (喜劇擔當 [xǐ jù dān dāng]), strategist (謀略擔當 [móu luè dān dāng]), and food junkie (吃貨擔當 [chī huò dān dāng]).
叫獸	n. Roaring+beast. Depraved professors. This Internet slang term and 教授 [jiào shòu] “professors” are homophones. It is a cynical nickname for scholars who mislead the public with irresponsible comments or sexually harass the students. Their credibility is jeopardized by their own ignorance or depravity.
輕拍	v. To hit gently. Often included in sentences like “Please hit lightly,” this Internet slang term is often used as a request for mild, constructive criticism from other Internet users when one expresses an opinion that’s potentially controversial. The equivalent in English would be “Don’t be too harsh.”
吸貓	v. Sniff+cat. (Of a cat owner) to sniff the cat. This Internet slang term is often used by cat owners to describe their love for cats. They can’t help hugging and playing with the cats as soon as they see them, and they even like sniffing the smell of cats. The term mimics the word 吸煙 [xī yān] “smoking.”
逆天改命	<Expression> Defy heaven and change one’s destiny. This expression comes from the TV series Fighter of the Destiny. The protagonist Chen Changsheng is plagued with an incurable illness, fated not to live past the age of twenty. He is therefore determined to find the magic stone that will change his fate.
秒刪	v. Second+delete. To delete within seconds. To delete swiftly. This Internet slang term is often used to describe celebrities’ quick deletion of their Weibo posts. To their chagrin, those posts are often screencropped by Internet users before deletion and prompted more discussions due to instant deletion.
片	thin piece; flake; a slice; film; TV play; to slice; to carve thin; partial; incomplete; one-sided; classifier for slices, tablets, tract of land, area of water; classifier for CDs, movies, DVDs etc; used with numeral 一[yi1]: classifier for scenario, scene, feeling, atmosphere, sound etc; Kangxi radical 91
會聊天	v. To know how to chat. A conversationalist who is polite, respectful, understanding, and interesting is touted as someone who knows how to chat. This Internet slang term celebrates one’s high EQ. In the Chinese Internet culture, a high IQ is predominately defined as being polite and considerate of others.
麼麼噠	n. 麼 [mē] is an onomatopoeia that mimics the sound of a gentle kiss aka “mwa,” [or chup in Thai, schmatz in German, mats-muts in Greek, umma in Malayalam, and chu in Japanese]. This Intenernet term imitates the form of 萌萌噠 [méng méng da] and has been a popular way among Chinese young people to show affection.
豬精女孩	n. <Fandom Terminology> Pig spirit+girl. This sexist Internet slang term originally referred to female fans who eat a lot like pigs and feel so good about themselves and therefore are annoying to others. Now it also refers to fat, ugly women with a histrionic personality. Sometimes it is used for self-mockery.
總攻	n. Attack all around. A person who launches an all-around attack. A person who takes charge of the situation and is able to make others obey him or her. This Internet slang term comes from the Japanese ACG culture, especially Boy’s Love-themed works. The term is often used positively to describe a natural leader.
網感	n. Web+sense. The level of interactivity with the viewers on the Internet. This Internet slang term is often used as a standard for evaluating TV shows. A TV program with a good web sense has a large fan base on the Internet, satisfies Internet users’ aesthetic needs, and sparks heated discussions on the Internet.
友盡	v. Friend+over. To sever a friendship. This Internet slang term is often used as a humorous reply to a friend’s prank or offensive comment or a joking comment on a friend’s amazing strength that makes you feel sorry for your mediocrity. Yet, sometimes people do mean it when they say to you, “Friendship terminated.”
点	point; dot; drop; speck; o'clock; point (in space or time); to draw a dot; to check on a list; to choose; to order (food in a restaurant); to touch briefly; to hint; to light; to ignite; to pour a liquid drop by drop; (old) one fifth of a two-hour watch 更[geng1]; dot stroke in Chinese characters; classifier for items
母職懲罰	n. Mother’s role+punishment. Punishment caused by fulfilling the role of a mother. This Internet slang term refers to the disadvantages that a woman has at home and work because of her role as a mother—such as more unpaid housework, discrimination in job search, lower income, and fewer career advancement opportunities.
碰瓷	(coll.) to scam sb by setting up an "accident" in which one appears to have sustained damage or injury caused by the scam victim, then demanding compensation (variations include putting "expensive" porcelain in a place where it is likely to be knocked over by passers-by, and stepping into the path of a slow-moving car)
挂	to hang; to suspend (from a hook etc); to hang up (the phone); (of a line) to be dead; to be worried; to be concerned; (dialect) to make a phone call; to register (at a hospital); to make an appointment (with a doctor); (slang) to kill; to die; to be finished; to fail (an exam); classifier for sets or clusters of objects
起	to rise; to raise; to get up; to set out; to start; to appear; to launch; to initiate (action); to draft; to establish; to get (from a depot or counter); verb suffix, to start; starting from (a time, place, price etc); classifier for occurrences or unpredictable events: case, instance; classifier for groups: batch, group
大豬蹄子	Big pig’s foot. Trotter. This Internet slang term refers to an unwelcome man, especially a man who is not sensitive to women’s emotional needs, a fickle man who turns cold to a woman after they become a couple, or a man who is a playboy. The meme went popular in August, 2018 as a generic complaint about men’s shortcomings.
节	joint; node; (bound form) section; segment; solar term (one of the 24 divisions of the year in the traditional Chinese calendar); seasonal festival; (bound form) to economize; to save; (bound form) moral integrity; chastity; classifier for segments: lessons, train wagons, biblical verses etc; knot (nautical miles per hour)
开	to open (transitive or intransitive); (of ships, vehicles, troops etc) to start; to turn on; to put in operation; to operate; to run; to boil; to write out (a prescription, check, invoice etc); (directional complement) away; off; carat (gold); abbr. for Kelvin, 開爾文|开尔文[Kai1 er3 wen2]; abbr. for 開本|开本[kai1 ben3], book format
厉害	(used to describe sb or sth that makes a very strong impression, whether favorable or unfavorable) terrible; intense; severe; devastating; amazing; awesome; outstanding; (of a person) stern; strict; harsh; shrewd; tough; (of an animal) fierce; (of a resemblance) striking; (of liquor or chili pepper) strong; (of bacteria) virulent
約炮	v. Appointment+cannon. To have casual sex such as one-night stands and other related activity. This Internet slang term is created from a male points of view because it is a combination of 約會 [yuē huì] “to have a date” and 打炮 [dǎ pào] “1) To open fire with artillery, 2) a slang term for having sex [with a prostitute], or 3) to jerk off.”
洪荒之力	n. Primeval power. Catastrophically strong physical strength. This Internet slang term came into popularity because of the 2015 TV drama The Journey of Flower in which the character Hua Qiangu aka Demon God has the preternatural, catastrophic power. Currently the meme is used to describe one’s physical strength or one’s urge to do something.
跳戲	v. Jump+drama. [Of an actor or actress] to give unconvincing performance. The reasons vary. It could be because the viewers are accustomed to seeing the actor or actress cast in a different type of role, because the performer’s previous acting in a similar role left a deeper impression on the audience, or because the storyline is problematic.
微博淪陷	v. [Someone’s] Weibo account+occupied. [Someone’s, usually a celebrity’s] Weibo account is inundated with Internet users’ comments. This Internet slang term is often used to describe the situation where a celebrity grabbed the headlines and then another celebrity related to him or her suddenly received a large number of comments on social media.
整	(bound form) whole; complete; entire; (before a measure word) whole; (before or after number + measure word) exactly; (bound form) in good order; tidy; neat; (bound form) to put in order; to straighten; (bound form) to repair; to mend; to renovate; (coll.) to fix sb; to give sb a hard time; to mess with sb; (dialect) to tinker with; to do sth to
门	gate; door; CL:扇[shan4]; gateway; doorway; CL:個|个[ge4]; opening; valve; switch; way to do something; knack; family; house; (religious) sect; school (of thought); class; category; phylum or division (taxonomy); classifier for large guns; classifier for lessons, subjects, branches of technology; (suffix) -gate (i.e. scandal; derived from Watergate)
劃掉	v. To cross out [a word]. This Internet slang term is often used humorously to correct yourself. You usually insert the Internet slang term between the original word and the correction. The original word shows your true intention while the correction is the result of your self-censorship. E.g. I admire my idol’s appearance, cross that out, talent.
反差萌	n. Contrast+cuteness. This Internet slang term comes from the Japanese ACG subculture and refers to the adorableness accentuated by the contrast between a character’s sex and gender, age and appearance, biological age and psychological age, identity and personality, past personality and current personality, public persona and true personality, etc.
愛無能	n. Inability to love. This Internet slang term refers to some people’s inability to enter a relationship. The reasons vary. Some people are traumatized by past relationships, some are too narcissistic to love others, some are afraid of commitment, some repress their feelings too much…Some people attribute their singledom to their inability to love.
从	from; through; via; (bound form) to follow; (bound form) to obey; (bound form) to engage in (an activity); (used before a negative) ever; (bound form) (Taiwan pr. [zong4]) retainer; attendant; (bound form) (Taiwan pr. [zong4]) assistant; auxiliary; subordinate; (bound form) (Taiwan pr. [zong4]) related by common paternal grandfather or earlier ancestor
土創	n. Indigenous & Unrefined+create. Indigenous & Unrefined Create. This Internet slang term is a nickname for Produce 101, a Chinese reality television show spinoff of the South Korean television show Produce 101. The Chinese name of the show is literally Create 101. The show was criticized for the caliber of its contestants as well the quality of production.
白嫖飯	n. Free+patronize+fan. Fans who patronize [a prostitute] for free. Here “prostitute” actually refers to an idol. This Internet slang term is a pejorative term for fans who are not willing to spend money or take part in social media campaigns for their idols. They only want to enjoy the idols’ works for free without making any contribution to the idols’ careers.
梗	branch; stem; stalk; CL:根[gen1]; to block; to hinder; (neologism that evolved from 哏[gen2], initially in Taiwan, during the first decade of the 21st century) memorable creative idea (joke, catchphrase, meme, neologism, witty remark etc); prominent feature of a creative work (punchline of a joke, trope in a drama, special ingredient in a dish, riff in a pop song etc)
股	thigh; part of a whole; portion of a sum; (stock) share; strand of a thread; low-level administrative unit, translated as "section" or "department" etc, ranked below 科[ke1]; classifier for long winding things like ropes, rivers etc; classifier for smoke, smells etc: thread, puff, whiff; classifier for bands of people, gangs etc; classifier for sudden forceful actions
鎖場	v. To lock the auditorium. This Internet slang term describes the phenomenon that ardent fans purchase one to two movie tickets for each movie auditorium where their idols’ movie is scheduled to be screened, in order to give theatrical exhibitors the false impression that their idols’ movies are very popular so that the movie would be screened at more movie theaters.
去	to go; to go to (a place); (of a time etc) last; just passed; to send; to remove; to get rid of; to reduce; to be apart from in space or time; to die (euphemism); to play (a part); (when used either before or after a verb) to go in order to do sth; (after a verb of motion indicates movement away from the speaker); (used after certain verbs to indicate detachment or separation)
天仙攻	n. Fairy+attack. This Internet slang term is the fans’ nickname for actress Liu Yifei or Crystal Liu in 2015. Liu Yifei is famous for her role in The Return of the Condor Heroes as the beautiful and elegant Xiaolongnü. She also dubbed “Sister Fairy.” The new nickname was originally used to express the fans’ admiration for her dashing and slightly masculine look when dressed in suits.
躺槍	v. “Lying down [but still got] shot. ” Short for 躺著也中槍 [tǎng zhe yě zhòng qiāng] “getting shot while lying [on the floor]”, this Internet slang term is used to describe people being criticized or mentioned in an unwanted way even when they deliberately try to avoid it. People mentioned or blamed for what they are not responsible for often use this Internet slang term for self-mockery.
投	to throw (sth in a specific direction: ball, javelin, grenade etc); to cast (a ballot); to cast (a glance, a shadow etc); to put in (money for investment, a coin to operate a slot machine); to send (a letter, a manuscript etc); to throw oneself into (a river, a well etc to commit suicide); to go to; to seek refuge; to place oneself into the hands of; (coll.) to rinse (clothes) in water
送你上墻	<Expression> Send you onto the wall. Send you to [the section of] hot comments [which are often automatically placed at the top]. This expression is often used to express one’s approval of a comment on a social media post because it is well-written or funny. The Internet users who use this expression usually click “like” on the comment too to make it pinned to the top of the comment section.
塘主	n. [Fish] pond owner. This Internet slang term is a pejorative nickname for Zhang Han, because his famous line in the TV show Boss & Me:  “I want to let everyone know: This fish pond, is now under your management by contract.” People jeer his role for making a ludicrous confession of love by mentioning a fish pond. The nickname implies discrimination against country people and contempt for Zhang Han.
帶節奏	v. Lead+rhythm. <Gaming terminology> To instigate a fight. This Internet slang term is originally used to describe a gamer who determines the strategies for the whole team in a group video or computer game. Now it is used to describe an Internet user who misleads others with wrong information or offensive language in online discussions and instigates verbal fights among groups holding opposing views.
少女心	n. Teen girl’s heart. A person with a teen girl’s heart is girly, dreamy, sensitive, vigorous, and sentimental. This Internet slang term is often used positively to describe a person who unapologetically adores girly toys and longs for romantic chance encounters with male celebrities like a moony teenage fangirl. This term sometimes runs the risk of perpetuating gender stereotypes about girls and teenagers.
被	quilt; to cover (with); (literary) to suffer (a misfortune); used to indicate passive voice (placed before the doer of the action like "by" in English passive-voice sentences, or, if the doer is not mentioned, before the verb); (since c. 2009) (sarcastic or jocular) used to indicate that the following word should be regarded as being in air quotes (as in 被旅遊|被旅游[bei4 lu:3 you2] to "go on a trip", for example)
黑科技	n. Black technology. This term first appeared in フルメタル・パニックor Full Metal Panic!, a series of light novels written by Shoji Gatoh and illustrated by Shiki Douji, and referred to technology that is far more advanced than those of the real world. As a Chinese Internet slang term, it describes awe-inspiring technology that is beyond the understanding of the average people. Sometimes this term is used sarcastically.
土嗨	adj. rustic+excited. This Internet slang term was originally used to describe an electronic dance music dilettante who mistakes DJ for electronic dance music. Now it is commonly used to describe Chinese electronic dance music that sound amateurish by international standards. The contempt for unsophisticated composers is quite obvious, judged from the use of the character 土 [tǔ] “uncouth, unsophisticated, rural.”
手撕鬼子	n. To lacerate the devils [a term of abuse for foreign invaders, particularly Japanese invaders] by hand. This Internet slang term pokes fun at the 2011 Chinese TV drama The Curious Maestros against Japanese Invasion in which a Kungfu master tears up the Japanese invaders in the War of Resistance against Japan (1937-1945). The plot was berated online and by state-run newspapers like People’s Daily for distorting history.
實力	adj./adv. Derived from the original noun “capability,” this Internet slang term is used as an adjective meaning “real,” or “evidence-based” and as an adverb meaning “strongly” and “effectively. ” This term is often used humorously or satirically. For example, 實力裝逼 [shí lì zhuāng bī] v. to try hard to impress others by pretending to be better than one really is. 實力心疼 [shí lì xīn téng] v. To really feel sorry for [someone].
蛙哥	n. Frog+brother. Brother frog. This Internet slang term is a tongue-in-cheek mutation of 五阿哥 [wǔ à gē] The fifth brother who was Prince Rong or Yongqi of the Qing dynasty. It became a nickname for actor Alec Su or Su Yongpeng who played the role of Prince Rong on My Fair Princess or Princess Return Pearl in 1998. If you say  五阿哥 [wǔ à gē] fast enough and with a Taiwanese Mandarin accent as Alec Su did, it will sound like 蛙哥 [wā gē].
高仿號	n. High+imitate+account. Weibo accounts that pretend to be owned by celebrities in order to attract followers. Such accounts often steal celebrities’ pictures and imitate their writing styles. Oversharing is another common weakness among those fake accounts. When an celebrity posts weibos too often or displays qualities that are little known to the public on Weibo, their fans will also quip that those celebrities’ weibo accounts are fakes.
道	road; path (CL:條|条[tiao2],股[gu3]); (bound form) way; reason; principle; (bound form) a skill; an art; a specialization; (Daoism) the Way; the Dao; to say (introducing a direct quotation, as in a novel); (bound form) to express; to extend (polite words); classifier for long thin things (rivers, cracks etc), barriers (walls, doors etc), questions (in an exam etc), commands, courses in a meal, steps in a process; (old) circuit (administrative division)
三歲	n. Three-year-old. This Internet slang term is often coupled with someone’s last name. It became popular first when used to describe Hong Kong actor Francis Ng aka Wu Zhenyu when he appeared with his son on the reality TV show Where Are We Going, Dad in 2014. Netizens dubbed him “Wu Three-Year-Old”, amused by his mischievous and childlike personality on the show as well as on Weibo. The meme has been widely used to describe many beloved celebrities.
老鹿蹣跚	<Expression> An old deer staggers. This expression describes the reaction of unmarried people in their late 20s or older to their crushes. As opposed to 小鹿亂撞 [xiǎo lù luàn zhuàng] “A fawn rushes impetuously, an idiom that describes a young person’s restless state due to fear or strong emotions [upon seeing his or her crush],” this expression pokes fun at older unmarried people’s reluctance to be emotionally invested in the love interest for fear of getting hurt.
甲	first of the ten Heavenly Stems 十天干[shi2 tian1 gan1]; (used for an unspecified person or thing); first (in a list, as a party to a contract etc); letter "A" or roman "I" in list "A, B, C", or "I, II, III" etc; armor plating; shell or carapace; (of the fingers or toes) nail; bladed leather or metal armor (old); ranking system used in the Imperial examinations (old); civil administration unit in the baojia 保甲[bao3 jia3] system (old); ancient Chinese compass point: 75°
反向育儿	reverse parenting. While past generations of parents in China maintained a serious demeanor and relied on punishments as a form of discipline, the post-’90s generation is embracing a different approach: When their kids lay on the floor in an ice cream store, parents do the same. If the children throw away a toy, parents throw away others too. Some even go to extremes: putting their kids’ studies on hold to play video games for hours on end, just as their children desired.
妖艷賤貨	n. Pretty and coquettish bitches. This Internet slang term was made popular by Taiwanese vlogger @谷阿莫 who is famed for producing video synopses of movies and TV series. In the synopses, the term was used frequently in the sentence “[The male lead] feels [the female lead] is so innocent, so unpretentious, and so different from those pretty coquettish bitches outside.” This term describes the type of women that grosses the male leads out, but of course irony is often involved.
詩和遠方	<Expression> Poetry and the far-off land. This expression comes from the quote from Zhang Kequn, musician Gao Xiaosong’s mother, “Life is more than resigning to the mundane affairs in life; it is also about poetry and the far-off land.” This quote became popular among Chinese young people under the pressure of high housing prices in big cities. It is often cited to inspire people to stop fretting over not amassing enough material wealth and instead find a place of inner peace through art and travel.
殺馬特	adj./n. Kill+horse+special. Smart. The scene people. This Internet slang term mimics the pronunciation of the English word “smart,” but it is used to tease the teenagers and young adults who prefer a fashion style that emphasizes androgyny and bright colors. These young people usually migrated from rural areas to urban areas. They lack higher education and take on low-income jobs in cities. Their fashion choices reflect their need for attention and sense of alienation in the process of urbanization.
来	to come; (used as a substitute for a more specific verb); hither (directional complement for motion toward the speaker, as in 回來|回来[hui2 lai5]); ever since (as in 自古以來|自古以来[zi4 gu3 yi3 lai2]); for the past (amount of time); (prefix) the coming ...; the next ... (as in 來世|来世[lai2 shi4]); (between two verbs) in order to; (after a round number) approximately; (used after 得[de2] to indicate possibility, as in 談得來|谈得来[tan2 de5 lai2], or after 不[bu4] to indicate impossibility, as in 吃不來|吃不来[chi1 bu5 lai2])
就	(after a suppositional clause) in that case; then; (after a clause of action) as soon as; immediately after; (same as 就是[jiu4 shi4]) merely; nothing else but; simply; just; precisely; exactly; only; as little as; as much as; as many as; to approach; to move towards; to undertake; to engage in; (often followed by 著|着[zhe5]) taking advantage of; (of food) to go with; with regard to; concerning; (pattern: 就[jiu4] ... 也[ye3] ...) even if ... still ...; (pattern: 不[bu4] ... 就[jiu4] ...) if not ... then must be ...
只有	only have ...; there is only ...; (used in combination with 才[cai2]) it is only if one ... (that one can ...) (Example: 只有通過治療才能痊愈|只有通过治疗才能痊愈[zhi3 you3 tong1 guo4 zhi4 liao2 cai2 neng2 quan2 yu4] "the only way to cure it is with therapy"); it is only ... (who ...) (Example: 只有男性才有此需要[zhi3 you3 nan2 xing4 cai2 you3 ci3 xu1 yao4] "only men would have such a requirement"); (used to indicate that one has no alternative) one can only (do a certain thing) (Example: 只有屈服[zhi3 you3 qu1 fu2] "the only thing you can do is give in")
油膩	adj. Oily, greasy. This Internet slang term was made popular by Chinese writer Feng Tang in his article “How to Avoid Becoming a Greasy, Creepy Middle-Aged Man.” The article reminds middle-aged Chinese men not to: get fat, stop learning, stay still, talk about sex in public, be overtly nostalgic, lecture youngsters, cause trouble for others, stop shopping, ignore personal hygiene and grooming, or despise healthy life habits. In that sense, “greasy” describes a person who is indolent, narcissistic, annoying, misogynistic, and/or lewd.
喪	adj./v. To vegetate due to deep frustration. This Internet slang became popular in 2016 following Internet memes like 葛優癱 [gě yōu tān] “the Ge You slouch”, 廢柴 [fèi chái] “trashy firewood, douchebags”, 生無所戀 [shēng wú suǒ liàn] “There is nothing in life to long for”, Pepe the Frog, etc. Analysts attribute the popularity of this Internet slang term to the post-90s‘ [people born between 1990 and 1999] pessimism about social mobility amidst a host of social problems such as air pollution, the skyrocketing housing prices, and workplace stress.
老司機	n. The old driver. The Internet slang term started off referring to a person who likes talking dirty. The internet meme comes from “老司機，嗚嗚嗚/污污污”: Old driver, toot, toot, toot/dirty dirty dirty.” “Toot” and “dirty” are homophones. Later, another meaning of this term emerged: a person who is experienced in something. For example, a senior-year student may refer to himself or herself as an old driver because he or she has spent more time at a university than younger students. A veteran salesperson can also describe himself or herself as an old driver in the field.
吃瓜群眾	n. The watermelon-eating people. This Internet slang term is often used in the context of 不明真相的吃瓜群眾 [bù míng zhēn xiàng de chī guā qún zhòng] the watermelon-eating people who are oblivious to the truth. This term was originally used to describe the public whose interest is jeopardized by the civil servants who blindly follow the directions of their injudicious supervisors. Now it describes Internet users who are gossipy and inquisitive or who are awear of certain hot topics but decline to comment on something. They often chalk up their silence or apathy to disinterest or the lack of access to the truth.
種子	n. Seed. Torrent file. As an Internet slang term it often refers to a torrent file. In the BitTorrent file distribution system, a torrent file is a computer file that contains metadata about files and folders to be distributed, and usually also a list of the network locations of trackers, which are computers that help participants in the system find each other and form efficient distribution groups. A torrent file does not contain the content to be distributed; it only contains information about those files, such as their names, sizes, folder structure, and cryptographic hash values for verifying file integrity.
高級臉	n. High-end face. This Internet slang term refers to the latest beauty trend among Chinese women. A Chinese woman who has a high-end face usually looks a little masculine. She often has the single eyelids, relatively small, long, and wide-set eyes, slightly higher cheekbones, thicker lips, and a chiseled jawline. The above facial features convey an air of aloofness and even frigidity. This trend differs from the traditional standard for female beauty which accentuates femininity and childlike innocence. The Chinese models popular in the West such as Lv Yan, Du Juan, and Liu Wen may have contributed to popularity of this Internet slang term.
