道理	reason; argument; sense; principle; basis; justification; CL:個|个[ge4]
弊端	systemic problem (sometimes refers specifically to corrupt practices)
从事	to go for; to engage in; to undertake; to deal with; to handle; to do
词汇	vocabulary; list of words (e.g. for language teaching purposes); word
经常	frequently; constantly; regularly; often; day-to-day; everyday; daily
观念	notion; thought; concept; sense; views; ideology; general impressions
儿女	children; sons and daughters; a young man and a young woman (in love)
烦	to feel vexed; to bother; to trouble; superfluous and confusing; edgy
困难	difficult; challenging; straitened circumstances; difficult situation
动漫	cartoons and comics; anime and manga; cartoon (animated movie); anime
滑	to slip; to slide; slippery; smooth; sly; slippery; not to be trusted
数量	amount; quantity (CL:個|个[ge4]); quantitative; (math.) scalar quantity
死	to die; impassable; uncrossable; inflexible; rigid; extremely; damned
递增	to increase by degrees; in increasing order; incremental; progressive
垃圾	trash; refuse; garbage; (coll.) of poor quality; Taiwan pr. [le4 se4]
听说	to hear (sth said); one hears (that); hearsay; listening and speaking
约会	appointment; engagement; date; CL:次[ci4],個|个[ge4]; to arrange to meet
绿化	to make green with plants; to reforest; (Internet slang) Islamization
示范	to demonstrate; to show how to do sth; demonstration; a model example
显	to make visible; to reveal; prominent; conspicuous; (prefix) phanero-
修复	to restore; to renovate; (computing) to repair (a corrupted file etc)
挥	to wave; to brandish; to command; to conduct; to scatter; to disperse
选修	(at a school) to take as an elective; an elective; elective (subject)
引导	to guide; to lead (around); to conduct; to boot; introduction; primer
酱紫	dark reddish purple; Internet slang abbr. for 這樣子|这样子[zhe4 yang4 zi5]
征求	to solicit; to seek; to request (opinions, feedback etc); to petition
暂停	to suspend; time-out (e.g. in sports); stoppage; pause (media player)
解体	to break up into components; to disintegrate; to collapse; to crumble
奏	to play music; to achieve; to present a memorial to the emperor (old)
冷落	desolate; unfrequented; to treat sb coldly; to snub; to cold shoulder
全球暖化	global warming (Taiwan and Hong Kong usage); written 全球變暖|全球变暖 in PRC
卵	egg; ovum; spawn; (coll.) testicles; (old) penis; (expletive) fucking
容纳	to hold; to contain; to accommodate; to tolerate (different opinions)
无精打采	dispirited and downcast (idiom); listless; in low spirits; washed out
屑	bits; fragments; crumbs; filings; trifling; trivial; to condescend to
闭幕	the curtain falls; lower the curtain; to come to an end (of a meeting)
不行	won't do; be out of the question; be no good; not work; not be capable
不论	whatever; no matter what (who, how etc); regardless of; not to discuss
土味情話	n. Crude and unsophisticated+words of love. Corny terms of endearment.
努力	to make an effort; to try hard; to strive; hard-working; conscientious
队伍	ranks; troops; queue; line; procession; CL:個|个[ge4],支[zhi1],條|条[tiao2]
一边	one side; either side; on the one hand; on the other hand; doing while
关闭	to close; to shut (a window etc); (of a shop, school etc) to shut down
临时	as the time draws near; at the last moment; temporary; interim; ad hoc
加入	to become a member; to join; to mix into; to participate in; to add in
进一步	to go a step further; (develop, understand, improve etc) more; further
聚	to assemble; to gather (transitive or intransitive); (chemistry) poly-
短促	short in time; fleeting; brief; gasping (breath); curt (tone of voice)
突出	prominent; outstanding; to give prominence to; to protrude; to project
呀	(particle equivalent to 啊 after a vowel, expressing surprise or doubt)
摩擦	friction; rubbing; chafing; fig. disharmony; conflict; also written 磨擦
吼	to roar; to howl; to shriek; roar or howl of an animal; bellow of rage
粗來	v. Come out. A humorous phonetic deviation of 出來 [chū lái] “come out”.
之后	after; behind; (at the beginning of a sentence) afterwards; since then
凶	vicious; fierce; ominous; inauspicious; famine; variant of 兇|凶[xiong1]
战斗	to fight; to engage in combat; struggle; battle; CL:場|场[chang2],次[ci4]
勉强	to do with difficulty; to force sb to do sth; reluctant; barely enough
内向	reserved (personality); introverted; (economics etc) domestic-oriented
体谅	to empathize; to allow (for sth); to show understanding; to appreciate
无理取闹	to make trouble without reason (idiom); to be deliberately provocative
演习	(military, firefighting etc) (verb and noun) drill; exercise; maneuver
毕竟	after all; all in all; when all is said and done; in the final analysis
材料	(raw) material; data; (fig.) person who has the potential to do the job
不成	won't do; unable to; (at the end of a rhetorical question) can that be?
猫	cat (CL:隻|只[zhi1]); (dialect) to hide oneself; (loanword) (coll.) modem
别扭	awkward; difficult; uncomfortable; not agreeing; at loggerheads; gauche
马上	at once; right away; immediately; on horseback (i.e. by military force)
不惜	not stint; not spare; not hesitate (to do sth); not scruple (to do sth)
发送	to transmit; to dispatch; to issue (an official document or credential)
跌	to fall; to tumble; to trip; (of prices etc) to drop; Taiwan pr. [die2]
小狼狗	n. Little wolfdog. A woman’s young, dashing, and responsible boyfriend.
新專	n. New album. This Internet slang term is short for 新專輯 [xīn zhuān jí].
苦	bitter; hardship; pain; to suffer; to bring suffering to; painstakingly
又	(once) again; also; both... and...; and yet; (used for emphasis) anyway
呈现	to appear; to emerge; to present (a certain appearance); to demonstrate
立刻	forthwith; immediate; prompt; promptly; straightway; thereupon; at once
明确	clear-cut; definite; explicit; to clarify; to specify; to make definite
年代	a decade of a century (e.g. the Sixties); age; era; period; CL:個|个[ge4]
国会	Parliament (UK); Congress (US); Diet (Japan); Legislative Yuan (Taiwan)
留下	to leave behind; to stay behind; to remain; to keep; not to let (sb) go
进口	to import; imported; entrance; inlet (for the intake of air, water etc)
雨	(literary) to rain; (of rain, snow etc) to fall; to precipitate; to wet
中	to hit (the mark); to be hit by; to suffer; to win (a prize, a lottery)
列	to arrange; to line up; file; series; (in data tables) column; (Tw) row
捐款	to donate money; to contribute funds; donation; contribution (of money)
修理	to repair; to fix; to prune; to trim; (coll.) to sort sb out; to fix sb
年前	by the end of the year; at the end of the year; shortly before New Year
棉	generic term for cotton or kapok; cotton; padded or quilted with cotton
租	to hire; to rent; to charter; to rent out; to lease out; rent; land tax
附属	subsidiary; auxiliary; attached; affiliated; subordinate; subordinating
嗨p	adj. Hi+P. This Internet slang term is a phonetic deviation of “happy.”
随意	as one wishes; according to one's wishes; at will; voluntary; conscious
推动	to push (e.g. for acceptance of a plan); to promote; to give impetus to
厅	(reception) hall; living room; office; provincial government department
休闲	leisure; relaxation; not working; idle; to enjoy leisure; to lie fallow
要好	to be on good terms; to be close friends; striving for self-improvement
之一	one of (sth); one out of a multitude; one (third, quarter, percent etc)
狼吞虎咽	to wolf down one's food (idiom); to devour ravenously; to gorge oneself
牵制	to control; to curb; to restrict; to impede; to pin down (enemy troops)
心甘情愿	delighted to (do sth, idiom); perfectly happy to do; most willing to do
保证	guarantee; to guarantee; to ensure; to safeguard; to pledge; CL:個|个[ge4]
背包	knapsack; rucksack; infantry pack; field pack; blanket roll; CL:個|个[ge4]
本人	I; me; myself; oneself; yourself; himself; herself; the person concerned
背心	sleeveless garment (vest, waistcoat, singlet, tank top etc); CL:件[jian4]
对不起	I'm sorry; excuse me; I beg your pardon; to let (sb) down; to disappoint
请	to ask; to invite; please (do sth); to treat (to a meal etc); to request
倒是	contrary to what one might expect; actually; contrariwise; why don't you
二手	indirectly acquired; second-hand (information, equipment etc); assistant
阐述	to expound (a position); to elaborate (on a topic); to treat (a subject)
一直	straight (in a straight line); continuously; always; all the way through
男	male; Baron, lowest of five orders of nobility 五等爵位[wu3 deng3 jue2 wei4]
搞	to do; to make; to go in for; to set up; to get hold of; to take care of
构成	to constitute; to form; to compose; to make up; to configure (computing)
另外	additional; in addition; besides; separate; other; moreover; furthermore
论文	paper; treatise; thesis; CL:篇[pian1]; to discuss a paper or thesis (old)
木头	slow-witted; blockhead; log (of wood, timber etc); CL:塊|块[kuai4],根[gen1]
膨脹	adj. Big-headed. This Internet slang term is often used in self-mockery.
事实上	in fact; in reality; actually; as a matter of fact; de facto; ipso facto
留学生	student studying abroad; (foreign) exchange student; CL:個|个[ge4],位[wei4]
劝	to advise; to urge; to try to persuade; to exhort; to console; to soothe
克服	(try to) overcome (hardships etc); to conquer; to put up with; to endure
盯	to watch attentively; to fix one's attention on; to stare at; to gaze at
反面	reverse side; backside; the other side (of a problem etc); negative; bad
优惠	privilege; favorable (terms); preferential (treatment); discount (price)
复活	to revive; (lit. and fig.) to come back to life; (religion) resurrection
收获	to harvest; to reap; to gain; crop; harvest; profit; gain; bonus; reward
谈话	to talk (with sb); to have a conversation; talk; conversation; CL:次[ci4]
套路	sequence of movements in martial arts; routine; pattern; standard method
危害	to jeopardize; to harm; to endanger; harmful effect; damage; CL:個|个[ge4]
寵溺	adj. adv. & n. Spoil+indulge. Indulgent, indulgently, loving indulgence.
学会	to learn; to master; institute; learned society; (scholarly) association
有关	to have sth to do with; to relate to; related to; to concern; concerning
酒精	alcohol; ethanol CH3CH2OH; ethyl alcohol; also written 乙醇; grain alcohol
清淡	light (of food, not greasy or strongly flavored); insipid; slack (sales)
进取	to show initiative; to be a go-getter; to push forward with one's agenda
包容	to pardon; to forgive; to show tolerance; to contain; to hold; inclusive
翻山越岭	lit. to pass over mountain ridges (idiom); fig. hardships of the journey
嚷	to shout; to bellow; to make a big deal of sth; to make a fuss about sth
让步	to concede; to give in; to yield; a concession; (linguistics) concessive
伤脑筋	to be a real headache; to find sth a real headache; to beat one's brains
示威	to demonstrate (as a protest); a demonstration; a military show of force
镶嵌	to inlay; to embed; to set (e.g. a jewel in a ring); tiling; tesselation
循序渐进	in sequence, step by step (idiom); to make steady progress incrementally
冤枉	to accuse wrongly; to treat unjustly; injustice; wronged; not worthwhile
啊	modal particle ending sentence, showing affirmation, approval, or consent
办	to do; to manage; to handle; to go about; to run; to set up; to deal with
傍晚	in the evening; when night falls; towards evening; at night fall; at dusk
出	variant of 出[chu1] (classifier for plays or chapters of classical novels)
兵	soldiers; a force; an army; weapons; arms; military; warlike; CL:個|个[ge4]
钱	coin; money; CL:筆|笔[bi3]; unit of weight, one tenth of a tael 兩|两[liang3]
姑娘	girl; young woman; young lady; daughter; paternal aunt (old); CL:個|个[ge4]
骑	to sit astride; to ride (a horse, bike etc); classifier for saddle horses
层出不穷	more and more emerge; innumerable succession; breeding like flies (idiom)
搀	to take by the arm and assist; to mix; to blend; to dilute; to adulterate
交换	to exchange; to swap; to switch (telecom); commutative (math); to commute
校长	(college, university) president; headmaster; CL:個|个[ge4],位[wei4],名[ming2]
经典	the classics; scriptures; classical; classic (example, case etc); typical
辣	hot (spicy); pungent; (of chili pepper, raw onions etc) to sting; to burn
敲	to hit; to strike; to tap; to rap; to knock; to rip sb off; to overcharge
过渡	to cross over (by ferry); transition; interim; caretaker (administration)
继承	to inherit; to succeed to (the throne etc); to carry on (a tradition etc)
颠倒	to turn upside down; to reverse; back to front; confused; deranged; crazy
首	head; chief; first (occasion, thing etc); classifier for poems, songs etc
堕落	to degrade; to degenerate; to become depraved; corrupt; a fall from grace
决策	strategic decision; decision-making; policy decision; to determine policy
意见	idea; opinion; suggestion; objection; complaint; CL:點|点[dian3],條|条[tiao2]
泛滥	to be in flood; to overflow (the banks); to inundate; to spread unchecked
直接	direct (opposite: indirect 間接|间接[jian4 jie1]); immediate; straightforward
母鸡	hen; don't know (humorous slang mimicking Cantonese 唔知, Jyutping: m4 zi1)
嘴炮	(Internet slang) to mouth off; to shoot one's mouth off; sb who does that
首	head; chief; first (occasion, thing etc); classifier for poems, songs etc
全力	with all one's strength; full strength; all-out (effort); fully (support)
圈粉	(neologism c. 2015) (coll.) to win (sb) over as a fan; to garner new fans
中医	traditional Chinese medical science; a doctor trained in Chinese medicine
首	head; chief; first (occasion, thing etc); classifier for poems, songs etc
下去	to go down; to descend; to go on; to continue; (of a servant) to withdraw
踢	to kick; to play (e.g. soccer); (slang) butch (in a lesbian relationship)
缓和	to ease (tension); to alleviate; to moderate; to allay; to make more mild
先后	early or late; first and last; priority; in succession; one after another
压	used in 壓根兒|压根儿[ya4 gen1 r5] and 壓馬路|压马路[ya4 ma3 lu4] and 壓板|压板[ya4 ban3]
也好	that's fine; may as well; (reduplicated) regardless of whether ... or ...
均匀	even; well-distributed; homogeneous; well-proportioned (figure, body etc)
分分鐘	adv. Literally “every minute”, this Internet slang term means “instantly”
自	(bound form) self; oneself; from; since; naturally; as a matter of course
指定	to appoint; to assign; to indicate clearly and with certainty; designated
甩	to throw; to fling; to swing; to leave behind; to throw off; to dump (sb)
命名	to give a name to; to dub; to christen; to designate; named after; naming
实事求是	lit. to seek truth from facts (idiom); fig. to be practical and realistic
闲话	casual conversation; chat; gossip; to talk about (whatever comes to mind)
争先恐后	striving to be first and fearing to be last (idiom); outdoing one another
便	used in 便宜|便宜[pian2 yi5]; used in 便便[pian2 pian2]; used in 便嬛[pian2 xuan1]
除非	only if (..., or otherwise, ...); only when; only in the case that; unless
比喻	to compare; to liken to; metaphor; analogy; figure of speech; figuratively
贬低	to belittle; to disparage; to play down; to demean; to degrade; to devalue
结果	outcome; result; conclusion; in the end; as a result; to kill; to dispatch
级	level; grade; rank; step (of stairs); CL:個|个[ge4]; classifier: step, level
家长	head of a household; family head; patriarch; parent or guardian of a child
过度	excessive; over-; excess; going too far; extravagant; intemperate; overdue
小学生	primary school student; schoolchild; CL:個|个[ge4],名[ming2]; (fig.) beginner
加盟	to become a member of an alliance or union; to align; to join; participate
据	according to; to act in accordance with; to depend on; to seize; to occupy
温柔	gentle and soft; tender; sweet (commonly used to describe a girl or woman)
文具	stationery; item of stationery (pen, pencil, eraser, pencil sharpener etc)
分寸	propriety; appropriate behavior; proper speech or action; within the norms
蒙	to cover; ignorant; to suffer (misfortune); to receive (a favor); to cheat
闻	to hear; news; well-known; famous; reputation; fame; to smell; to sniff at
左右	left and right; nearby; approximately; attendant; to control; to influence
组织	to organize; organization; (biology) tissue; (textiles) weave; CL:個|个[ge4]
有人	someone; people; anyone; there is someone there; occupied (as in restroom)
随	to follow; to comply with; varying according to...; to allow; subsequently
嗨	oh alas; hey!; hi! (loanword); a high (natural or drug-induced) (loanword)
合算	worthwhile; to be a good deal; to be a bargain; to reckon up; to calculate
相关	related; relevant; pertinent; to be interrelated; (statistics) correlation
昏迷	to lose consciousness; to be in a coma; stupor; coma; stunned; disoriented
过期	to be overdue; to exceed the time limit; to expire (as in expiration date)
心态	attitude (of the heart); state of one's psyche; way of thinking; mentality
养老	to provide for the elderly (family members); to enjoy a life in retirement
這貨	n. This dude, often used in causal conversation among Chinese young people
应急	to respond to an emergency; to meet a contingency; (attributive) emergency
专辑	album; record (music); special collection of printed or broadcast material
扩张	expansion; dilation; to expand (e.g. one's power or influence); to broaden
穿不出去	(colloquial, used to talk about clothes you wouldn't want to wear outside)
扭转	to reverse; to turn around (an undesirable situation); (mechanics) torsion
颇	rather; quite; considerably; oblique; inclined; slanting; Taiwan pr. [po3]
陶醉	to be infatuated with; to be drunk with; to be enchanted with; to revel in
媳妇	daughter-in-law; wife (of a younger man); young married woman; young woman
倍	(two, three etc) -fold; times (multiplier); double; to increase or multiply
作业	school assignment; homework; work; task; operation; CL:個|个[ge4]; to operate
打算	to plan; to intend; to calculate; plan; intention; calculation; CL:個|个[ge4]
编制	to weave; to plait; to compile; to put together (a lesson plan, budget etc)
补贴	to subsidize; subsidy; allowance; to supplement (one's salary etc); benefit
发现	to notice; to become aware of; to discover; to find; to detect; a discovery
同学	to study at the same school; fellow student; classmate; CL:位[wei4],個|个[ge4]
低	low; beneath; to lower (one's head); to let droop; to hang down; to incline
低分飄過	v. To float by with a low score. To narrowly pass an exam with a low score.
畅通	unimpeded; free-flowing; straight path; unclogged; move without obstruction
吃力	to entail strenuous effort; to toil at a task; strenuous; laborious; strain
果实	fruit (produced by a plant); (fig.) fruits (of success etc); results; gains
买卖	buying and selling; business; business transactions; CL:樁|桩[zhuang1],次[ci4]
波恩	Bonn, a small town on the Rhine, Cold War capital of West Germany 1949-1990
赶上	to keep up with; to catch up with; to overtake; to chance upon; in time for
漏	to leak; to divulge; to leave out by mistake; waterclock or hourglass (old)
恢复	to reinstate; to resume; to restore; to recover; to regain; to rehabilitate
大不了	at worst; if worst comes to worst; (usu. in the negative) serious; alarming
题目	subject; title; topic (CL:個|个[ge4]); exercise or exam question (CL:道[dao4])
美	beautiful; very satisfactory; good; to beautify; to be pleased with oneself
疗养	to get well; to heal; to recuperate; to convalesce; convalescence; to nurse
捐	to relinquish; to abandon; to contribute; to donate; (bound form) tax; levy
冬令时	standard time (as opposed to daylight saving time 夏令時|夏令时[xia4 ling4 shi2])
母子	mother and child; parent and subsidiary (companies); principal and interest
入学	to enter a school or college; to go to school for the first time as a child
轰动	to cause a sensation; to create a stir in (a place); commotion; controversy
通报	to inform; to notify; to announce; circular; bulletin; (scientific) journal
铜牌	bronze medal; bronze plaque bearing a business name or logo etc; CL:枚[mei2]
自律	self-discipline; self-regulation; autonomy (ethics); autonomic (physiology)
指挥	to conduct; to command; to direct; conductor (of an orchestra); CL:個|个[ge4]
精华	best feature; most important part of an object; quintessence; essence; soul
麻痹	paralysis; palsy; numbness; to benumb; (fig.) to lull; negligent; apathetic
人为	artificial; man-made; having human cause or origin; human attempt or effort
朋友圈	Moments (social networking function of smartphone app WeChat 微信[Wei1 xin4])
小心翼翼	cautious and solemn (idiom); very carefully; prudent; gently and cautiously
疑惑	to doubt; to distrust; unconvincing; to puzzle over; misgivings; suspicions
周折	twists and turns; vicissitude; complication; difficulty; effort; CL:番[fan1]
周转	to rotate; to circulate (cash, stock etc); turnover; circulation; cash flow
报名	to sign up; to enter one's name; to apply; to register; to enroll; to enlist
服务员	waiter; waitress; attendant; customer service personnel; CL:個|个[ge4],位[wei4]
潮	tide; damp; moist; humid; fashionable; trendy; (coll.) inferior; substandard
先生	teacher; gentleman; sir; mister (Mr.); husband; (dialect) doctor; CL:位[wei4]
答应	to answer; to respond; to answer positively; to agree; to accept; to promise
策划	to plot; to scheme; to bring about; to engineer; planning; producer; planner
长短	length; accident; mishap; right and wrong; good and bad; merits and demerits
方案	plan; program (for action etc); proposal; proposed bill; CL:個|个[ge4],套[tao4]
估计	to estimate; to assess; to calculate; (coll.) to reckon; to think (that ...)
大妈	father's elder brother's wife; aunt (affectionate term for an elderly woman)
规律	rule (e.g. of science); law of behavior; regular pattern; rhythm; discipline
鼓	drum; CL:通[tong4],面[mian4]; to drum; to strike; to rouse; to bulge; to swell
集体	collective (decision); joint (effort); a group; a team; en masse; as a group
胡子	beard; mustache or whiskers; facial hair; CL:撮[zuo3],根[gen1]; (coll.) bandit
加上	plus; to put in; to add; to add on; to add into; in addition; on top of that
叼	to hold with one's mouth (as a smoker with a cigarette or a dog with a bone)
领	neck; collar; to lead; to receive; classifier for clothes, mats, screens etc
痛快	delighted; to one's heart's content; straightforward; also pr. [tong4 kuai5]
相当	equivalent to; appropriate; considerably; to a certain extent; fairly; quite
想法	way of thinking; opinion; notion; to think of a way (to do sth); CL:個|个[ge4]
脫線	v. To derail. To suddenly change the subject; to suddenly become distracted.
西藏	Tibet; Xizang or Tibet Autonomous Region 西藏自治區|西藏自治区[Xi1 zang4 Zi4 zhi4 qu1]
先进	sophisticated; advanced (technology etc); meritorious; exemplary (deeds etc)
踏	to tread; to stamp; to step on; to press a pedal; to investigate on the spot
心疼	to love dearly; to feel sorry for sb; to regret; to grudge; to be distressed
增值	to appreciate (financially); to increase in value; value-added (accountancy)
立方	cube (math.); abbr. for 立方體|立方体[li4 fang1 ti3]; abbr. for 立方米[li4 fang1 mi3]
相对	relatively; opposite; to resist; to oppose; relative; vis-a-vis; counterpart
强制	to force; to compel; to coerce; forced; compulsory; Taiwan pr. [qiang3 zhi4]
日益	day by day; more and more; increasingly; more and more with each passing day
衰退	to decline; to fall; to drop; to falter; a decline; recession (in economics)
戴	to put on or wear (glasses, hat, gloves etc); to respect; to bear; to support
刺	thorn; sting; thrust; to prick; to pierce; to stab; to assassinate; to murder
成分	composition; ingredient; element; component; one's social status; CL:個|个[ge4]
大众	the masses; the great bulk of the population; popular (of music, science etc)
根本	fundamental; basic; root; simply; absolutely (not); (not) at all; CL:個|个[ge4]
广大	(of an area) vast or extensive; large-scale; widespread; (of people) numerous
点名	roll call; to mention sb by name; (to call or praise or criticize sb) by name
动摇	to sway; to waver; to rock; to rattle; to destabilize; to pose a challenge to
到期	to fall due (loan etc); to expire (visa etc); to mature (investment bond etc)
纪录	variant of 記錄|记录[ji4 lu4] (but in Taiwan, not for the verb sense "to record")
吊	a string of 100 cash (arch.); to lament; to condole with; variant of 吊[diao4]
充实	rich; full; substantial; to enrich; to augment; to substantiate (an argument)
腦殘粉	n. Brain-damaged+fan. Stanners. Zealous fans who blindly worship their idols.
迷路	to lose the way; lost; labyrinth; labyrinthus vestibularis (of the inner ear)
空降	to drop from the sky; (fig.) to appear out of nowhere; (attributive) airborne
捣乱	to disturb; to look for trouble; to stir up a row; to bother sb intentionally
得天独厚	blessed by heaven (idiom); enjoying exceptional advantages; favored by nature
路线	itinerary; route; political line (e.g. right revisionist road); CL:條|条[tiao2]
黑草	n. Black+grass. This Internet slang term refers to Wallace Chung’s male fans.
用功	diligent; industrious (in one's studies); to study hard; to make great effort
娱乐	to entertain; to amuse; entertainment; recreation; amusement; hobby; fun; joy
气象	meteorological feature; CL:個|个[ge4]; meteorology; atmosphere; ambience; scene
恰好	as it turns out; by lucky coincidence; (of number, time, size etc) just right
设想	to imagine; to assume; to envisage; tentative plan; to have consideration for
议题	topic of discussion; topic; subject; issue (under discussion); CL:項|项[xiang4]
赠	to give as a present; to repel; to bestow an honorary title after death (old)
转身	(of a person) to turn round; to face about; (of a widow) to remarry (archaic)
指示	to point out; to indicate; to instruct; directives; instructions; CL:個|个[ge4]
你呀	(colloquial, used to express dissatisfaction with the person being addressed)
埋没	to engulf; to bury; to overlook; to stifle; to neglect; to fall into oblivion
慢性	slow and patient; chronic (disease); slow to take effect (e.g. a slow poison)
涂抹	to paint; to smear; to apply (makeup etc); to doodle; to erase; to obliterate
争气	to work hard for sth; to resolve on improvement; determined not to fall short
正在	just at (that time); right in (that place); right in the middle of (doing sth)
对面	(sitting) opposite; across (the street); directly in front; to be face to face
常规	code of conduct; conventions; common practice; routine (medical procedure etc)
电台	transmitter-receiver; broadcasting station; radio station; CL:個|个[ge4],家[jia1]
订	to agree; to conclude; to draw up; to subscribe to (a newspaper etc); to order
昂	to lift; to raise; to raise one's head; high; high spirits; soaring; expensive
沉闷	oppressive (of weather); heavy; depressed; not happy; (of sound) dull; muffled
喘气	to breathe deeply; to pant; to gasp; to take a breather; to catch one's breath
目录	catalog; table of contents; directory (on computer hard drive); list; contents
实在	really; actually; indeed; true; real; honest; dependable; (philosophy) reality
数字	numeral; digit; number; figure; amount; digital (electronics etc); CL:個|个[ge4]
齐	neat; even; level with; identical; simultaneous; all together; to even sth out
凭	to lean against; to rely on; on the basis of; no matter (how, what etc); proof
名胜	a place famous for its scenery or historical relics; scenic spot; CL:處|处[chu4]
赛	to compete; competition; match; to surpass; better than; superior to; to excel
上市	to hit the market (of a new product); to float (a company on the stock market)
胡乱	careless; reckless; casually; absent-mindedly; at will; at random; any old how
证	certificate; proof; to prove; to demonstrate; to confirm; variant of 症[zheng4]
转动	to rotate (about an axis); to revolve; to turn; to move in a circle; to gyrate
灵感	inspiration; insight; a burst of creativity in scientific or artistic endeavor
掐	to pick (flowers); to pinch; to nip; to pinch off; to clutch; (slang) to fight
师范	teacher-training; pedagogical; normal (school, e.g. Beijing Normal University)
压抑	to constrain or repress emotions; oppressive; stifling; depressing; repression
打扮	to decorate; to dress; to make up; to adorn; manner of dressing; style of dress
反应	to react; to respond; reaction; response; reply; chemical reaction; CL:個|个[ge4]
管理	to supervise; to manage; to administer; management; administration; CL:個|个[ge4]
骨头	bone; CL:根[gen1],塊|块[kuai4]; moral character; bitterness; Taiwan pr. [gu2 tou5]
分成	to divide (into); to split a bonus; to break into; tenths; percentage allotment
秒	second (unit of time); arc second (angular measurement unit); (coll.) instantly
消化	to digest (food); (fig.) to absorb (information etc); to assimilate; to process
慌	to get panicky; to lose one's head; (coll.) (after 得[de2]) unbearably; terribly
披	to drape over one's shoulders; to open; to unroll; to split open; to spread out
区别	difference; to distinguish; to discriminate; to make a distinction; CL:個|个[ge4]
过时	old-fashioned; out of date; to be later than the time stipulated or agreed upon
失败	to be defeated; to lose; to fail (e.g. experiments); failure; defeat; CL:次[ci4]
抵制	to resist; to boycott; to refuse (to cooperate); to reject; resistance; refusal
垫	pad; cushion; mat; to pad out; to fill a gap; to pay for sb; to advance (money)
考核	to examine; to check up on; to assess; to review; appraisal; review; evaluation
填空	to fill a job vacancy; to fill in a blank (e.g. on questionnaire or exam paper)
球场	stadium; sports ground; court; pitch; field; golf course; CL:個|个[ge4],處|处[chu4]
原来	original; former; originally; formerly; at first; so, actually, as it turns out
分歧	divergent; difference (of opinion, position); disagreement; (math.) bifurcation
资料	material; resources; data; information; profile (Internet); CL:份[fen4],個|个[ge4]
评	to discuss; to comment; to criticize; to judge; to choose (by public appraisal)
勺	spoon; ladle; CL:把[ba3]; abbr. for 公勺[gong1 shao2], centiliter (unit of volume)
围	to encircle; to surround; all around; to wear by wrapping around (scarf, shawl)
好客	hospitality; to treat guests well; to enjoy having guests; hospitable; friendly
员	(bound form) person engaged in a certain field of activity; (bound form) member
夹杂	to mix together (disparate substances); to mingle; a mix; to be tangled up with
钟	clock; o'clock; time as measured in hours and minutes; bell; CL:架[jia4],座[zuo4]
印	to print; to mark; to engrave; a seal; a print; a stamp; a mark; a trace; image
打扮	to decorate; to dress; to make up; to adorn; manner of dressing; style of dress
刹车	to brake (when driving); to stop; to switch off; to check (bad habits); a brake
以至	down to; up to; to such an extent as to ...; also written 以至於|以至于[yi3 zhi4 yu2]
执着	to be strongly attached to; to be dedicated; to cling to; (Buddhism) attachment
不得不	have no choice or option but to; cannot but; have to; can't help it; can't avoid
避	to avoid; to shun; to flee; to escape; to keep away from; to leave; to hide from
西皮	one of the two chief types of music in Chinese opera; see also 二黃|二黄[er4 huang2]
不要紧	unimportant; not serious; it doesn't matter; never mind; it looks all right, but
补	to repair; to patch; to mend; to make up for; to fill (a vacancy); to supplement
车号	vehicle number (license plate number, taxi number, bus number, train car number)
没事儿	to have spare time; free from work; it's not important; it's nothing; never mind
具备	to possess; to have; equipped with; able to fulfill (conditions or requirements)
回报	(in) return; reciprocation; payback; retaliation; to report back; to reciprocate
伙	companion; partner; group; classifier for groups of people; to combine; together
回收	to recycle; to reclaim; to retrieve; to recover; to recall (a defective product)
地步	stage; degree (to which a situation has evolved); a (usu. bad) situation; leeway
颗	classifier for small spheres, pearls, corn grains, teeth, hearts, satellites etc
截止	to close; to stop; to put a stop to sth; cut-off point; stopping point; deadline
进攻	to attack; to assault; to go on the offensive; attack; assault; offense (sports)
立	to stand; to set up; to establish; to lay down; to draw up; at once; immediately
模样	look; style; appearance; approximation; about; CL:個|个[ge4]; also pr. [mo2 yang4]
愉快	cheerful; cheerily; delightful; pleasant; pleasantly; pleasing; happy; delighted
废寝忘食	(idiom) to skip one's sleep and meals; to be completely wrapped up in one's work
时刻	time; juncture; moment; period of time; CL:個|个[ge4],段[duan4]; constantly; always
套餐	set meal; (fig.) product or service package (e.g. for a cell phone subscription)
黑暗料理	n. Dark cuisine. Bizarre foods or weird food combinations that look distasteful.
同期	the corresponding time period (in a different year etc); concurrent; synchronous
各種	adj. All kinds of. This Internet slang term is usually followed by an adjective.
章	chapter; section; clause; movement (of symphony); seal; badge; regulation; order
过节	to celebrate a festival; after the celebrations (i.e. once the festival is over)
刻薄	unkind; harsh; cutting; mean; acrimony; to embezzle by making illegal deductions
事务	(political, economic etc) affairs; work; transaction (as in a computer database)
淘汰	to wash out; (fig.) to cull; to weed out; to eliminate; to die out; to phase out
大方	generous; magnanimous; stylish; in good taste; easy-mannered; natural and relaxed
史詩級	adj. Epic poem-level. This Internet slang term means reaching a very high degree.
瘦	thin; to lose weight; (of clothing) tight; (of meat) lean; (of land) unproductive
洞	cave; hole; zero (unambiguous spoken form when spelling out numbers); CL:個|个[ge4]
工夫	period of time (may be months, or mere seconds); spare time; skill; labor; effort
姨母笑	(neologism c. 2017) (slang) kindly, indulgent smile (usu. on the face of a woman)
站	station; to stand; to halt; to stop; branch of a company or organization; website
讲究	to pay particular attention to; carefully selected for quality; tastefully chosen
卷	to roll up; to sweep up; to carry along; a roll; classifier for rolls, spools etc
气	gas; air; smell; weather; to make angry; to annoy; to get angry; vital energy; qi
解	acrobatic display (esp. on horseback) (old); variant of 懈[xie4] and 邂[xie4] (old)
站	station; to stand; to halt; to stop; branch of a company or organization; website
利	sharp; favorable; advantage; benefit; profit; interest; to do good to; to benefit
指导	to guide; to give directions; to direct; to coach; guidance; tuition; CL:個|个[ge4]
认同	to approve of; to endorse; to acknowledge; to recognize; to identify oneself with
站	station; to stand; to halt; to stop; branch of a company or organization; website
推广	to extend; to spread; to popularize; generalization; promotion (of a product etc)
拖	to drag; to tow; to trail; to hang down; to mop (the floor); to delay; to drag on
假设	to suppose; to presume; to assume; supposing that ...; if; hypothesis; conjecture
抓紧	to keep a firm grip on; to pay close attention to; to lose no time in (doing sth)
用得着	to be able to use; useable; to have a use for; (in a question) to be necessary to
有事	to be occupied with sth; to have sth on one's mind; there is something the matter
指标	(production) target; quota; index; indicator; sign; signpost; (computing) pointer
再说	to say again; to put off a discussion until later; moreover; what's more; besides
利害	terrible; formidable; serious; devastating; tough; capable; sharp; severe; fierce
耍	to play with; to wield; to act (cool etc); to display (a skill, one's temper etc)
安检	security check (abbr. for 安全檢查|安全检查[an1 quan2 jian3 cha2]); to do a security check
出圈	to remove manure from a cowshed or pigsty etc (for use as fertilizer); to muck out
补充	to replenish; to supplement; to complement; additional; supplementary; CL:個|个[ge4]
不好意思	to feel embarrassed; to find it embarrassing; to be sorry (for inconveniencing sb)
到底	finally; in the end; when all is said and done; after all; to the end; to the last
运动	to move; to exercise; sports; exercise; motion; movement; campaign; CL:場|场[chang3]
发票	invoice; receipt; bill; uniform invoice (abbr. for 統一發票|统一发票[tong3 yi1 fa1 piao4])
汉字	Chinese character; CL:個|个[ge4]; Japanese: kanji; Korean: hanja; Vietnamese: hán tự
出行	to go out somewhere (relatively short trip); to set off on a journey (longer trip)
马	horse; CL:匹[pi3]; horse or cavalry piece in Chinese chess; knight in Western chess
称心如意	(idiom) after one's own heart; gratifying; satisfactory; everything one could wish
可见	it can clearly be seen (that this is the case); it is (thus) clear; clear; visible
工程	engineering; an engineering project; project; undertaking; CL:個|个[ge4],項|项[xiang4]
改装	to change one's costume; to repackage; to remodel; to refit; to modify; to convert
光线	light ray; CL:條|条[tiao2],道[dao4]; light; illumination; lighting (for a photograph)
含义	meaning (implicit in a phrase); implied meaning; hidden meaning; hint; connotation
骗	to cheat; to swindle; to deceive; to get on (a horse etc) by swinging one leg over
回复	to reply; to recover; to return (to a previous condition); Re: in reply to (email)
收拾	to put in order; to tidy up; to pack; to repair; (coll.) to sort sb out; to fix sb
空间	space; room; (fig.) scope; leeway; (astronomy) outer space; (physics, math.) space
亏	deficiency; deficit; luckily; it's lucky that...; (often ironically) fancy that...
流动	to flow; to circulate; to go from place to place; to be mobile; (of assets) liquid
停车	to pull up (stop one's vehicle); to park; (of a machine) to stop working; to stall
支持	to be in favor of; to support; to back; support; backing; to stand by; CL:個|个[ge4]
公安局	public security bureau (government office similar in function to a police station)
使得	usable; serviceable; feasible; workable; doable; to make; to cause; to bring about
提示	to point out; to remind (sb of sth); to suggest; suggestion; tip; reminder; notice
做法	way of handling sth; method for making; work method; recipe; practice; CL:個|个[ge4]
相处	to be in contact (with sb); to associate; to interact; to get along (well, poorly)
还原	to restore to the original state; to reconstruct (an event); reduction (chemistry)
物业	property; real estate; abbr. for 物業管理|物业管理[wu4 ye4 guan3 li3], property management
嬌羞	adj. Bashful. This Internet slang term is often used humorously to describe males.
急功近利	seeking instant benefit (idiom); shortsighted vision, looking only for fast return
家伙	household dish, implement or furniture; domestic animal; (coll.) guy; chap; weapon
终点	the end; end point; finishing line (in a race); destination; terminus; CL:個|个[ge4]
转化	to change; to turn; to convert; (genetics) to transform; (chemistry) isomerization
论证	to prove a point; to expound on; to demonstrate or prove (through argument); proof
确信	to be convinced; to be sure; to firmly believe; to be positive that; definite news
报销	to submit an expense account; to apply for reimbursement; to write off; to wipe out
大小	large and small; size; adults and children; consideration of seniority; at any rate
超	to exceed; to overtake; to surpass; to transcend; to pass; to cross; ultra-; super-
待	to wait; to treat; to deal with; to need; going to (do sth); about to; intending to
交流	to exchange; exchange; communication; interaction; to have social contact (with sb)
集中	to concentrate; to centralize; to focus; centralized; concentrated; to put together
紧张	nervous; keyed up; intense; tense; strained; in short supply; scarce; CL:陣|阵[zhen4]
只	classifier for birds and certain animals, one of a pair, some utensils, vessels etc
复苏	variant of 復甦|复苏[fu4 su1]; to recover (health, economic); to resuscitate; anabiosis
官	government official; governmental; official; public; organ of the body; CL:個|个[ge4]
露馅	to leak; to expose (sb's secret); to spill the beans; to let the cat out of the bag
上边	the top; above; overhead; upwards; the top margin; above-mentioned; those higher up
宫	palace; temple; castration (as corporal punishment); first note in pentatonic scale
背鍋俠	n. Carry+wok+knight. Scapegoat. This Internet slang term derives from 背鍋 [bēi guō].
响	echo; sound; noise; to make a sound; to sound; to ring; loud; classifier for noises
阳光	sunshine; (of personality) upbeat; energetic; transparent (open to public scrutiny)
反思	to think back over sth; to review; to revisit; to rethink; reflection; reassessment
牵	to lead along; to pull (an animal on a tether); (bound form) to involve; to draw in
失误	lapse; mistake; to make a mistake; fault; service fault (in volleyball, tennis etc)
只	classifier for birds and certain animals, one of a pair, some utensils, vessels etc
实践	practice; to put into practice; to live up to (a promise); to carry out (a project)
伟大	huge; great; grand; worthy of the greatest admiration; important (contribution etc)
想不到	unexpected; hard to imagine; it had not occurred to me; who could have thought that
空前绝后	unprecedented and never to be duplicated; the first and the last; unmatched; unique
名副其实	not just in name only, but also in reality (idiom); aptly named; worthy of the name
徘徊	to pace back and forth; to dither; to hesitate; (of sales figures etc) to fluctuate
贫乏	impoverished; lacking; deficient; limited; meager; impoverishment; lack; deficiency
上进	to make progress; to do better; fig. ambitious to improve oneself; to move forwards
把握	to grasp (also fig.); to seize; to hold; assurance; certainty; sure (of the outcome)
安置	to find a place for; to help settle down; to arrange for; to get into bed; placement
不敢当	lit. I dare not (accept the honor); fig. I don't deserve your praise; you flatter me
放	to put; to place; to release; to free; to let go; to let out; to set off (fireworks)
工作	to work; (of a machine) to operate; job; work; task; CL:個|个[ge4],份[fen4],項|项[xiang4]
负责	to be responsible for; to be in charge of; to bear responsibility for; conscientious
感情	emotion; sentiment; affection; feelings between two persons; CL:個|个[ge4],種|种[zhong3]
单元	unit (forming an entity); element; (in a residential building) entrance or staircase
联系	connection; contact; relation; to get in touch with; to integrate; to link; to touch
记录	to record; record (written account); note-taker; record (in sports etc); CL:個|个[ge4]
打量	to size sb up; to look sb up and down; to take the measure of; to suppose; to reckon
遏制	to check; to contain; to hold back; to keep within limits; to constrain; to restrain
秩序	order (orderly); order (sequence); social order; the state (of society); CL:個|个[ge4]
综合	comprehensive; composite; synthesized; mixed; to sum up; to integrate; to synthesize
收养	to take in and care for (an elderly person, a dog etc); to adopt (a child); adoption
狠心	callous; heartless; to resolve (to do sth); firm resolve (as in 下狠心[xia4 hen3 xin1])
废话	nonsense; rubbish; superfluous words; You don't say!; No kidding! (gently sarcastic)
哏	old variant of 狠[hen3]; old variant of 很[hen3]; also used as an exclamation of anger
牺牲	to sacrifice one's life; to sacrifice (sth valued); beast slaughtered as a sacrifice
新兴	(of markets, industries, infectious diseases etc) rising; emerging; in the ascendant
节制	to control; to restrict; to moderate; to temper; moderation; sobriety; to administer
一时	a period of time; a while; for a short while; temporary; momentary; at the same time
资源	natural resource (such as water or minerals); resource (such as manpower or tourism)
拘束	to restrict; to restrain; constrained; awkward; ill at ease; uncomfortable; reticent
开朗	spacious and well-lit; open and clear; (of character) optimistic; cheerful; carefree
武侠	martial arts chivalry (Chinese literary, theatrical and cinema genre); knight-errant
宝贝	treasured object; treasure; darling; baby; cowry; good-for-nothing or queer character
掰	to break off or break open sth with one's hands; (fig.) to break off (a relationship)
不仅	not just; not limited to; (as a correlative conjunction) not only (..., but also ...)
底	background; bottom; base; end (of the month, year etc); remnants; (math.) radix; base
换	to exchange; to change (clothes etc); to substitute; to switch; to convert (currency)
递	to hand over; to pass on; to deliver; (bound form) progressively; in the proper order
变质	to degenerate; to deteriorate; (of food) to go bad; to go off; (geology) metamorphism
冲突	conflict; to conflict; clash of opposing forces; collision (of interests); contention
决定	to decide (to do something); to resolve; decision; CL:個|个[ge4],項|项[xiang4]; certainly
读音	pronunciation; literary (rather than colloquial) pronunciation of a Chinese character
影响	influence; effect; to influence; to affect (usually adversely); to disturb; CL:股[gu3]
理发	to get a haircut; to have one's hair done; to cut (sb's) hair; to give (sb) a haircut
架	to support; frame; rack; framework; classifier for planes, large vehicles, radios etc
過氣網紅	n. Has-been+Internet celebrity. A former Internet celebrity who is no longer popular.
景	(bound form) scenery; circumstance; situation; scene (of a play); (literary) sunlight
目光	gaze; (fig.) attention; expression in one's eyes; look; (lit. and fig.) sight; vision
养	to raise (animals); to bring up (children); to keep (pets); to support; to give birth
舌头	tongue; CL:個|个[ge4]; enemy soldier captured for the purpose of extracting information
文字	character; script; writing; written language; writing style; phraseology; CL:個|个[ge4]
话筒	microphone; (telephone) receiver; handset; megaphone; (fig.) mouthpiece; spokesperson
碎碎唸	v. Fragmented+fragmented+talk. 1) To chatter/prattle/jabber; 2) to nag; 3) to mutter.
机动	locomotive; motorized; power-driven; adaptable; flexible (use, treatment, timing etc)
嫌	to dislike; suspicion; resentment; enmity; abbr. for 嫌犯[xian2 fan4], criminal suspect
较量	to pit oneself against sb; to compete with sb; contest; battle; to haggle; to quibble
灭亡	to be destroyed; to become extinct; to perish; to die out; to destroy; to exterminate
屈服	to surrender; to succumb; to yield; (as a transitive verb) to defeat; to prevail over
泰斗	(abbr. for 泰山北斗[Tai4 Shan1 Bei3 dou3]) distinguished figure; doyen; revered authority
心眼儿	one's thoughts; mind; intention; willingness to accept new ideas; baseless suspicions
隐患	a danger concealed within sth; hidden damage; misfortune not visible from the surface
报	to announce; to inform; report; newspaper; recompense; revenge; CL:份[fen4],張|张[zhang1]
包袱	wrapping cloth; a bundle wrapped in cloth; load; weight; burden; funny part; punchline
后面	the back; the rear; the last bit; behind; near the end; at the back; later; afterwards
冬叔	n. Uncle Dong. This Internet slang term is a nickname for Chinese actress Zhou Dongyu.
处分	to discipline sb; to punish; disciplinary action; to deal with (a matter); CL:個|个[ge4]
后边	the back; the rear; the last bit; behind; near the end; at the back; later; afterwards
厚	thick; deep or profound; kind; generous; rich or strong in flavor; to favor; to stress
贷款	a loan; CL:筆|笔[bi3]; to provide a loan (e.g. bank); to raise a loan (from e.g. a bank)
海	ocean; sea; CL:個|个[ge4],片[pian4]; great number of people or things; (dialect) numerous
口语	colloquial speech; spoken language; vernacular language; slander; gossip; CL:門|门[men2]
科学	science; scientific knowledge; scientific; rational; CL:門|门[men2],個|个[ge4],種|种[zhong3]
一定	surely; certainly; necessarily; fixed; a certain (extent etc); given; particular; must
炸裂	adj. Explode+shatter. [Of one’s acting, singing, writing, etc.] awesome, breathtaking.
中间	the middle; the inside; in the middle; within; between; among; during; in the meantime
私貨	n. Personal+goods. Personal opinion that might not be liked by the readers or viewers.
磋商	to consult; to discuss seriously; to negotiate; to confer; negotiations; consultations
紧	tight; strict; close at hand; near; urgent; tense; hard up; short of money; to tighten
名	name; noun (part of speech); place (e.g. among winners); famous; classifier for people
就是	exactly; precisely; only; simply; just; (used correlatively with 也[ye3]) even; even if
辛苦	exhausting; hard; tough; arduous; to work hard; to go to a lot of trouble; hardship(s)
群嘲	(neologism c. 2011) to deride a group of people; (of a group of people) to deride (sb)
扇	fan; sliding, hinged or detachable flat part of sth; classifier for doors, windows etc
以外	apart from; other than; except for; external; outside of; on the other side of; beyond
又叒叕	adv. Again + Again×3 + Again×4. This Internet slang term emphasizes a recurring event.
外面	outside (also pr. [wai4 mian5] for this sense); surface; exterior; external appearance
现实	reality; actuality; real; actual; realistic; pragmatic; materialistic; self-interested
疼痛	pain; (of a body part) to be painful; to be sore; to hurt; (of a person) to be in pain
五星	the five visible planets, namely: Mercury 水星, Venus 金星, Mars 火星, Jupiter 木星, Saturn 土星
结晶	to crystallize; crystallization; crystal; crystalline; (fig.) the fruit (of labor etc)
颈椎	cervical vertebra; the seven cervical vertebrae in the neck of humans and most mammals
飘	to float (in the air); to flutter; to waft; complacent; frivolous; weak; shaky; wobbly
元素	element (key component of sth); (chemistry) element; (math.) element (member of a set)
专利	patent; sth uniquely enjoyed (or possessed etc) by a certain group of people; monopoly
招待	to hold a reception; to offer hospitality; to entertain (guests); to serve (customers)
日新月异	daily renewal, monthly change (idiom); every day sees new developments; rapid progress
应酬	to engage in social activities; to socialize; dinner party; banquet; social engagement
沾光	to bask in the light; fig. to benefit from association with sb or sth; reflected glory
周边	periphery; rim; surroundings; all around; perimeter; peripheral (computing); spin-offs
表演	play; show; performance; exhibition; to perform; to act; to demonstrate; CL:場|场[chang3]
不通	to be obstructed; to be blocked up; to be impassable; to make no sense; to be illogical
曾经	once; already; former; previously; ever; (past tense marker used before verb or clause)
层面	aspect; facet; level (political, psychological, spiritual etc); (geology) bedding plane
找	to try to find; to look for; to call on sb; to find; to seek; to return; to give change
池子	pond; bathhouse pool; dance floor of a ballroom; (old) stalls (front rows in a theater)
广播	broadcast; CL:個|个[ge4]; broadcasting; to broadcast; (formal) to propagate; to publicize
楼	house with more than 1 story; storied building; floor; CL:層|层[ceng2],座[zuo4],棟|栋[dong4]
要求	to request; to require; requirement; to stake a claim; to ask; to demand; CL:點|点[dian3]
反问	to ask (a question) in reply; to answer a question with a question; rhetorical question
风暴	storm; violent commotion; fig. crisis (e.g. revolution, uprising, financial crisis etc)
却	but; yet; however; while; to go back; to decline; to retreat; nevertheless; even though
文章	article; essay; literary works; writings; hidden meaning; CL:篇[pian1],段[duan4],頁|页[ye4]
虽然	although; even though (often used correlatively with 可是[ke3 shi4] or 但是[dan4 shi4] etc)
沸腾	(of a liquid) to boil; (of sentiments etc) to boil over; to flare up; to be impassioned
嘛	modal particle indicating that sth is obvious; particle indicating a pause for emphasis
哎	hey!; (interjection used to attract attention or to express surprise or disapprobation)
去掉	to get rid of; to exclude; to eliminate; to remove; to delete; to strip out; to extract
束	to bind; bunch; bundle; classifier for bunches, bundles, beams of light etc; to control
撞臉	v. Face+bump. This Internet slang term is often used to describe celebrity look-alikes.
替	to substitute for; to take the place of; to replace; for; on behalf of; to stand in for
团长	regimental command; head of a delegation; group buy organizer; group-buying coordinator
歇	to rest; to take a break; to stop; to halt; (dialect) to sleep; a moment; a short while
占有	to have; to own; to hold; to occupy; to possess; to account for (a high proportion etc)
开支	expenditures; expenses (CL:筆|笔[bi3], 項|项[xiang4]); to spend money; (coll.) to pay wages
指数	(numerical, statistical) index; (math.) exponent; index; exponential (function, growth)
抹杀	to erase; to cover traces; to obliterate evidence; to expunge; to blot out; to suppress
内涵	meaningful content; implication; (semantics) connotation; inner qualities (of a person)
忍耐	to endure; to bear with; to exercise patience; to restrain oneself; patience; endurance
书记	secretary (chief official of a branch of a socialist or communist party); clerk; scribe
爱好	to like; to be fond of; to take pleasure in; to be keen on; interest; hobby; CL:個|个[ge4]
杯	variant of 杯[bei1]; trophy cup; classifier for certain containers of liquids: glass, cup
标准	standard; norm; criterion; (adjective) standard; good; correct; conforming to a standard
拍磚	v. To hit with a brick. To lambaste someone online as if hitting him or her with bricks.
不足	insufficient; lacking; deficiency; not enough; inadequate; not worth; cannot; should not
沉	to submerge; to immerse; to sink; to keep down; to lower; to drop; deep; profound; heavy
干杯	to drink a toast; Cheers! (proposing a toast); Here's to you!; Bottoms up!; lit. dry cup
坐	to sit; to take a seat; to take (a bus, airplane etc); to bear fruit; variant of 座[zuo4]
反复	repeatedly; over and over; to upend; unstable; to come and go; (of an illness) to return
更新	to replace the old with new; to renew; to renovate; to upgrade; to update; to regenerate
联络	to get in touch with; to contact; to stay in contact (with); liaison; (math.) connection
生词	new word (in textbook); word that is unfamiliar or not yet studied; CL:組|组[zu3],個|个[ge4]
強排	v. Strongly+stand [behind you]. To strongly agree with [you]. To strongly support [you].
以	to use; by means of; according to; in order to; because of; at (a certain date or place)
反射	to reflect; reflection (from a mirror etc); reflex (i.e. automatic reaction of organism)
栏目	regular column or segment (in a publication or broadcast program); program (TV or radio)
露	dew; syrup; nectar; outdoors (not under cover); to show; to reveal; to betray; to expose
剩男	n. Leftover men. A sexist Internet slang term referring to single men over 30 years old.
逆襲	v./n. To counterattack, to reverse the score, to catch up and eventually taking the lead
为此	for this reason; with regards to this; in this respect; in order to do this; to this end
族	race; nationality; ethnicity; clan; by extension, social group (e.g. office workers 上班族)
凝聚	to condense; to coagulate; coacervation (i.e. form tiny droplets); aggregation; coherent
萝卜	radish (Raphanus sativus), esp. white radish 白蘿蔔|白萝卜[bai2 luo2 bo5]; CL:個|个[ge4],根[gen1]
眼神	expression or emotion showing in one's eyes; meaningful glance; wink; eyesight (dialect)
转折	shift in the trend of events; turnaround; plot shift in a book; turn in the conversation
着想	to give thought (to others); to consider (other people's needs); also pr. [zhao2 xiang3]
案例	case (of fraud, hepatitis, international cooperation etc); instance; example; CL:個|个[ge4]
些	classifier indicating a small amount or small number greater than 1: some, a few, several
踩	to step on; to tread; to stamp; to press a pedal; to pedal (a bike); (online) to downvote
出门	to go out; to leave home; to go on a journey; away from home; (of a woman) to get married
倡导	to advocate; to initiate; to propose; to be a proponent of (an idea or school of thought)
可能	might (happen); possible; probable; possibility; probability; maybe; perhaps; CL:個|个[ge4]
好看	good-looking; nice-looking; good (of a movie, book, TV show etc); embarrassed; humiliated
浇	to pour liquid; to irrigate (using waterwheel); to water; to cast (molten metal); to mold
闊以	v. Can, able to. This Internet slang term is a humorous phonetic deviation of 可以 [kě yǐ].
斷眉	n. Broken eyebrow. This Internet slang term is an affectionate nickname for Charlie Puth.
一旦	in case (sth happens); if; once (sth happens, then...); when; in a short time; in one day
灭	to extinguish or put out; to go out (of a fire etc); to exterminate or wipe out; to drown
人家	other people; sb else; he, she or they; I, me (referring to oneself as "one" or "people")
升级	to go up by one grade; to be promoted; to escalate (in intensity); (computing) to upgrade
假一赔十	lit. if one is fake, I shall compensate you for ten of them; fig. (of goods) 100% genuine
归纳	to sum up; to summarize; to conclude from facts; induction (method of deduction in logic)
蠢萌	adj. Adorkable. Both dorky/silly and adorable. This Internet slang term is used lovingly.
喇叭	horn (automobile etc); loudspeaker; brass wind instrument; trumpet; suona 鎖吶|锁呐[suo3 na4]
乐意	to be willing to do sth; to be ready to do sth; to be happy to do sth; content; satisfied
投掷	to throw sth a long distance; to hurl; to throw at; to throw (dice etc); to flip (a coin)
肖像	portrait (painting, photo etc); (in a general sense) representation of a person; likeness
验证	to inspect and verify; experimental verification; to validate (a theory); to authenticate
不怎么样	not up to much; very indifferent; nothing great about it; nothing good to be said about it
承认	to admit; to concede; to recognize; recognition (diplomatic, artistic etc); to acknowledge
担任	to hold a governmental office or post; to assume office of; to take charge of; to serve as
配一臉	n. Match+a+face. [Of two things or two people] looking great together, totally compatible.
憋	to choke; to stifle; to restrain; to hold back; to hold in (urine); to hold (one's breath)
空调	air conditioning; air conditioner (including units that have a heating mode); CL:臺|台[tai2]
得以	able to; so that sb can; enabling; in order to; finally in a position to; with sth in view
持久	lasting; enduring; persistent; permanent; protracted; endurance; persistence; to last long
商场	shopping mall; shopping center; department store; emporium; CL:家[jia1]; the business world
轻松	light; gentle; relaxed; effortless; uncomplicated; to relax; to take things less seriously
吊打	to hang sb up and beat him; (fig.) (slang) to own (one's opponent); to thoroughly dominate
净	clean; completely; only; net (income, exports etc); (Chinese opera) painted face male role
E神	n. E+deity. A nickname for Eason Chan, a Hong Kong singer, because it sounds like “Eason.”
密切	close; familiar; intimate; closely (related); to foster close ties; to pay close attention
重点	important point; main point; focus; key (project etc); to focus on; to put the emphasis on
鍾黑	n. Chung+black. Wallace Chung detractors. People who disparage Wallace Chung and his fans.
特	special; unique; distinguished; especially; unusual; very; abbr. for 特克斯[te4 ke4 si1], tex
无奈	to have no alternative; frustrated; exasperated; helpless; (conjunction) but unfortunately
协调	to coordinate; to harmonize; to fit together; to match (colors etc); harmonious; concerted
撕逼	(slang) (lit.) to tear cunt; (fig.) (of females) to have a catfight; to have a bitch fight
运作	to operate; operations; workings; activities (usu. of an organization); thread (computing)
要命	to cause sb's death; extremely; terribly; (used in complaining about sth) to be a nuisance
爱	to love; to be fond of; to like; affection; to be inclined (to do sth); to tend to (happen)
棒	stick; club; cudgel; smart; capable; strong; wonderful; classifier for legs of a relay race
才	(variant of 才[cai2]) just now; (variant of 才[cai2]) (before an expression of quantity) only
洗	to wash; to bathe; to develop (photographs); to shuffle (cards etc); to erase (a recording)
出入	to go out and come in; entrance and exit; expenditure and income; discrepancy; inconsistent
定期	at set dates; at regular intervals; periodic; limited to a fixed period of time; fixed term
进行	to advance; to conduct; underway; in progress; to do; to carry out; to carry on; to execute
反映	to mirror; to reflect; mirror image; reflection; (fig.) to report; to make known; to render
粑粑	n. Poo. Dad. This Internet slang term means “dad”. It mimics the Taiwanese Mandarin accent.
山	mountain; hill (CL:座[zuo4]); (coll.) small bundle of straw for silkworms to spin cocoons on
膩害	n. Awesome. This Internet slang term mimics the Taiwanese Mandarin accent for comic effect.
阴暗	dim; dark; overcast; darkness; shadow; (fig.) dismal; gloomy; somber; murky; shadowy (side)
降温	to become cooler; to lower the temperature; cooling; (of interest, activity etc) to decline
集	to gather; to collect; collected works; classifier for sections of a TV series etc: episode
对照	to contrast; to compare; to place side by side for comparison (as parallel texts); to check
民间	among the people; popular; folk; non-governmental; involving people rather than governments
末	tip; end; final stage; latter part; inessential detail; powder; dust; opera role of old man
普及	to spread extensively; to generalize; widespread; popular; universal; ubiquitous; pervasive
背鍋	v. Carry+wok. 1) To be made the scapegoat. 2) To bear the blame for someone else’s mistake.
狗帶	v. Dog leash. The Internet term sounds like “go die” in English and serves as an expletive.
体会	to know from experience; to learn through experience; to realize; understanding; experience
组	to form; to organize; group; team; classifier for sets, series, groups of people, batteries
悬	to hang or suspend; to worry; public announcement; unresolved; baseless; without foundation
愣	to look distracted; to stare blankly; distracted; blank; (coll.) unexpectedly; rash; rashly
流浪	to drift about; to wander; to roam; nomadic; homeless; unsettled (e.g. population); vagrant
浓厚	dense; thick (fog, clouds etc); to have a strong interest in; deep; fully saturated (color)
亲热	affectionate; intimate; warmhearted; to show affection for; (coll.) to get intimate with sb
介绍	to introduce (sb to sb); to give a presentation; to present (sb for a job etc); introduction
角	role (theater); to compete; ancient three legged wine vessel; third note of pentatonic scale
记	to record; to note; to memorize; to remember; mark; sign; classifier for blows, kicks, shots
封	to confer; to grant; to bestow a title; to seal; classifier for sealed objects, esp. letters
划	to delimit; to transfer; to assign; to plan; to draw (a line); stroke of a Chinese character
封	to confer; to grant; to bestow a title; to seal; classifier for sealed objects, esp. letters
毒唯	fan of one particular member of a pop idol band who denigrates and defames the other members
迪士尼	Disney (company name, surname); Walt Disney (1901-1966), American animator and film producer
拿出	to take out; to put out; to provide; to put forward (a proposal); to come up with (evidence)
决心	determination; resolution; determined; firm and resolute; to make up one's mind; CL:個|个[ge4]
汤	soup; hot or boiling water; decoction of medicinal herbs; water in which sth has been boiled
剧	theatrical work (play, opera, TV series etc); dramatic (change, increase etc); acute; severe
牛	ox; cow; bull; CL:條|条[tiao2],頭|头[tou2]; newton (abbr. for 牛頓|牛顿[niu2 dun4]); (slang) awesome
完善	(of systems, facilities etc) comprehensive; well-developed; excellent; to refine; to improve
追星狗	n. Star-chasing dogs. Fanatic fans [of artists and entertainers such as singers and actors].
燃	to burn; to ignite; to light; fig. to spark off (hopes); to start (debate); to raise (hopes)
夸张	to exaggerate; overstated; exaggerated; hyperbole; (coll.) excessive; ridiculous; outrageous
牛	ox; cow; bull; CL:條|条[tiao2],頭|头[tou2]; newton (abbr. for 牛頓|牛顿[niu2 dun4]); (slang) awesome
闯	to rush; to charge; to dash; to break through; to temper oneself (through battling hardships)
有	to have; there is; (bound form) having; with; -ful; -ed; -al (as in 有意[you3 yi4] intentional)
份	classifier for gifts, newspaper, magazine, papers, reports, contracts etc; variant of 分[fen4]
聲控	n. Voice+freak. One who is easily attracted to people (of the opposite sex) with nice voices.
不得已	to act against one's will; to have no alternative but to; to have to; to have no choice; must
调动	to transfer; to maneuver (troops etc); movement of personnel; to mobilize; to bring into play
可怕	awful; dreadful; fearful; formidable; frightful; scary; hideous; horrible; terrible; terribly
化	to make into; to change into; -ization; to ... -ize; to transform; abbr. for 化學|化学[hua4 xue2]
环保	environmental protection; environmentally friendly; abbr. for 環境保護|环境保护[huan2 jing4 bao3 hu4]
白起	Bai Qi (-258 BC), famous general of Qin 秦國|秦国, the victor at 長平|长平 in 260 BC; same as 公孫起|公孙起
听写	(of a pupil) to write down (in a dictation exercise); dictation; (music) to transcribe by ear
雙標	n./adj. Double standard. This Internet slang term is short for 雙重標準 [shuāng chóng biāo zhǔn].
有	to have; there is; (bound form) having; with; -ful; -ed; -al (as in 有意[you3 yi4] intentional)
启动	to start (a machine); (fig.) to set in motion; to launch (an operation); to activate (a plan)
入门	entrance door; to enter a door; introduction (to a subject); to learn the basics of a subject
受	to receive; to accept; to suffer; subjected to; to bear; to stand; pleasant; (passive marker)
油	oil; fat; grease; petroleum; to apply tung oil, paint or varnish; oily; greasy; glib; cunning
有	to have; there is; (bound form) having; with; -ful; -ed; -al (as in 有意[you3 yi4] intentional)
献	to offer; to present; to dedicate; to donate; to show; to put on display; worthy person (old)
荤	strong-smelling vegetable (garlic etc); non-vegetarian food (meat, fish etc); vulgar; obscene
急于求成	anxious for quick results (idiom); to demand instant success; impatient for result; impetuous
只见	to see (the same thing) over and over again; to see, to one's surprise, (sth happen suddenly)
粒	grain; granule; classifier for small round things (peas, bullets, peanuts, pills, grains etc)
蓬荜生辉	Your presence brings light to my humble dwelling; see also 蓬蓽生光|蓬荜生光[peng2 bi4 sheng1 guang1]
体面	dignity; prestige; face; honorable; creditable; (of sb's appearance) presentable; respectable
胸怀	one's bosom (the seat of emotions); breast; broad-minded and open; to think about; to cherish
出来	(after a verb, indicates coming out, completion of an action, or ability to discern or detect)
闭塞	to stop up; to close up; hard to get to; out of the way; inaccessible; unenlightened; blocking
解决	to solve; to resolve; to settle (a problem); to eliminate; to wipe out (an enemy, bandits etc)
扶	to support with the hand; to help sb up; to support oneself by holding onto something; to help
放下	to lay down; to put down; to let go of; to relinquish; to set aside; to lower (the blinds etc)
沉淀	(chemistry) to settle; to precipitate; (chemistry) sediment; precipitate; (fig.) to accumulate
负	to bear; to carry (on one's back); to turn one's back on; to be defeated; negative (math. etc)
普通话	Mandarin (common language); Putonghua (common speech of the Chinese language); ordinary speech
生命	life (as the characteristic of living beings); living being; creature (CL:個|个[ge4],條|条[tiao2])
閃	v. Literally “flash,” this Internet slang term means to leave swiftly, to beat a hasty retreat
男友力	(coll.) attractiveness (as a potential boyfriend); degree to which one is "boyfriend material"
燒腦	adj. Burn+brain. Brain-scorching. This Internet slang term means “intellectually challenging”.
節操	n. Scruples, moral principles, integrity. This slang term is often used in teasing and joking.
乡	country or countryside; native place; home village or town; township (PRC administrative unit)
礼尚往来	lit. proper behavior is based on reciprocity (idiom); fig. to return politeness for politeness
力所能及	as far as one's capabilities extend (idiom); to the best of one's ability; within one's powers
履行	to fulfill (one's obligations); to carry out (a task); to implement (an agreement); to perform
職業假笑	n. Professional fake smile. This Internet slang term is used to describe one’s insincere smile.
编织	to weave; to knit; to plait; to braid; (fig.) to create (sth abstract, e.g. a dream, a lie etc)
怀疑	to doubt (sth); to be skeptical of; to have one's doubts; to harbor suspicions; to suspect that
拉	to pull; to play (a bowed instrument); to drag; to draw; to chat; (coll.) to empty one's bowels
用	to use; to employ; to have to; to eat or drink; expense or outlay; usefulness; hence; therefore
张	to open up; to spread; sheet of paper; classifier for flat objects, sheet; classifier for votes
着急	to worry; to feel anxious; to feel a sense of urgency; to be in a hurry; Taiwan pr. [zhao1 ji2]
麻烦	trouble; inconvenience; inconvenient; troublesome; annoying; to bother sb; to put sb to trouble
气候	(meteorology) climate; (fig.) climate; prevailing conditions (in human affairs); CL:種|种[zhong3]
甜茶	n. Sweet tea. This Internet slang term is an affectionate nickname for actor Timothée Chalamet.
两手	one's two hands; two prongs (of a strategy); both aspects, eventualities etc; skills; expertise
简体字	simplified Chinese character, as opposed to traditional Chinese character 繁體字|繁体字[fan2 ti3 zi4]
碾壓	v. To mash [someone]. To defeat someone with an obvious advantage in intelligence, wealth, etc.
遇	(bound form) to encounter; to happen upon; to meet unplanned; (bound form) to treat; to receive
中华民族	the Chinese nation; the Chinese people (collective reference to all the ethnic groups in China)
漂浮	to float; to hover; to drift (also fig., to lead a wandering life); to rove; showy; superficial
发病	(of an illness) to occur; (of a person) to get sick; to fall ill; onset (of a medical condition)
社會	adj. Worldly, sophisticated, street-smart. This Internet slang term is often used sarcastically.
撩騷	v. titillate+sex appeal. This Internet slang term refers to flirting with or hitting on someone.
剪	scissors; shears; clippers; CL:把[ba3]; to cut with scissors; to trim; to wipe out or exterminate
师傅	master; qualified worker; respectful form of address for older men; CL:個|个[ge4],位[wei4],名[ming2]
受到	to receive (praise, an education, punishment etc); to be ...ed (praised, educated, punished etc)
配	to join; to fit; to mate; to mix; to match; to deserve; to make up (a prescription); to allocate
外卖	(of a restaurant) to provide a takeout or home delivery meal; takeout (business); takeout (meal)
散	to scatter; to break up (a meeting etc); to disperse; to disseminate; to dispel; (coll.) to sack
和解	to settle (a dispute out of court); to reconcile; settlement; conciliation; to become reconciled
踏实	firmly-based; steady; steadfast; to have peace of mind; free from anxiety; Taiwan pr. [ta4 shi2]
腐女	fujoshi (woman who likes manga about male homosexual love) (derived from Japanese 腐女子 "fujoshi")
主张	to advocate; to stand for; view; position; stand; proposition; viewpoint; assertion; CL:個|个[ge4]
游行	to march; to parade; to demonstrate; procession; march; demonstration; to travel around; to roam
只顾	solely preoccupied (with one thing); engrossed; focusing (on sth); to look after only one aspect
启示	to reveal; to enlighten; enlightenment; revelation; illumination; moral (of a story etc); lesson
一帆风顺	propitious wind throughout the journey (idiom); plain sailing; to go smoothly; have a nice trip!
保养	to take good care of (or conserve) one's health; to keep in good repair; to maintain; maintenance
除	to get rid of; to remove; to exclude; to eliminate; to wipe out; to divide; except; not including
分组	to divide into groups; group (formed from a larger group); subgroup; (computer networking) packet
定位	to orientate; to position; to categorize (as); to characterize (as); positioning; position; niche
麻麻	n. Sackcloth. Mom. This Internet slang term means “mom”. It mimics the Taiwanese Mandarin accent.
故障	malfunction; breakdown; defect; shortcoming; fault; failure; impediment; error; bug (in software)
十分	very; completely; utterly; extremely; absolutely; hundred percent; to divide into ten equal parts
墙	wall (CL:面[mian4],堵[du3]); (slang) to block (a website) (usu. in the passive: 被牆|被墙[bei4 qiang2])
惹	to provoke; to irritate; to vex; to stir up; to anger; to attract (troubles); to cause (problems)
启事	announcement (written, on billboard, letter, newspaper or website); to post information; a notice
相机	camera (abbr. for 照相機|照相机[zhao4 xiang4 ji1]); at the opportune moment; as the circumstances allow
懶癌	n. Laziness cancer. This Internet term is used to describe one’s procrastination or slothfulness.
铁	iron (metal); arms; weapons; hard; strong; violent; unshakeable; determined; close; tight (slang)
微信	Weixin or WeChat (mobile text and voice messaging service developed by Tencent 騰訊|腾讯[Teng2 xun4])
一路	the whole journey; all the way; going the same way; going in the same direction; of the same kind
争论	to argue; to debate; to contend; argument; contention; controversy; debate; CL:次[ci4],場|场[chang3]
准	accurate; standard; definitely; certainly; about to become (bride, son-in-law etc); quasi-; para-
糟蹋	to waste; to defile; to abuse; to insult; to defile; to trample on; to wreck; also pr. [zao1 ta5]
爱不释手	(idiom) to like sth so much that one is reluctant to put it down; to find sth utterly irresistible
哪儿	where?; wherever; anywhere; somewhere; (used in rhetorical questions) how can ...?; how could ...?
保管	to hold in safekeeping; to have in one's care; to guarantee; certainly; surely; custodian; curator
调查	investigation; inquiry; to investigate; to survey; survey; (opinion) poll; CL:項|项[xiang4],個|个[ge4]
出路	a way out (lit. and fig.); opportunity for advancement; a way forward; outlet (for one's products)
建议	to propose; to suggest; to recommend; proposal; suggestion; recommendation; CL:個|个[ge4],點|点[dian3]
整段垮掉	[One of Xue Zhiqian’s pet phrases] The whole segment collapses. This expression means “Epic fail!”
没什么	it doesn't matter; it's nothing; never mind; think nothing of it; it's my pleasure; you're welcome
举	to lift; to hold up; to cite; to enumerate; to act; to raise; to choose; to elect; act; move; deed
封闭	to close; to seal off; to close down (an illegal venue); closed (i.e. isolated from outside input)
隔	to separate; to partition; to stand or lie between; at a distance from; after or at an interval of
初代	adj. [Of someone or something] the first generation. This Internet slang term comes from Japanese.
狠	ruthless; fierce; ferocious; determined; resolute; to harden (one's heart); old variant of 很[hen3]
下课	to finish class; to get out of class; (fig.) (esp. of a sports coach) to be dismissed; to be fired
胖友	n. Fat+friend. Friend. This Internet slang term is a phonetic deviation of 朋友 [péng yǒu] “friend.”
左	left; the Left (politics); east; unorthodox; queer; wrong; differing; opposite; variant of 佐[zuo3]
预防	to prevent; to take precautions against; to protect; to guard against; precautionary; prophylactic
画蛇添足	lit. draw legs on a snake (idiom); fig. to ruin the effect by adding sth superfluous; to overdo it
齐心协力	to work with a common purpose (idiom); to make concerted efforts; to pull together; to work as one
深沉	deep; profound; (of a person) reserved; undemonstrative; (of a voice, sound etc) deep; low-pitched
挨	to suffer; to endure; to pull through (hard times); to delay; to stall; to play for time; to dawdle
聊騷	v. Chat+sex appeal. (rizz?) This Internet slang term refers to flirting with or hitting on someone.
作天作地	v. Overreact+sky+overreact+ground. To make a scene. To behave impudently and piss other people off.
部位	part (esp. of the body, but also of a vegetable, e.g. the root, or a garment, e.g. the sleeve, etc)
题	topic; problem for discussion; exam question; subject; to inscribe; to mention; CL:個|个[ge4],道[dao4]
成就	accomplishment; success; achievement; CL:個|个[ge4]; to achieve (a result); to create; to bring about
淡	insipid; diluted; weak; mild; light in color; tasteless; indifferent; (variant of 氮[dan4]) nitrogen
打击	to hit; to strike; to attack; to crack down on sth; blow; (psychological) shock; percussion (music)
教训	to provide guidance; to lecture sb; to upbraid; a talking-to; a bitter lesson; CL:番[fan1],頓|顿[dun4]
穷	poor; destitute; to use up; to exhaust; thoroughly; extremely; (coll.) persistently and pointlessly
键	key (on a piano or computer keyboard); button (on a mouse or other device); chemical bond; linchpin
金拱門	n. The golden arched door. This Internet slang term is the new official Chinese name of McDonald’s.
旁	one side; other; different; lateral component of a Chinese character (such as 刂[dao1], 亻[ren2] etc)
拼	to piece together; to join together; to stake all; adventurous; at the risk of one's life; to spell
追劇	v. Chase+drama. To binge-watch TV dramas or to keep up with the latest episodes of a new TV series.
弱	weak; feeble; young; inferior; not as good as; (following a decimal or fraction) slightly less than
室	room; work unit; grave; scabbard; family or clan; one of the 28 constellations of Chinese astronomy
飯	n. Fan.. The pinyin pronunciation of the Chinese character “rice” looks like the English word “fan”
脱离	to separate oneself from; to break away from; diastasis (medicine); abscission; abjunction (botany)
趴	to lie on one's stomach; to lean forward, resting one's upper body (on a desktop etc); (Tw) percent
新人	newcomer; fresh talent; newlywed, esp. new bride; bride and groom; (paleoanthropology) Homo sapiens
间隔	gap; interval; compartment; to divide; to separate; to leave a gap of (two weeks, three meters etc)
愿	(bound form) wish; hope; desire; to be willing; to wish (that sth may happen); may ...; vow; pledge
再生	to be reborn; to regenerate; to be a second so-and-so (famous dead person); recycling; regeneration
公寓	apartment building; block of flats (may be a public housing block or a condominium etc) (CL:套[tao4])
死宅	die-hard otaku (sb who hardly ever emerges from their home, where they play games, watch movies etc)
幹得漂亮	<Expression> Well done! This expression is sometimes used to praise well-executed pranks or repartee
好人	good person; healthy person; person who tries not to offend anyone, even at the expense of principle
使	to make; to cause; to enable; to use; to employ; to send; to instruct sb to do sth; envoy; messenger
小仙女	girl fairy; beautiful girl or young woman; (neologism) (slang) irrational and egocentric young woman
清明节	Qingming or Pure Brightness Festival or Tomb Sweeping Day, celebration for the dead (in early April)
舔屏	v. To lick the screen. To drool over the online photos or videos of sexy people or scrumptious food.
兴趣	interest (desire to know about sth); interest (thing in which one is interested); hobby; CL:個|个[ge4]
想方设法	to think up every possible method (idiom); to devise ways and means; to try this, that and the other
一丝不苟	not one thread loose (idiom); strictly according to the rules; meticulous; not one hair out of place
音响	sound; acoustics; audio; hi-fi system; stereo sound system; abbr. for 組合音響|组合音响[zu3 he2 yin1 xiang3]
白酒	baijiu, a spirit usually distilled from sorghum; (Tw) white wine (abbr. for 白葡萄酒[bai2 pu2 tao5 jiu3])
课	subject; course; CL:門|门[men2]; class; lesson; CL:堂[tang2],節|节[jie2]; to levy; tax; form of divination
读	to read out; to read aloud; to read; to attend (school); to study (a subject in school); to pronounce
炒	to sauté; to stir-fry; to speculate (in real estate etc); to scalp; to hype up; to sack; to fire (sb)
刻	quarter (hour); moment; to carve; to engrave; to cut; oppressive; classifier for short time intervals
次数	number of times; frequency; order number (in a series); power (math.); degree of a polynomial (math.)
发出	to issue (an order, decree etc); to send out; to dispatch; to produce (a sound); to let out (a laugh)
天命圈	n. Mandate of Heaven+Circle. Safe zone. This Internet slang term originated from the game Knives Out.
关注	to pay attention to; to follow sth closely; to follow (on social media); concern; interest; attention
刻	quarter (hour); moment; to carve; to engrave; to cut; oppressive; classifier for short time intervals
凑合	to bring together; to make do in a bad situation; to just get by; to improvise; passable; not too bad
悄悄	quiet; making little or no noise; surreptitious; stealthy; anxious; worried; Taiwan pr. [qiao3 qiao3]
刻	quarter (hour); moment; to carve; to engrave; to cut; oppressive; classifier for short time intervals
开关	power switch; gas valve; to open the city (or frontier) gate; to open and close; to switch on and off
盆	basin; flower pot; unit of volume equal to 12 斗[dou3] and 8 升[sheng1], approx 128 liters; CL:個|个[ge4]
出坑	v. To get out of a pit. To complete an Internet novel; to accomplish all the tasks in an online game.
小白	(slang) novice; greenhorn; (old) (slang) fool; idiot; abbr. for 小白臉|小白脸[xiao3 bai2 lian3], pretty boy
实惠	tangible benefit; material advantages; cheap; economical; advantageous (deal); substantial (discount)
內個	interj. An alternative of 那個 [nà ge] “that one. ” A common filler in Mandarin everyday conversations.
抬头	to raise one's head; to gain ground; account name, or space for writing the name on checks, bills etc
提升	to promote (to a higher-ranking position); to lift; to hoist; (fig.) to elevate; to raise; to improve
争	to strive for; to vie for; to argue or debate; deficient or lacking (dialect); how or what (literary)
飯隨愛豆	<Expression> The fans and their idols share similar qualities [in terms of personality and interests]
直播	(TV, radio) to broadcast live; live broadcast; (Internet) to livestream; (agriculture) direct seeding
招呼	to call out to; to greet; to say hello to; to inform; to take care of; to take care that one does not
苦尽甘来	bitterness finishes, sweetness begins (idiom); the hard times are over, the good times just beginning
笔记	to take down (in writing); notes; a type of literature consisting mainly of short sketches; CL:本[ben3]
曝光	to expose (photography); (fig.) to expose (a scandal); (advertising) exposure; Taiwan pr. [pu4 guang1]
太陽女神	Goddess Sun. This Internet slang term is an affectionate nickname for Chinese entertainer Xie Na. ​​​​
签	inscribed bamboo stick (used in divination, gambling, drawing lots etc); small wood sliver; label; tag
拍	to pat; to clap; to slap; to swat; to take (a photo); to shoot (a film); racket (sports); beat (music)
由	to follow; from; because of; due to; by; via; through; (before a noun and a verb) it is for ... to ...
签	inscribed bamboo stick (used in divination, gambling, drawing lots etc); small wood sliver; label; tag
行人	pedestrian; traveler on foot; passer-by; official responsible for arranging audiences with the emperor
甩鍋	v. Dump+wok. 1) To refuse to be wronged. 2) To shirk responsibility while one is actually responsible.
死忠粉	& 鐵粉 [tiě fěn] n. Dead+loyal+fan. Iron+fan. Both Internet slang terms mean “hardcore fans, stalwarts”.
消灭	to put an end to; to annihilate; to cause to perish; to perish; annihilation (in quantum field theory)
尖端	sharp pointed end; the tip; the cusp; tip-top; most advanced and sophisticated; highest peak; the best
组合	to assemble; to combine; to compose; combination; association; set; compilation; (math.) combinatorial
人事	personnel; human resources; human affairs; ways of the world; (euphemism) sexuality; the facts of life
气质	personality traits; temperament; disposition; aura; air; feel; vibe; refinement; sophistication; class
裁判	(law) to judge; to adjudicate; verdict; judgement; (sports) to referee; (sports) umpire; referee; judge
分布	to scatter; to distribute; to be distributed (over an area etc); (statistical, geographic) distribution
肥	fat; fertile; loose-fitting or large; to fertilize; to become rich by illegal means; fertilizer; manure
卡	to block; to be stuck; to be wedged; customs station; a clip; a fastener; a checkpost; Taiwan pr. [ka3]
画面	scene; tableau; picture; image; screen (displayed by a computer); (motion picture) frame; field of view
沙发	sofa (loanword); CL:條|条[tiao2],張|张[zhang1]; (Internet slang) the first reply or replier to a forum post
提出	to raise (an issue); to propose; to put forward; to suggest; to post (on a website); to withdraw (cash)
臉大	adj. Big-faced. This Internet slang term is used to criticize someone for being brazen or narcissistic.
正好	just (in time); just right; just enough; to happen to; to chance to; by chance; it just so happens that
在乎	to rest with; to lie in; to be due to (a certain attribute); (often used in the negative) to care about
生成	to generate; to produce; to form; to be formed; to come into being; to be born with; to be blessed with
投入	to throw into; to put into; to throw oneself into; to participate in; to invest in; absorbed; engrossed
过瘾	to satisfy a craving; to get a kick out of sth; gratifying; immensely enjoyable; satisfying; fulfilling
为止	until; (used in combination with words like 到[dao4] or 至[zhi4] in constructs of the form 到...為止|到...为止)
握	to hold; to grasp; to clench (one's fist); (bound form) to have in one's control; classifier: a handful
演	to perform (a play etc); to stage (a show); (bound form) to develop; to play out; to carry out (a task)
落水	to fall into water; to sink; overboard; fig. to degenerate; to sink (into depravity); to go to the dogs
捧	to hold or offer with both hands; to sing the praises of; classifier for what can be held in both hands
生肖	one of the twelve animals symbolic of the earthly branches 地支[di4 zhi1]; animal from the Chinese zodiac
弦	bow string; string of musical instrument; watchspring; chord (segment of curve); hypotenuse; CL:根[gen1]
斩钉截铁	lit. to chop the nail and slice the iron (idiom); fig. resolute and decisive; unhesitating; categorical
两	two; both; some; a few; tael, unit of weight equal to 50 grams (modern) or 1⁄16 of a catty 斤[jin1] (old)
背着	turning one's back to (sth or sb); keeping sth secret from (sb); keeping (one's hands) behind one's back
打工	to work a temporary or casual job; (of students) to have a job outside of class time, or during vacation
够	enough (sufficient); enough (too much); (coll.) (before adj.) really; (coll.) to reach by stretching out
吐血	to cough up blood; (coll.) (used figuratively to indicate an extreme degree of anger or frustration etc)
考	to check; to verify; to test; to examine; to take an exam; to take an entrance exam for; deceased father
两	two; both; some; a few; tael, unit of weight equal to 50 grams (modern) or 1⁄16 of a catty 斤[jin1] (old)
竟然	unexpectedly; to one's surprise; in spite of everything; in that crazy way; actually; to go as far as to
规范	norm; standard; specification; regulation; rule; within the rules; to fix rules; to regulate; to specify
两	two; both; some; a few; tael, unit of weight equal to 50 grams (modern) or 1⁄16 of a catty 斤[jin1] (old)
说明	to explain; to illustrate; to indicate; to show; to prove; explanation; directions; caption; CL:個|个[ge4]
床上運動	n. On the bed+exercise. Exercise in bed. This Internet slang term is a euphemism for sexual intercourse.
台阶	steps; flight of steps; step (over obstacle); fig. way out of an embarrassing situation; bench (geology)
对联	rhyming couplet; pair of lines of verse written vertically down the sides of a doorway; CL:副[fu4],幅[fu2]
指	finger; to point at or to; to indicate or refer to; to depend on; to count on; (of hair) to stand on end
圈	circle; ring; loop (CL:個|个[ge4]); classifier for loops, orbits, laps of race etc; to surround; to circle
守	to guard; to defend; to keep watch; to abide by the law; to observe (rules or ritual); nearby; adjoining
辜负	to fail to live up (to expectations); unworthy (of trust); to let down; to betray (hopes); to disappoint
细	thin or slender; finely particulate; thin and soft; fine; delicate; trifling; (of a sound) quiet; frugal
主流	main stream (of a river); fig. the essential point; main viewpoint of a matter; mainstream (culture etc)
理所当然	as it should be by rights (idiom); proper and to be expected as a matter of course; inevitable and right
算数	to count numbers; to keep to one's word; to hold (i.e. to remain valid); to count (i.e. to be important)
报告	to inform; to report; to make known; report; speech; talk; lecture; CL:篇[pian1],份[fen4],個|个[ge4],通[tong4]
送	to send; to deliver; to transmit; to give (as a present); to see (sb) off; to accompany; to go along with
风光	scene; view; sight; landscape; to be well-regarded; to be well-off; grand (dialect); impressive (dialect)
犯	to violate; to offend; to assault; criminal; crime; to make a mistake; recurrence (of mistake or sth bad)
环	ring; hoop; loop; (chain) link; classifier for scores in archery etc; to surround; to encircle; to hem in
回避	to shun; to avoid (sb); to skirt; to evade (an issue); to step back; to withdraw; to recuse (a judge etc)
牌	mahjong tile; playing card; game pieces; signboard; plate; tablet; medal; CL:片[pian4],個|个[ge4],塊|块[kuai4]
构思	to design; to plot; to plan out; to compose; to draw a mental sketch; conception; plan; idea; composition
图	diagram; picture; drawing; chart; map; CL:張|张[zhang1]; to plan; to scheme; to attempt; to pursue; to seek
炸	to burst; to explode; to blow up; to bomb; (coll.) to fly into a rage; (coll.) to scamper off; to scatter
拼命	to do one's utmost; with all one's might; at all costs; (to work or fight) as if one's life depends on it
出轨	to be derailed; to go off the rails; (fig.) to overstep the bounds; (fig.) to have an extramarital affair
祖先	ancestors; forebears; (biology) ancestral species; ancient species from which present-day species evolved
暗	(literary) to close (a door); to eclipse; confused; ignorant (variant of 暗[an4]); dark (variant of 暗[an4])
辈	lifetime; generation; group of people; class; classifier for generations; (literary) classifier for people
水	water; river; liquid; beverage; additional charges or income; (of clothes) classifier for number of washes
大哥	eldest brother; big brother (polite address for a man of about the same age as oneself); gang leader; boss
绿	green; (slang) (derived from 綠帽子|绿帽子[lu:4 mao4 zi5]) to cheat on (one's spouse or boyfriend or girlfriend)
感受	to sense; perception; to feel (through the senses); to experience; a feeling; an impression; an experience
肯定	to be certain; to be positive; assuredly; definitely; to give recognition; to affirm; affirmative (answer)
酒	wine (esp. rice wine); liquor; spirits; alcoholic beverage; CL:杯[bei1],瓶[ping2],罐[guan4],桶[tong3],缸[gang1]
开机	to start an engine; to boot up (a computer); to press Ctrl-Alt-Delete; to begin shooting a film or TV show
开学	(of a student) to start school; (of a semester) to begin; (old) to found a school; the start of a new term
觉悟	to come to understand; to realize; consciousness; awareness; Buddhist enlightenment (Sanskrit: cittotpāda)
说明书	(technical) manual; (book of) directions; synopsis (of a play or film); specification (patent); CL:本[ben3]
锲而不舍	to chip away at a task and not abandon it (idiom); to chisel away at sth; to persevere; unflagging efforts
表示	(of sb) to express; to state; to show; (of sth) to indicate; to signify; to show; expression; manifestation
成	to succeed; to finish; to complete; to accomplish; to become; to turn into; to be all right; OK!; one tenth
高甜	adj. Highly sweet. This Internet slang term positively describes how intimate and affectionate a couple is.
成	to succeed; to finish; to complete; to accomplish; to become; to turn into; to be all right; OK!; one tenth
代理	to act on behalf of sb in a responsible position; to act as an agent or proxy; surrogate; (computing) proxy
像	to resemble; to be like; to look as if; such as; appearance; image; portrait; image under a mapping (math.)
高潮	high tide; high water; upsurge; peak of activity; climax (of a story, a competition etc); to have an orgasm
挤	to crowd in; to cram in; to force others aside; to press; to squeeze; to find (time in one's busy schedule)
花瓶	flower vase; (fig.) female employee considered to be just a pretty face (attractive but not very competent)
蹬	to step on; to tread on; to put on; to wear (shoes, trousers etc); (slang) to dump (sb); Taiwan pr. [deng4]
看起来	seemingly; apparently; looks as if; appears to be; gives the impression that; seems on the face of it to be
米叔	n. Rice+Uncle. Uncle Mi. This Internet slang term is an affectionate nickname for Indian artist Aamir Khan.
证明	proof; certificate; identification; testimonial; CL:個|个[ge4]; to prove; to testify; to confirm the truth of
欠	to owe; to lack; (literary) to be deficient in; (bound form) yawn; to raise slightly (a part of one's body)
像	to resemble; to be like; to look as if; such as; appearance; image; portrait; image under a mapping (math.)
公知	public intellectual (sometimes used derogatorily) (abbr. for 公共知識分子|公共知识分子[gong1 gong4 zhi1 shi5 fen4 zi3])
入	to enter; to go into; to join; to become a member of; to confirm or agree with; abbr. for 入聲|入声[ru4 sheng1]
並沒有	Actually, not really. This Internet slang term is often used to defy someone else’s presumption humorously.
攀登	to climb; to pull oneself up; to clamber; to scale; fig. to forge ahead in the face of hardships and danger
搬	to move (i.e. relocate oneself); to move (sth relatively heavy or bulky); to shift; to copy indiscriminately
保留	to keep; to retain; to have reservations (about sth); to hold back (from saying sth); to put aside for later
词语	word (general term including monosyllables through to short phrases); term (e.g. technical term); expression
处理	to handle; to deal with; to punish; to treat sth by a special process; to process; to sell at reduced prices
吹	to blow; to play a wind instrument; to blast; to puff; to boast; to brag; to end in failure; to fall through
房子	house; building (single- or two-story); apartment; room; CL:棟|栋[dong4],幢[zhuang4],座[zuo4],套[tao4],間|间[jian1]
辩解	to explain; to justify; to defend (a point of view etc); to provide an explanation; to try to defend oneself
贵	expensive; (bound form) highly valued; precious; (bound form) noble; of high rank; (prefix) (honorific) your
黑	black; dark; sinister; secret; shady; illegal; to hide (sth) away; to vilify; (loanword) to hack (computing)
出名	well-known for sth; to become well known; to make one's mark; to lend one's name (to an event, endeavor etc)
对立	to oppose; to set sth against; to be antagonistic to; antithetical; relative opposite; opposing; diametrical
向	variant of 向[xiang4]; direction; orientation; to face; to turn toward; to; towards; shortly before; formerly
季	season; the last month of a season; fourth or youngest amongst brothers; classifier for seasonal crop yields
对了	Correct!; Oh, that's right, ... (when one suddenly remembers sth one wanted to mention); Oh, by the way, ...
演出	to act (in a play); to perform; to put on (a performance); performance; concert; show; CL:場|场[chang3],次[ci4]
虐腹	v. Abuse+abdomen. To do intense ab workouts, especially to develop a visible Adonis belt or a V-shaped core.
染	to dye; to catch (a disease); to acquire (bad habits etc); to contaminate; to add color washes to a painting
沿	along; to follow (a line, tradition etc); to carry on; to trim (a border with braid, tape etc); border; edge
演绎	(of a story etc) to unfold; to play out; to develop (a technique etc); to enact; (logic) to deduce; to infer
元宵节	Lantern Festival, the final event of the Spring Festival 春節|春节, on 15th of first month of the lunar calendar
正气	healthy atmosphere; moral spirit; unyielding integrity; probity; (TCM) vital energy (resistance to diseases)
本子	book; notebook; Japanese-style self-published comic (esp. an erotic one), aka "dōjinshi"; CL:本[ben3]; edition
住	to live; to dwell; to stay; to reside; to stop; (suffix indicating firmness, steadiness, or coming to a halt)
专业	specialty; specialized field; main field of study (at university); major; CL:門|门[men2],個|个[ge4]; professional
乖	(of a child) obedient, well-behaved; clever; shrewd; alert; perverse; contrary to reason; irregular; abnormal
该	should; ought to; probably; must be; to deserve; to owe; to be sb's turn to do sth; that; the above-mentioned
胆	gall bladder; courage; guts; gall; inner container (e.g. bladder of a football, inner container of a thermos)
共	common; general; to share; together; total; altogether; abbr. for 共產黨|共产党[Gong4 chan3 dang3], Communist party
斤	catty; (PRC) weight equal to 500 g; (Tw) weight equal to 600 g; (HK, Malaysia, Singapore) slightly over 604 g
满	to fill; full; filled; packed; fully; completely; quite; to reach the limit; to satisfy; satisfied; contented
乃們	pronoun. You [guys]. This Internet slang term is used humorously because 乃 [nǎ] is the archaic form of “you.”
網綠	v. Net+green. To be cheated on by one’s partner who has an affair with someone he or she met on the Internet.
哈尔滨	Harbin, subprovincial city and capital of Heilongjiang province 黑龍江|黑龙江[Hei1 long2 jiang1] in northeast China
清	(of water etc) clear; clean; quiet; still; pure; uncorrupted; clear; distinct; to clear; to settle (accounts)
融合	a mixture; an amalgam; fusion; welding together; to be in harmony with (nature); to harmonize with; to fit in
科普	(attributive) popular science; (coll.) to explain in layperson's terms; abbr. for 科學普及|科学普及[ke1 xue2 pu3 ji2]
爽	bright; clear; crisp; open; frank; straightforward; to feel well; fine; pleasurable; invigorating; to deviate
退步	to do less well than before; to make a concession; setback; backward step; leeway; room to maneuver; fallback
叙述	to relate (a story or information); to tell or talk about; to recount; narration; telling; narrative; account
失事	(of a plane, ship etc) to have an accident (plane crash, shipwreck, vehicle collision etc); to mess things up
爱心	compassion; kindness; care for others; love; CL:片[pian4]; charity (bazaar, golf day etc); heart (the symbol ♥)
翻译	to translate; to interpret; translator; interpreter; translation; interpretation; CL:個|个[ge4],位[wei4],名[ming2]
启发	to enlighten; to explain (a text etc); to stimulate (a mental attitude); enlightenment; revelation; motivation
流行	(of a contagious disease etc) to spread; to propagate; (of a style of clothing, song etc) popular; fashionable
兄弟	brothers; younger brother; CL:個|个[ge4]; I, me (humble term used by men in public speech); brotherly; fraternal
聊	(coll.) to chat; (literary) temporarily; for a while; (literary) somewhat; slightly; (literary) to depend upon
扑	to throw oneself at; to pounce on; to devote one's energies; to flap; to flutter; to dab; to pat; to bend over
私人	private; personal; interpersonal; sb with whom one has a close personal relationship; a member of one's clique
型号	model (particular version of a manufactured article); type (product specification in terms of color, size etc)
隔壁老王	Mr Wang from next door (term used jocularly to refer to a neighbor who is supposedly sleeping with one's wife)
一向	a period of time in the recent past; (indicating a period of time up to the present) all along; the whole time
行程	journey; travel route; distance of travel; course (of history); stroke (of a piston); (Tw) (computing) process
尊敬	to respect; to revere; to esteem; honorable; distinguished (used on formal occasions before a term of address)
儒家	Confucian school, founded by Confucius 孔子[Kong3 zi3] (551-479 BC) and Mencius 孟子[Meng4 zi3] (c. 372-c. 289 BC)
神仙	Daoist immortal; supernatural entity; (in modern fiction) fairy, elf, leprechaun etc; fig. lighthearted person
吞吞吐吐	to hum and haw (idiom); to mumble as if hiding sth; to speak and break off, then start again; to hold sth back
酝酿	(of alcohol) to ferment; (of a crisis) to be brewing; to mull over (an issue); to hold exploratory discussions
方便	convenient; suitable; to facilitate; to make things easy; having money to spare; (euphemism) to relieve oneself
也	(adverb) also; both ... and ... (before predicates only); (literary) particle having functions similar to 啊[a5]
沒眼看	<Expression> [Having] no eyes to see. Can’t stand looking at [something embarrassing, shocking, or disgusting].
鵝廠	n. Goose+factory. Penguin factory. Tencent. This Internet slang term refers to Tencent whose logo is a penguin.
救救孩子	<Expression> Save the child. This expression is often used when asking for help. “The child” refers to oneself.
发射	to shoot (a projectile); to fire (a rocket); to launch; to emit (a particle); to discharge; emanation; emission
非	to not be; not; wrong; incorrect; non-; un-; in-; de-; to reproach; to blame; (coll.) to insist on; simply must
轻	light; easy; gentle; soft; reckless; unimportant; frivolous; small in number; unstressed; neutral; to disparage
開封菜	n. The Kaifeng cuisine. This Internet slang term is a humorous moniker for KFC, because they share the acronym.
美容	to improve one's appearance (using cosmetics or cosmetic surgery); to make oneself more attractive; to beautify
全场	everyone present; the whole audience; across-the-board; unanimously; whole duration (of a competition or match)
杀	to kill; to slay; to murder; to attack; to weaken; to reduce; (dialect) to smart; (used after a verb) extremely
吃亏	to suffer losses; to come to grief; to lose out; to get the worst of it; to be at a disadvantage; unfortunately
说法	way of speaking; wording; formulation; one's version (of events); statement; theory; hypothesis; interpretation
寄托	to entrust (to sb); to place (one's hope, energy etc) in; a thing in which one invests (one's hope, energy etc)
伪装	to pretend to be (asleep etc); to disguise oneself as; pretense; disguise; (military) to camouflage; camouflage
保安	to ensure public security; to ensure safety (for workers engaged in production); public security; security guard
在	to exist; to be alive; (of sb or sth) to be (located) at; (used before a verb to indicate an action in progress)
穿	to wear; to put on; to dress; to bore through; to pierce; to perforate; to penetrate; to pass through; to thread
鎮魂女孩	n. Guardian Girls. Female fans of Guardian, a Chinese web drama adapted from the fantasy novel of the same name.
代表	representative; delegate; CL:位[wei4],個|个[ge4],名[ming2]; to represent; to stand for; on behalf of; in the name of
光	light; ray (CL:道[dao4]); bright; shiny; only; merely; used up; finished; to leave (a part of the body) uncovered
前	front; forward; ahead; first; top (followed by a number); future; ago; before; BC (e.g. 前293年); former; formerly
扶我上墻	<Expression> Help me get onto the wall. Help me become more visible in this online discussion by liking my post.
平	flat; level; equal; to tie (make the same score); to draw (score); calm; peaceful; abbr. for 平聲|平声[ping2 sheng1]
女司機	n. Female driver. This Internet slang term indicates the prejudice that female drivers have poor driving skills.
彩蛋	painted eggshell; Easter egg; (media) Easter egg (hidden feature in software or a movie etc); post-credits scene
大写加粗	adj. Written in bold and all caps. This Internet slang term is used to emphasize the words that come thereafter.
在于	to rest with; to lie in; to be due to (a certain attribute); (of a matter) to be determined by; to be up to (sb)
通电	to set up an electric circuit; to electrify; to switch on; to be connected to an electricity grid; open telegram
鸦雀无声	lit. crow and peacock make no sound; absolute silence (idiom); not a single voice can be heard; absolute silence
层	to pile on top of one another; layer; stratum; floor (of a building); story; (math.) sheaf; classifier for layers
段	paragraph; section; segment; stage (of a process); classifier for stories, periods of time, lengths of thread etc
寄己	n. Self. This Internet slang term is an alternative to 自己 [zì jǐ] “self, oneself” and mimics the Cantonese accent
黑出翔	<Expression> Black+out+shit. To eloquently roast a person to the point where the person shitted his or her pants.
亮	bright; light; to shine; to flash; loud and clear; to show (one's passport etc); to make public (one's views etc)
炮總	n. Cannon+Boss. This Internet slang term is a nickname for British actor Paul Bettany 炮 [pào] sounds like “Paul.”
接收	reception (of transmitted signal); to receive; to accept; to admit; to take over (e.g. a factory); to expropriate
借鉴	to draw on (others' experience); to learn from (how others do things); lesson to be learned (by observing others)
通	classifier for an activity, taken in its entirety (tirade of abuse, stint of music playing, bout of drinking etc)
推坑	v. To push [someone] into a pit. To persuade someone to become a fan of novels or manga delivered in serial form.
有意义	to make sense; to have meaning; to have significance; meaningful; significant; worthwhile; important; interesting
收藏	to collect (works of art, dolls, antiques etc); to put away for safekeeping; (Internet) to bookmark; a collection
買買買	v. Buy buy buy! This Internet slang term is often used humorously to convey or provoke a strong desire to splurge
专题	specific topic (addressed by a book, lecture, TV program etc); article, report or program etc on a specific topic
镇	to press down; to calm; to subdue; to suppress; to guard; garrison; small town; to cool or chill (food or drinks)
流露	to reveal (indirectly, implicitly); to show (interest, contempt etc) by means of one's actions, tone of voice etc
泄气	to leak (gas); to be discouraged; to despair; (disparaging) pathetic; to vent one's anger; (of a tire) to be flat
抱	to hold; to carry (in one's arms); to hug; to embrace; to surround; to cherish; (coll.) (of clothes) to fit nicely
发达	well-developed; flourishing; to develop; to promote; to expand; (literary) to achieve fame and fortune; to prosper
寄	to send; to mail; to entrust; to depend on; to attach oneself to; to live (in a house); to lodge; foster (son etc)
哪里	where?; somewhere; anywhere; wherever; nowhere (negative answer to question); humble expression denying compliment
发起	to originate; to initiate; to launch (an attack, an initiative etc); to start; to propose sth (for the first time)
肉	meat; flesh; pulp (of a fruit); (coll.) (of a fruit) squashy; (of a person) flabby; irresolute; Kangxi radical 130
親測有效	<Expression> [I’ve] tested it myself; [it’s] effective. This expression is often used when recommending something.
收	to receive; to accept; to collect; to put away; to restrain; to stop; in care of (used on address line after name)
解放	to liberate; to emancipate; liberation; refers to the Communists' victory over the Nationalists in 1949; CL:次[ci4]
太极拳	shadowboxing or Taiji, T'aichi or T'aichichuan; traditional form of physical exercise or relaxation; a martial art
尽	to use up; to exhaust; to end; to finish; to the utmost; exhausted; finished; to the limit (of sth); all; entirely
为难	to feel embarrassed or awkward; to make things difficult (for someone); to find things difficult (to do or manage)
块	lump; chunk; piece; classifier for pieces of cloth, cake, soap etc; (coll.) classifier for money and currency units
充电	to recharge (a battery); (fig.) to recharge one's batteries (through leisure); to update one's skills and knowledge
辫子	plait; braid; pigtail; a mistake or shortcoming that may be exploited by an opponent; handle; CL:根[gen1],條|条[tiao2]
调	to harmonize; to reconcile; to blend; to suit well; to adjust; to regulate; to season (food); to provoke; to incite
奶奶	(informal) grandma (paternal grandmother); (respectful) mistress of the house; CL:位[wei4]; (coll.) boobies; breasts
卷西	n. Curly+west. Curly West. This Internet slang term is an affectionate nickname for American actor Jesse Eisenberg.
纷纷	one after another; in succession; one by one; continuously; diverse; in profusion; numerous and confused; pell-mell
C位	n. C position. The central position [in photo shooting or video taping, which implies the celebrity’s high status].
男頻	n. Male+channel. Internet novels that target male readers. Such novels are usually about wars and picking up women.
土肥圓	adj. Unsophisticated+fat+round. This derogatory Internet slang term is often used in body shaming and self-mockery.
量	capacity; quantity; amount; to estimate; abbr. for 量詞|量词[liang4 ci2], classifier (in Chinese grammar); measure word
神經病啊	<Expression> [One of Xue Zhiqian’s pet phrases] Neurotic! This expression means “Are you crazy?” or “Are you nuts?”
应用	to put to use; to apply; practical; applied (science, linguistics etc); application; practical use; (computing) app
應援	v. Originating from Japan and South Korea,  応援 or 응원, this Internet slang term means to help and support [the idol]
烫	to scald; to burn (by scalding); to blanch (cooking); to heat (sth) up in hot water; to perm; to iron; scalding hot
擦	to rub; to scratch; to wipe; to polish; to apply (lipstick, lotion etc); to brush (past); to shred (a vegetable etc)
便是	(emphasizes that sth is precisely or exactly as stated); precisely; exactly; even; if; just like; in the same way as
锻炼	to toughen; to temper; to engage in physical exercise; to work out; (fig.) to develop one's skills; to train oneself
賽高	adj. Competition+high. The highest, the best, awesome. This Internet slang term comes from the Japanese ACG culture.
霧草	n. Fog+glass. This Internet slang term is a euphemism for 我操 [wǒ cào] “I fuck” because of the similar pronunciation.
開畫	v. Open+picture. Derived from Japanese, this Internet slang term refers to the first showing of a movie in theaters.
打包	to wrap; to pack; to put leftovers in a doggy bag for take-out; (computing) to package (i.e. create an archive file)
条	strip; item; article; clause (of law or treaty); classifier for long thin things (ribbon, river, road, trousers etc)
品味	to sample; to taste; to appreciate; one's taste (i.e. in music, literature, fashion, food and drink etc); good taste
输	to lose; to be beaten; (bound form) to transport; (literary) to donate; to contribute; (coll.) to enter (a password)
酸	sour; tart; sick at heart; grieved; sore; aching; pedantic; impractical; to make sarcastic remarks about sb; an acid
瞎说	to talk drivel; to assert sth without a proper understanding or basis in fact; not to know what one is talking about
州	prefecture; (old) province; (old) administrative division; state (e.g. of US); oblast (Russia); canton (Switzerland)
塑造	to model; to mold; (fig.) to create (a character, a market, an image etc); (fig.) (literature) to portray (in words)
拔	to pull up; to pull out; to draw out by suction; to select; to pick; to stand out (above level); to surpass; to seize
不过	only; merely; no more than; but; however; anyway (to get back to a previous topic); cannot be more (after adjectival)
部	ministry; department; section; part; division; troops; board; classifier for works of literature, films, machines etc
部长	head of a (government etc) department; section chief; section head; secretary; minister; CL:個|个[ge4],位[wei4],名[ming2]
讲	to speak; to explain; to negotiate; to emphasize; to be particular about; as far as sth is concerned; speech; lecture
认识	to know; to recognize; to be familiar with; to get acquainted with sb; knowledge; understanding; awareness; cognition
然鵝	interj. But, nevertheless. This Internet slang term is an alternative to 然而 [rán ér] and mimics the Cantonese accent.
交	to hand over; to deliver; to pay (money); to turn over; to make friends; (of lines) to intersect; variant of 跤[jiao1]
根	root; basis; classifier for long slender objects, e.g. cigarettes, guitar strings; CL:條|条[tiao2]; radical (chemistry)
混	to mix; to mingle; muddled; to drift along; to muddle along; to pass for; to get along with sb; thoughtless; reckless
将军	general; high-ranking military officer; to check or checkmate; fig. to embarrass; to challenge; to put sb on the spot
信	letter; mail; CL:封[feng1]; to trust; to believe; to profess faith in; truthful; confidence; trust; at will; at random
突破	to break through; to make a breakthrough; to surmount (an obstacle); (sports) to break through the opponent's defense
信	letter; mail; CL:封[feng1]; to trust; to believe; to profess faith in; truthful; confidence; trust; at will; at random
整治	to bring under control; to regulate; to restore to good condition; (coll.) to fix (a person); to prepare (a meal etc)
打发	to dispatch sb to do sth; to make sb leave; to pass (the time); (old) to make arrangements; (old) to bestow (alms etc)
智商稅	n. IQ tax. This Internet slang term is often used in the phrase “paid the IQ tax” to describe someone who is gullible.
练	to practice; to train; to drill; to perfect (one's skill); exercise; (literary) white silk; to boil and scour raw silk
寡姐	n. Widow+Sister. Sister [Black] Widow. This Internet slang term is a nickname for American actress Scarlett Johansson.
味道	flavor; taste; (fig.) feeling (of ...); sense (of ...); hint (of ...); (fig.) interest; delight; (dialect) smell; odor
同人	people from the same workplace or profession; co-worker; colleague; pop culture enthusiasts who create fan fiction etc
线	thread; string; wire; line; CL:條|条[tiao2],股[gu3],根[gen1]; (after a number) tier (unofficial ranking of a Chinese city)
空闲	leisure; spare time; (of a person) free; unoccupied; (of equipment, rooms etc) unoccupied; unused; idle; vacant; spare
祝	to pray for; to wish (sb bon voyage, happy birthday etc); person who invokes the spirits during sacrificial ceremonies
排放	to arrange in order; to emit; to discharge (exhaust gas, waste water etc); (of animals) to ovulate; to discharge semen
任重道远	a heavy load and a long road; fig. to bear heavy responsibilities through a long struggle (cf Confucian Analects, 8.7)
宁可	preferably; one would prefer to...(or not to...); would rather; (would) be better to; (to pick) the lesser of two evils
囧司徒	n. Awkward+Situ [Chinese surname]. This Internet slang term is a nickname for Jon Stewart due to similar pronunciation.
挖坑	to dig a hole; (fig.) to make things difficult for sb; (neologism) (slang) (of a writer) to start work on a new project
赏	to bestow (a reward); to give (to an inferior); to hand down; a reward (bestowed by a superior); to appreciate (beauty)
规矩	lit. compass and set square; fig. established standard; rule; customs; practices; fig. upright and honest; well-behaved
转移	to shift; to relocate; to transfer; (fig.) to shift (attention); to change (the subject etc); (medicine) to metastasize
麻醉	anesthesia; to anesthetize; (fig.) to corrupt (sb's mind); to enervate; to numb the mind (to escape from harsh reality)
G點	n. G-spot. This Internet slang term metaphorically refers to things that make one elated. It’s often used sarcastically.
测试	to test (machinery etc); to test (a person's skill in a particular area); a test; (computing) beta (version of software)
跟	heel; to follow closely; to go with; (of a woman) to marry sb; with; compared with; to; towards; and (joining two nouns)
要	to want; to need; to ask for; will; shall; about to; need to; should; if (same as 要是[yao4 shi5]); (bound form) important
大姐	big sister; elder sister; older sister (also polite term of address for a girl or woman slightly older than the speaker)
规定	to stipulate; to specify; to prescribe; to fix (a price); to set (a quota); regulations; rules; provisions; stipulations
滅霸	n. Destroy+tyrant. Thanos. Thanos is a fictional character appearing in American comic books published by Marvel Comics.
賣腐	v. Sell+gayness. To present oneself or a piece of artwork in a way that appeals to an audience that adore homosexuality.
要	to want; to need; to ask for; will; shall; about to; need to; should; if (same as 要是[yao4 shi5]); (bound form) important
綠綠	n. Green green. This Internet slang term refers to the Muslims, because green is an important color in the Muslim world.
白蓮花	n. White lotus flower. 1) Kind, innocent, lovable, good people. 2) People who pretend to be kind, innocent, and lovable.
要	to want; to need; to ask for; will; shall; about to; need to; should; if (same as 要是[yao4 shi5]); (bound form) important
讨好	to get the desired outcome; to win favor by fawning on sb; to curry favor with; a fruitful outcome to reward one's labor
心得	what one has learned (through experience, reading etc); knowledge; insight; understanding; tips; CL:項|项[xiang4],個|个[ge4]
词	word; statement; speech; lyrics; a form of lyric poetry, flourishing in the Song dynasty 宋朝|宋朝[Song4 chao2] (CL:首[shou3])
沙雕	adj./n. Sand+sculpture. This Internet slang term is a euphemism for 傻屌 [shǎ diǎo] “stupid+penis” or “stupid, stupid-ass.”
戾氣	n. Evil tendencies. This Internet slang term refers to the antisocial inclinations that people display online or offline.
条件	condition; circumstance; term; factor; requirement; prerequisite; qualification; situation; state; condition; CL:個|个[ge4]
碎	(transitive or intransitive verb) to break into pieces; to shatter; to crumble; broken; fragmentary; scattered; garrulous
啦	sentence-final particle, contraction of 了啊, indicating exclamation; particle placed after each item in a list of examples
阵	disposition of troops; wave; spate; burst; spell; short period of time; classifier for events or states of short duration
新番	n. New show. Originally it referred to new Japanese animation-manga TV series, now it describes any new TV show or movie.
粘贴	to stick; to affix; to adhere; to paste (as in "copy and paste"); Taiwan pr. [nian2 tie1]; also written 黏貼|黏贴[nian2 tie1]
招	to recruit; to provoke; to beckon; to incur; to infect; contagious; a move (chess); a maneuver; device; trick; to confess
编	to weave; to plait; to organize; to group; to arrange; to edit; to compile; to write; to compose; to fabricate; to make up
口	mouth; classifier for things with mouths (people, domestic animals, cannons, wells etc); classifier for bites or mouthfuls
绕	variant of 繞|绕[rao4], to rotate around; to spiral; to move around; to go round (an obstacle); to by-pass; to make a detour
墻內	adj. On this side of the wall. This Internet slang term refers to the Internet environment affected by the Great Firewall.
眼	eye; small hole; crux (of a matter); CL:隻|只[zhi1],雙|双[shuang1]; classifier for big hollow things (wells, stoves, pots etc)
透	(bound form) to penetrate; to seep through; to tell secretly; to leak; thoroughly; through and through; to appear; to show
提起	to mention; to speak of; to lift; to pick up; to arouse; to raise (a topic, a heavy weight, one's fist, one's spirits etc)
约	to make an appointment; to invite; approximately; pact; treaty; to economize; to restrict; to reduce (a fraction); concise
小确幸	sth small that one can find pleasure in (e.g. a cold beer after a hard day or a serendipitous find in a second-hand store)
觉醒	to awaken; to come to realize; awakened to the truth; the truth dawns upon one; scales fall from the eyes; to become aware
走漏	to leak (information, secrets etc); to smuggle and evade tax; to suffer shrinkage (partial loss of goods due to theft etc)
保	to defend; to protect; to keep; to guarantee; to ensure; civil administration unit in the baojia 保甲[bao3 jia3] system (old)
字	letter; symbol; character; word; CL:個|个[ge4]; courtesy or style name traditionally given to males aged 20 in dynastic China
处	place; location; spot; point; office; department; bureau; respect; classifier for locations or items of damage: spot, point
代	to substitute; to act on behalf of others; to replace; generation; dynasty; age; period; (historical) era; (geological) eon
烂	soft; mushy; well-cooked and soft; to rot; to decompose; rotten; worn out; chaotic; messy; utterly; thoroughly; crappy; bad
舔屏向	adj. Lick+screen+direction. (Of a video or article) created to show one’s admiration for a celebrity’s physical appearance.
實錘	n. Solid+hammer. Irrefutable evidence. This Internet slang term is often used negatively to describe the confirmed scandal.
馬路殺手	n. Road+killer. This Internet slang term refers to poor drivers. Female drivers are often unfairly labeled as road killers.
整理	to arrange; to tidy up; to sort out; to straighten out; to list systematically; to collate (data, files); to pack (luggage)
面向	to face; to turn towards; to incline to; geared towards; catering for; -oriented; facial feature; appearance; aspect; facet
民工	migrant worker (who moved from a rural area of China to a city to find work); temporary worker enlisted on a public project
开拓	to break new ground (for agriculture); to open up (a new seam); to develop (border regions); fig. to open up (new horizons)
调和	harmonious; to mediate; to reconcile; mediation; to compromise; to mix; to blend; blended; to season; seasoning; to placate
表现	to show; to show off; to display; to manifest; expression; manifestation; show; display; performance (at work etc); behavior
一丟丟	n. A little. This Internet slang term is a cute alternative to 一点点 [yì diǎn dian] “a little.” It comes from Shanxi dialects.
出台	to officially launch (a policy, program etc); to appear on stage; to appear publicly; (of a bar girl) to leave with a client
伯母	wife of father's elder brother; aunt; (polite form of address for a woman who is about the age of one's mother); CL:個|个[ge4]
槽點滿滿	<Expression> Problems worth criticizing or teasing about+full. Full of problems that are worth criticizing or teasing about.
緊臟	adj. Tight+dirty. Nervous. This Internet slang term means 緊張 [jǐn zhāng] “nervous.” It mimics the Taiwanese Mandarin accent.
对付	to handle; to deal with; to tackle; to get by with; to make do; (dialect) (usu. used in the negative) to get along with (sb)
交往	to associate (with); to have contact (with); to hang out (with); to date; (interpersonal) relationship; association; contact
加油	to add oil; to top up with gas; to refuel; to accelerate; to step on the gas; (fig.) to make an extra effort; to cheer sb on
炸號	v. Explode+account. [Of a Weibo account] to be deactivated permanently for breaking the community regulations of Sina Weibo.
解除	to remove; to sack; to get rid of; to relieve (sb of their duties); to free; to lift (an embargo); to rescind (an agreement)
通过	to pass through; to get through; to adopt (a resolution); to pass (legislation); to pass (a test); by means of; through; via
品质	character; intrinsic quality (of a person); quality (of a product or service, or as in "quality of life", "air quality" etc)
枪手	gunman; sharpshooter; sb who takes an exam for sb else; sb who produces a piece of work for sb else to pass off as their own
靈魂舞者	n. Soul+dancer. Soul dancer. This Internet slang term describes a person who botches a dance but exudes boundless confidence.
而	and; as well as; and so; but (not); yet (not); (indicates causal relation); (indicates change of state); (indicates contrast)
新冠病毒	novel coronavirus (abbr. for 新型冠狀病毒|新型冠状病毒[xin1 xing2 guan1 zhuang4 bing4 du2]) (esp. SARS-CoV-2, the virus causing COVID-19)
嬌嗔	v./n./adj. To protest coquettishly. This Internet slang term is often used humorously to describe the feminine side of a man.
白古	n. White+Gu. The white Louis Koo. This Internet slang term is the nickname for Hong Kong actor Louis Koo in his untanned era.
培养	to cultivate; to breed; to foster; to nurture; to educate; to groom (for a position); education; fostering; culture (biology)
登陆	to land; to come ashore; to make landfall (of typhoon etc); to log in (frequently used erroneous variant of 登錄|登录[deng1 lu4])
灣灣	n. Wan Wan. This Internet slang term was created by Mainland Internet users as a nickname for Taiwan or the Taiwanese people.
相应	to correspond; answering (one another); to agree (among the part); corresponding; relevant; appropriate; (modify) accordingly
抽	to draw out; to pull out from in between; to remove part of the whole; (of certain plants) to sprout or bud; to whip or thrash
肉體飯	n. Body+fan. A fan who adores the idol’s body or figure, compared to other fans who adores the idol’s face, voice, hands, etc.
特别	unusual; special; very; especially; particularly; expressly; for a specific purpose; (often followed by 是[shi4]) in particular
壯士	n. Hero, fighter. This Internet slang term is used humorously to address a fellow Internet user. Sarcasm is sometimes applied.
究竟	to go to the bottom of a matter; after all; when all is said and done; (in an interrogative sentence) finally; outcome; result
连	to link; to join; to connect; continuously; in succession; including; (used with 也[ye3], 都[dou1] etc) even; company (military)
收圖	v. Collect+pictures. To save into one’s personal collection the pictures of one’s idol posted by other people on social media.
挫折	setback; reverse; check; defeat; frustration; disappointment; to frustrate; to discourage; to set sb back; to blunt; to subdue
佛系玩家	n. Buddhist+sect+gamer. The Buddhist gamer. This Internet slang term refers to gamers who don’t care about their game results.
嘿嘿嘿	n. Hehehe. Lewd laughter. A euphemism for lovemaking used by Taiwanese entertainer Fei Yu-ching in one of his sex jokes on TV.
华侨	overseas Chinese; (in a restricted sense) Chinese emigrant who still retains Chinese nationality; CL:個|个[ge4],位[wei4],名[ming2]
似曾相识	déjà vu (the experience of seeing exactly the same situation a second time); seemingly familiar; apparently already acquainted
班	team; class; grade; (military) squad; work shift; CL:個|个[ge4]; classifier for groups of people and scheduled transport vehicles
吃土	(neologism c. 2015) (slang) (used jokingly) to live on dirt (typically because one has spent all one's money on consumer items)
烟	cigarette or pipe tobacco; CL:根[gen1]; smoke; mist; vapour; CL:縷|缕[lu:3]; tobacco plant; (of the eyes) to be irritated by smoke
翼	wing; area surrounding the bullseye of a target; to assist; one of the 28 constellations of Chinese astronomy; old variant of 翌
株	tree trunk; stump (tree root); a plant; classifier for trees or plants; strain (biology); to involve others (in shady business)
白人饭	White People’s Food. hastily put together and pre-made meals commonly associated with white people, but also save time and money
多	many; much; too many; in excess; (after a numeral) ... odd; how (to what extent) (Taiwan pr. [duo2]); (bound form) multi-; poly-
湯老濕	n. Dirty Teacher Tang. This Internet slang term is a ludicrous nickname for English actor, producer, and former model Tom Hardy.
塞皇	n. Emperor Sai. This Internet slang term is a nickname for South African and American actress and film producer Charlize Theron.
多	many; much; too many; in excess; (after a numeral) ... odd; how (to what extent) (Taiwan pr. [duo2]); (bound form) multi-; poly-
篇	sheet; piece of writing; bound set of bamboo slips used for record keeping (old); classifier for written items: chapter, article
女頻	n. Female+channel. Internet novels that target female readers. Such novels are usually about love triangles and homosexual love.
轮	wheel; disk; ring; steamship; to take turns; to rotate; classifier for big round objects: disk, or recurring events: round, turn
喷	(of a smell) strong; peak season (of a crop); (classifier for the ordinal number of a crop, in the context of multiple harvests)
气功	qigong, a traditional Chinese system of cultivating vital energy 氣|气[qi4] through coordinated breathing, movement and meditation
吸血鬼	leech; bloodsucking vermin; vampire (translated European notion); fig. cruel exploiter, esp. a capitalist exploiting the workers
油腻	greasy food; oily food; (of food) greasy; oily; fatty; (neologism c. 2017) (of a middle-aged man) obnoxious; pretentious; vulgar
大厦	(used in the names of grand buildings such as 百老匯大廈|百老汇大厦 Broadway Mansions (in Shanghai) or 帝國大廈|帝国大厦 Empire State Building etc)
夺	to seize; to take away forcibly; to wrest control of; to compete or strive for; to force one's way through; to leave out; to lose
戒	to guard against; to exhort; to admonish or warn; to give up or stop doing sth; Buddhist monastic discipline; ring (for a finger)
副	secondary; auxiliary; deputy; assistant; vice-; abbr. for 副詞|副词 adverb; classifier for pairs, sets of things & facial expressions
伐木累	n. Wood+cutting+exhausting. Exhausting to cut wood. This Internet slang term means “family” because of the similar pronunciation.
墻外	adj. On the other side of the wall. This Internet slang term refers to the Internet environment unaffected by the Great Firewall.
釦釦熊	n. Button+button+bear. This Internet slang term is a nickname for Stephen Colbert because it sounds like his last name “Colbert.”
逢	to meet by chance; to come across; (of a calendar event) to come along; (of an event) to fall on (a particular day); to fawn upon
副	secondary; auxiliary; deputy; assistant; vice-; abbr. for 副詞|副词 adverb; classifier for pairs, sets of things & facial expressions
細思恐極	Expression. Meticulously+think+fear+extreme. To think carefully about something to a point where one is petrified to the extreme.
跳水	to dive (into water); (sports) diving; to commit suicide by jumping into water; (fig.) (of stock prices etc) to fall dramatically
孕育	to be pregnant; to produce offspring; to nurture (a development, school of thought, artwork etc); fig. replete with (culture etc)
一下	(used after a verb) give it a go; to do (sth for a bit to give it a try); one time; once; in a while; all of a sudden; all at once
古風	n. Ancient style. This Internet slang term refers to literature, music, and art that portray or reflect the ancient Chinese style.
天菜	n. Heavenly dish. When you say someone is your “heavenly dish,” you mean that person is exactly your type—a person of your dreams.
熟	ripe; mature; thoroughly cooked; done; familiar; acquainted; experienced; skilled; (of sleep etc) deep; profound; also pr. [shou2]
盆栽精	n. Bonsai+elf/spirit. This Internet slang term is a loving nickname for The Weeknd due to his dreadlocks resembling a bonsai tree.
整体	whole entity; entire body; synthesis; as a whole (situation, construction, team etc); global; macrocosm; integral; holistic; whole
口耐	adj. Mouth+resistant. Lovely. Cute. This Internet slang term is 可爱 [kě ài] “lovely, cute” and mimics the Taiwanese Mandarin accent.
拿	to hold; to seize; to catch; to apprehend; to take; (used in the same way as 把[ba3]: to mark the following noun as a direct object)
神	god; deity; supernatural; magical; mysterious; spirit; mind; energy; lively; expressive; look; expression; (coll.) awesome; amazing
走心	to take care; to be mindful; (Internet slang) to be moved by sth; poignant; to have deep feelings for sb; to lose one's heart to sb
治	to rule; to govern; to manage; to control; to harness (a river); to treat (a disease); to wipe out (a pest); to punish; to research
富二代	children of entrepreneurs who became wealthy under Deng Xiaoping's economic reforms in the 1980s; see also 窮二代|穷二代[qiong2 er4 dai4]
人設已崩	Character design+already+collapse. [Often of a celebrity] image is ruined, usually because of his or her own inappropriate behavior.
撑	to support; to prop up; to push or move with a pole; to maintain; to open or unfurl; to fill to bursting point; brace; stay; support
搬運	v. To transport. This Internet slang term means to download videos, articles, photos, etc. and then repost  them on another website.
顏狗	n. Face+dog. A person who is easily attracted to good-looking people or stars, sometimes to the extent of ignoring their weaknesses.
神同步	n. Magic simultaneity. This Internet slang term is often used to describe the situation where people display the same body language.
佛系	(neologism c. 2017) (coll.) chill about everything (typically used to describe young people who don't buy into aspirational society)
旁友	n. Beside+friend. Friend. This Internet slang term is a phonetic deviation of 朋友 [péng yǒu] “friend” and 胖友 [pàng yǒu] “fat friend.”
以上	that level or higher; that amount or more; the above-mentioned; (used to indicate that one has completed one's remarks) That is all.
松	loose; to loosen; to relax; floss (dry, fluffy food product made from shredded, seasoned meat or fish, used as a topping or filling)
腦殘	adj. Brain+disabled. Literally “brain-damaged”, this slang term is often used to laugh at a person who is ludicrous, dumb, or weird.
孝顺	filial; dutiful; devoted to one's parents (and grandparents etc); to show filial piety towards (an older family member); filial piety
起到	(in an expression of the form 起到…作用[qi3 dao4 xx5 zuo4 yong4]) to have (a (motivating etc) effect); to play (a (stabilizing etc) role)
小黃書	n. Little+yellow+book. The yellow little book is a nickname for books and magazines characterized by either pornography or eroticism.
通用	to use anywhere, anytime (card, ticket etc); to be used by everyone (language, textbook etc); (of two or more things) interchangeable
軟妹	n. Soft+sister. Young women who are very feminine. Borrowed from the Japanese ACG culture, this Internet slang term is a little sexist
断	to break; to snap; to cut off; to give up or abstain from sth; to judge; (usu. used in the negative) absolutely; definitely; decidedly
菇涼	n. Mushroom+cold. Girl. This Internet slang term is 姑娘 [gū niáng] “girl” in the Lanzhou dialect. It is often used for humorous effect.
跑	to run; to run away; to escape; to run around (on errands etc); (of a gas or liquid) to leak or evaporate; (verb complement) away; off
较	(bound form) to compare; (literary) to dispute; compared to; (before an adjective) relatively; comparatively; rather; also pr. [jiao3]
化解	to dissolve; to resolve (contradictions); to dispel (doubts); to iron out (difficulties); to defuse (conflicts); to neutralize (fears)
送分題	n. Send+point+problem. Very easy question [on an exam]. This Internet slang term refers to question to which you must know the answer.
颠簸	to be jolted around (car on a bumpy road, boat on a rough sea, aircraft experiencing turbulence); (fig.) to undergo a rough experience
开花	to bloom; to blossom; to flower; (fig.) to burst; to split open; (fig.) to burst with joy; (fig.) to spring up everywhere; to flourish
期	a period of time; phase; stage; classifier for issues of a periodical, courses of study; time; term; period; to hope; Taiwan pr. [qi2]
偏	to lean; to slant; oblique; prejudiced; to deviate from average; to stray from the intended line; stubbornly; contrary to expectations
粉丝	bean vermicelli; mung bean starch noodles; Chinese vermicelli; cellophane noodles; CL:把[ba3]; fan (loanword); enthusiast for sb or sth
见义勇为	to see what is right and act courageously (idiom, from Analects); to stand up bravely for the truth; acting heroically in a just cause
养活	to provide for; to keep (animals, a family etc); to raise animals; to feed and clothe; support; the necessities of life; to give birth
菜	vegetable; greens (CL:棵[ke1]); dish (of food) (CL:樣|样[yang4],道[dao4],盤|盘[pan2]); (of one's skills etc) weak; poor; (coll.) (one's) type
产生	to arise; to come into being; to come about; to give rise to; to bring into being; to bring about; to produce; to engender; to generate
药	medicine; drug; substance used for a specific purpose (e.g. poisoning, explosion, fermenting); CL:種|种[zhong3],服[fu4],味[wei4]; to poison
干	tree trunk; main part of sth; to manage; to work; to do; capable; cadre; to kill (slang); to fuck (vulgar); (coll.) pissed off; annoyed
急诊	to give or receive urgent medical treatment; emergency treatment (at a hospital emergency department, or from a doctor on a house call)
录取	to accept an applicant (prospective student, employee etc) who passes an entrance exam; to admit (a student); to hire (a job candidate)
打臉	v. To slap one’s own face. To behave in ways that contradict one’s previous statements; to have one’s claims contradicted by the truth.
甜寵	“sweet and pampering” idol dramas which are replete with sweet romantic scenes where the male lead would do anything for the female lead
当	at or in the very same...; suitable; adequate; fitting; proper; to replace; to regard as; to think; to pawn; (coll.) to fail (a student)
附件	appendix (in a document); enclosure (accompanying a document); (email) attachment; accessory (for a car, computer etc); (anatomy) adnexa
澄清	to settle (of liquid); to become clear (by precipitation of impurities); precipitate (chemistry); to put in order; to quell disturbances
绿茶	green tea; (slang) (of a girl) seemingly innocent and charming but actually calculating and manipulative; a girl who has these qualities
抖森	n. Tremble+forest. This Internet slang term is a nickname for Tom Hiddleston because it sounds a little like his last name “Hiddleston.”
判	(bound form) to differentiate; to distinguish; (bound form) clearly (different); to judge; to decide; to grade; (of a judge) to sentence
与其	rather than... (used in expressions of the form 與其|与其[yu3qi2] + {verb1} + 不如[bu4ru2] + {verb2} "rather than {verb1}, better to {verb2}")
人道	human sympathy; humanitarianism; humane; the "human way", one of the stages in the cycle of reincarnation (Buddhism); sexual intercourse
折腾	to toss from side to side (e.g. sleeplessly); to repeat sth over and over again; to torment sb; to play crazy; to squander (time, money)
届	to arrive at (place or time); period; to become due; classifier for events, meetings, elections, sporting fixtures, years (of graduation)
鬥圖	v. Compete+pictures. To bicker or joke using pictures. This Internet slang term refers to having a playful pictorial conversation online.
正	straight; upright; proper; main; principal; to correct; to rectify; exactly; just (at that time); right (in that place); (math.) positive
吸霾	v. Sniff+smog. To have to sniff smog constantly because of air pollution. This Internet slang term mimics the word 吸煙 [xī yān] “smoking.”
正	straight; upright; proper; main; principal; to correct; to rectify; exactly; just (at that time); right (in that place); (math.) positive
泥萌	pron. Mud+cute. You guys. This Internet slang term is a phonetic deviation of 你們 [nǐ men] “you guys.” This term is often used humorously.
造	to make; to build; to manufacture; to invent; to fabricate; to go to; party (in a lawsuit or legal agreement); crop; classifier for crops
無感	adj. No feeling. Show no interest. To be not affected. This Internet slang term is used to show your disinterest in someone or something.
正	straight; upright; proper; main; principal; to correct; to rectify; exactly; just (at that time); right (in that place); (math.) positive
感冒	to catch cold; (common) cold; CL:場|场[chang2],次[ci4]; (coll.) to be interested in (often used in the negative); (Tw) to detest; can't stand
不服憋著	<Expression> If you are not convinced, hold it in. This expression is often used to show one’s confidence about one’s ability or argument.
科恩嫂	n. Coen+sister-in-law. This Internet slang term is Chinese Internet users’ nickname for Frances McDormand because she is Joel Coen’s wife.
流量	flow rate; throughput of passengers; volume of traffic; (hydrology) discharge; data traffic; network traffic; website traffic; mobile data
怪我咯	<Expression> My bad? So you think it is my fault? The person who uses this Internet slang term usually doesn’t think he or she is to blame
秃	bald (lacking hair or feathers); barren; bare; denuded; blunt (lacking a point); (of a piece of writing) unsatisfactory; lacking something
阿姨	maternal aunt; step-mother; childcare worker; nursemaid; woman of similar age to one's parents (term of address used by child); CL:個|个[ge4]
笔	pen; pencil; writing brush; to write or compose; the strokes of Chinese characters; classifier for sums of money, deals; CL:支[zhi1],枝[zhi1]
机场	airport; airfield; (slang) service provider for Shadowsocks or similar software for circumventing Internet censorship; CL:家[jia1],處|处[chu4]
动	(of sth) to move; to set in movement; to displace; to touch; to make use of; to stir (emotions); to alter; abbr. for 動詞|动词[dong4 ci2], verb
能打	adj. Can+fight. Competitive. This Internet slang term is often used to describe an entertainer’s appearance, acting, singing, fashion, etc.
奔現	v. Run+reality. [Of people engaging in online dating] to meet in person to see if they like each other offline and want to become a couple.
排	a row; a line; to set in order; to arrange; to line up; to eliminate; to drain; to push open; platoon; raft; classifier for lines, rows etc
佛系青年	n. Buddhist+sect+youth. The Buddhist youth. This Internet slang term is often used to describe the Post-’90 who are less ambitious in life.
排	a row; a line; to set in order; to arrange; to line up; to eliminate; to drain; to push open; platoon; raft; classifier for lines, rows etc
茄子	eggplant (Solanum melongena L.); aubergine; brinjal; Guinea squash; phonetic "cheese" (when being photographed); equivalent of "say cheese"
土	earth; dust; clay; local; indigenous; crude opium; unsophisticated; one of the eight categories of ancient musical instruments 八音[ba1 yin1]
总监	head; director (of an organizational unit); (police) commissioner; inspector-general; rank of local governor in Tang dynasty administration
慰安妇	comfort woman (woman or girl forced into sex slavery by the Japanese military 1937-1945) (orthographic borrowing from Japanese 慰安婦 "ianfu")
窝	nest; pit or hollow on the human body; lair; den; place; to harbor or shelter; to hold in check; to bend; classifier for litters and broods
多么	how (wonderful etc); what (a great idea etc); however (difficult it may be etc); (in interrogative sentences) how (much etc); to what extent
low	adj. Showing poor quality or taste or moral standards. Usually written with the lowercase “l”, this word means tacky, tasteless, or immoral.
单位	unit (of measure); unit (group of people as a whole); work unit (place of employment, esp. in the PRC prior to economic reform); CL:個|个[ge4]
尽管	despite; although; even though; in spite of; unhesitatingly; do not hesitate (to ask, complain etc); (go ahead and do it) without hesitating
转	to revolve; to turn; to circle about; to walk about; classifier for revolutions (per minute etc): revs, rpm; classifier for repeated actions
画风​	n. Painting style. This Internet slang term is often used to describe one’s style in appearance and behavior or the vibes in an environment.
四字弟弟	n. Four-character little brother. This Internet slang term is an affectionate nickname for Chinese entertainer Yiyang Qianxi aka Jackson Yee.
偉光正	adj. Great, honorable, and correct. This Internet slang term is short for 偉大，光榮，正確 [wěi dà, guāng róng, zhèng què], often used sarcastically.
卷福	n. Curly+Holmes. This Internet slang term is a nickname for Benedict Cumberbatch because of his curly hair and his character Sherlock Holmes.
喪心病狂	adj. Frenzied and perverse. As an Internet slang term, it is often used positively or neutrally to describe one’s wildly unexpected behavior.
干燥	(of weather, climate, soil etc) dry; arid; (of skin, mouth etc) dry; (fig.) dull; dry; boring; (of timber etc) to dry out; to season; to cure
都教授	n. Professor Du, referring to Do Min-joon from the South Korean TV show My Love from the Star which was tremendously popular in China in 2013
带有	to have as a feature or characteristic; to have an element of (confidence, sweetness, malevolence etc); to carry (a pathogen, connotation etc)
分别	to part; to leave each other; to distinguish; to tell apart; difference; distinction; in different ways; differently; separately; individually
馬	v. Horse. Bookmarked. This Internet slang term is used when you save a social media post for later perusal. 馬 [mǎ] and 碼 [mǎ ] are homophones.
翻紅	v. Flip+red. To become popular again. This Internet slang term is often used to describe the public’s renewed interest in celebrity has-beens.
周邊	n. Peripheral [products. ] Merchandise produced to take advantage of a related work or a celebrity featured in the work. A tie-in or spin-off.
上门	to drop in; to visit; to lock a door; (of a shop) to close; to go and live with one's wife's family, in effect becoming a member of her family
霸屏	v. To occupy the screen. You use this Internet slang term to describe an actor whose works you can see everywhere on TV and in movie theaters.
重口味	strong flavor (spicy, salty etc); (of food) strongly flavored; (of a person) having a preference for strong flavors; (slang) intense; hardcore
站台	platform (at a railway station); (Tw) (of an influential person) to publicly lend one's support (e.g. for an election candidate); (Tw) website
让	to yield; to permit; to let sb do sth; to have sb do sth; to make sb (feel sad etc); by (indicates the agent in a passive clause, like 被[bei4])
逼	to force (sb to do sth); to compel; to press for; to extort; to press on towards; to press up to; to close in on; euphemistic variant of 屄[bi1]
沖鴨	v. Run+duck. This Internet slang is a cute alternative to 沖呀  [chōng ya] “Run, go go go,” a way of encouraging people to cheer up or work hard.
走腎	adj. Walk+kidney. Going through the kidney. Adapted from 走心 [zǒu xīn], this Internet slang term refers to something that causes sexual arousal.
问候	to give one's respects; to send a greeting; (fig.) (coll.) to make offensive reference to (somebody dear to the person to whom one is speaking)
我宣你	~= 我喜歡你 [wǒ xǐ huān nǐ] Expression.. This Internet slang phrase is a cute way of saying “I like/dig/love you” with a Taiwanese Mandarin accent.
虐狗	v. To abuse [single] dogs. To deliberately or unknowingly tease or hurt the single people through public displayed affection online or offline.
章程	rules; regulations; constitution; statute; articles of association (of company); articles of incorporation; charter (of a corporation); by-laws
关	mountain pass; to close; to shut; to turn off; to confine; to lock (sb) up; to shut (sb in a room, a bird in a cage etc); to concern; to involve
快	rapid; quick; speed; rate; soon; almost; to make haste; clever; sharp (of knives or wits); forthright; plainspoken; gratified; pleased; pleasant
位	position; location; place; seat; classifier for people (honorific); classifier for binary bits (e.g. 十六位 16-bit or 2 bytes); (physics) potential
不喜勿噴	<Expression> If you don’t like [what I’m saying], don’t rant [against me]. This expression is often used before expressing one’s opinion online.
关	mountain pass; to close; to shut; to turn off; to confine; to lock (sb) up; to shut (sb in a room, a bird in a cage etc); to concern; to involve
主持	to take charge of; to manage or direct; to preside over; to uphold; to stand for (justice etc); to host (a TV or radio program etc); (TV) anchor
活久見	<Expression> Live+long+see. If you live long enough, you will be able to witness all kinds of things (however unbelievable or bizarre they are).
主动	to take the initiative; to do sth of one's own accord; spontaneous; active; opposite: passive 被動|被动[bei4 dong4]; drive (of gears and shafts etc)
灰常	~= 非常 [fēi cháng] Gray+usual. Very, extremely.. This Internet slang term is a humorous way of saying 非常 [fēi cháng] “very” with a Fujian accent.
人物	person; personage; figure (esp. sb of importance); character (in a play, novel etc); figure painting (as a genre of traditional Chinese painting)
情懷	n. Sentiment. This Internet slang term is used to describe one’s passion about something bigger than oneself. Sometimes it is used sarcastically.
黑歷史	n. Black+history. One’s disgraceful past. Sometimes it is used humorously to describe one’s embarrassing experiences when he or she was a rookie.
噴子	n. Literally “sprayers,” this Internet slang term means Internet trolls, or people who make deliberately offensive or provocative online postings
原著黨	n. The original work party. Fans of the original works, especially fans of the original Internet novels which are adapted into TV dramas or movies
想	to think (about); to think of; to devise; to think (that); to believe (that); to desire; to want (to); to miss (feel wistful about the absence of)
上网	to go online; to connect to the Internet; (of a document etc) to be uploaded to the Internet; (tennis, volleyball etc) to move in close to the net
諾蘭黑	n./adj. Nolan+black. Christopher Nolan detractors. This Internet slang term is used to describe people who dislike Christopher Nolan’s film style.
點讚之交	n. Click+like+acquaintances. People who maintain a minimal connection or their friendship superficially by liking each other’s social media posts.
放空	to relax completely; to empty one's mind; (finance) to sell short; (of a commercial vehicle) to travel empty (no cargo or passengers); to deadhead
本寶寶	n. I, the baby. Referring to oneself as a baby. This Internet slang term is used by young people to play cute. (Digital illustration by Kim Smith)
掀起	to lift; to raise (a lid etc); (of a storm) to surge; to stir up (waves etc); (fig.) to trigger; set off (a wave of popularity, a controversy etc)
摆脱	to break away from; to cast off (old ideas etc); to get rid of; to break away (from); to break out (of); to free oneself from; to extricate oneself
接	to receive; to answer (the phone); to meet or welcome sb; to connect; to catch; to join; to extend; to take one's turn on duty; to take over for sb
发挥	to display; to exhibit; to bring out implicit or innate qualities; to express (a thought or moral); to develop (an idea); to elaborate (on a theme)
鸟	bird; CL:隻|只[zhi1],群[qun2]; "bird" radical in Chinese characters (Kangxi radical 196); (dialect) to pay attention to; (intensifier) damned; goddamn
火	fire; urgent; ammunition; fiery or flaming; internal heat (Chinese medicine); hot (popular); classifier for military units (old); Kangxi radical 86
堵	to block up (a road, pipe etc); to stop up (a hole); (fig.) (of a person) choked up with anxiety or stress; wall (literary); (classifier for walls)
小透明	n. Little+transparent. Nobody. This Internet slang term is often used by fans who don’t have a large presence in the fandom to describe themselves.
火	fire; urgent; ammunition; fiery or flaming; internal heat (Chinese medicine); hot (popular); classifier for military units (old); Kangxi radical 86
大表姐	n. The eldest cousin sister. This Internet slang term is an affectionate nickname for American actress Jennifer Lawrence and Chinese model Liu Wen.
推	to push; to cut; to refuse; to reject; to decline; to shirk (responsibility); to put off; to delay; to push forward; to nominate; to elect; massage
理直气壮	in the right and self-confident (idiom); bold and confident with justice on one's side; to have the courage of one's convictions; just and forceful
背	the back of a body or object; to turn one's back; to hide something from; to learn by heart; to recite from memory; unlucky (slang); hard of hearing
抄	to make a copy; to plagiarize; to search and seize; to raid; to grab; to go off with; to take a shortcut; to make a turning move; to fold one's arms
电	lightning; electricity; electric (bound form); to get (or give) an electric shock; phone call or telegram etc; to send via telephone or telegram etc
尺	a Chinese foot; one-third of a meter; a ruler; a tape-measure; one of the three acupoints for measuring pulse in Chinese medicine; CL:支[zhi1],把[ba3]
派	clique; school; group; faction; to dispatch; to send; to assign; to appoint; pi (Greek letter Ππ); the circular ratio pi = 3.1415926; (loanword) pie
烧	to burn; to cook; to stew; to bake; to roast; to heat; to boil (tea, water etc); fever; to run a temperature; (coll.) to let things go to one's head
项	back of neck; item; thing; term (in a mathematical formula); sum (of money); classifier for principles, items, clauses, tasks, research projects etc
逆生長	n. Reverse+growth. This Internet slang term is used to describe someone whose appearance (almost) does not show signs of aging over a span of years.
黃桑	n. yellow+mulberry. Emperor. This Internet slang term is a comical way of saying 皇上 [huáng shàng] “Your majesty the emperor” with a Cantonese accent.
汗	perspiration; sweat; CL:滴[di1],頭|头[tou2],身[shen1]; to be speechless (out of helplessness, embarrassment etc) (Internet slang used as an interjection)
民宿	(orthographic borrowing from Japanese 民宿 "minshuku") property rented via Airbnb or similar platform; guesthouse; bed-and-breakfast; homestay; pension
扶墻	v. To support myself by holding onto the wall. This Internet slang term describes one’s shock at something that rendered himself or herself unsteady.
香	fragrant; sweet smelling; aromatic; savory or appetizing; (to eat) with relish; (of sleep) sound; perfume or spice; joss or incense stick; CL:根[gen1]
所	actually; place; classifier for houses, small buildings, institutions etc; that which; particle introducing a relative clause or passive; CL:個|个[ge4]
老濕	n. Always+wet. Teacher. This Internet slang term and 老師 [lǎo shī] “teacher” are homophones, but it is often used to refer to a lecherous male teacher.
大事	major event; major political event (war or change of regime); major social event (wedding or funeral); (do sth) in a big way; CL:件[jian4],樁|桩[zhuang1]
闹	noisy; cacophonous; to make noise; to disturb; to vent (feelings); to fall ill; to have an attack (of sickness); to go in (for some activity); to joke
批	to ascertain; to act on; to criticize; to pass on; classifier for batches, lots, military flights; tier (for the ranking of universities and colleges)
花式虐狗	v. Fancy+abuse+dogs. To hurt the feelings of single people [single dogs] knowingly or unknowingly through myriad forms of public display of affection.
批	to ascertain; to act on; to criticize; to pass on; classifier for batches, lots, military flights; tier (for the ranking of universities and colleges)
错	mistake; wrong; bad; interlocking; complex; to grind; to polish; to alternate; to stagger; to miss; to let slip; to evade; to inlay with gold or silver
大表哥	n. The eldest cousin brother. This Internet slang term is an affectionate nickname for British actor Dan Stevens, because of his role on Downton Abbey.
先	beforehand; first; earlier; at first; originally; for the time being; for now; (prefix) my late (in referring to deceased relatives older than oneself)
咱们	we or us (including both the speaker and the person(s) spoken to); (dialect) I or me; (dialect) (in a coaxing or familiar way) you; also pr. [za2 men5]
照	according to; in accordance with; to shine; to illuminate; to reflect; to look at (one's reflection); to take (a photo); photo; as requested; as before
逗	to tease (playfully); to entice; (coll.) to joke; (coll.) funny; amusing; to stay; to sojourn; brief pause at the end of a phrase (variant of 讀|读[dou4])
符合	in keeping with; in accordance with; tallying with; in line with; to agree with; to accord with; to conform to; to correspond with; to manage; to handle
尬舞	(slang) to battle each other in street dancing (derived from Taiwanese 較, which sounds similar to Mandarin 尬[ga4]); (slang) to perform weird dance moves
狼系男	n. Wolflike man. A wolflike man is calm, domineering, committed, and a bit hard to control. This slang term is often used to label a type of boyfriends.
雙標狗	n. Double standard+dog. A double-standard dog. This Internet slang term is a derogatory term for people who are considered practicing a double standard.
不服來戰	<Expression> If you are not convinced, come and fight [come argue with me]. This expression is often used to show one’s confidence about one’s argument.
抖機靈	<Expression> Shake+cleverness. Make a wisecrack. This expression is used slightly negatively to describe people who quip to show off how witty they are.
鼓动	to urge (an activity that may be beneficial, harmful or neutral); to encourage; to agitate; to instigate; to incite; to beat; to flap (wings, a fan etc)
不要不要	<Expression> No! No! This phrase is originally related to Japanese porn movies. 萌得不要不要的 Unbearably cute that it makes you say “No! No!” or “Stop! Stop!”
锦上添花	lit. add flowers to brocade (idiom); fig. to give sth additional splendor; to provide the crowning touch; (derog.) to benefit sb who is already well off
開車	v. To drive a car. To talk dirty. The Internet slang term often describes harmless dirty jokes which probably would not be considered sexual harrassment.
躁起來	<Expression> Get excited. Quoted from the song “Miss Dong” by Song Dongye, this expression is used to encourage people to become excited about something.
敷衍	to elaborate (on a theme); to expound (the classics); perfunctory; to skimp; to botch; to do sth half-heartedly or just for show; barely enough to get by
污力滔滔	<Expression> Pouring out dirtiness in a steady flow. This expression is used to describe people who like talking about sex either directly or indirectly.
作为	one's conduct; deed; activity; accomplishment; achievement; to act as; as (in the capacity of); qua; to view as; to look upon (sth as); to take sth to be
你	you (Note: In Taiwan, 妳 is used to address females, but in mainland China, it is not commonly used. Instead, 你 is used to address both males and females.)
大体	in general; more or less; in rough terms; basically; on the whole; overall situation; the big picture; cadaver for dissection in training medical students
右	(bound form) right; right-hand side; (bound form) (politics) right of center; (bound form) (old) west; (literary) the right side as the side of precedence
戲精	n. Drama+spirit. An attention-seeking person with a histrionic display of emotions and/or opinions. This Internet slang term is sometimes used humorously.
