临	to face; to overlook; to arrive; to beabout to; just before
宴	feast; repose
们	plural marker for pronouns, and nouns referring to individuals
莉	jasmine
动	to move; to set in movement; to displace; to touch; to make use of; to stir; to alter; abbr. for 動詞|动词[dong4 ci2], verb
敬	respectful; to respect; to offer politely
使	to make; to cause; to enable; to use; to employ; to send; to instruct sb to do sth; envoy; messenger
食	to eat; food; animal feed; eclipse; to feed
巅	summit
醉	intoxicated
稻	paddy; rice
洪	surname Hong; flood; big; great
设	to set up; to put in place; given; suppose; if
率	rate; frequency; to lead; to command; rash; hasty; frank; straightforward; generally; usually
顽	mischievous; obstinate; to play; stupid; stubborn; naughty
岩	cliff; rock; variant of 岩[yan2]
守	to guard; to defend; to keep watch; to abide by the law; to observe; nearby; adjoining
懒	lazy
兽	beast; animal; beastly; bestial
烈	ardent; intense; fierce; stern; upright; to give one's life for a noble cause; exploits; achievements
呀	/(particle equivalent to 啊 after a vowel, expressing surprise or doubt)/
佛	Buddha; Buddhism; seemingly; head ornament
不	no; not so; not; un-
皱	to wrinkle; wrinkled; to crease
待	to stay; to wait; to treat; to deal with; to need; going to; about to; intending to
撑	to support; to prop up; to push or move with a pole; to maintain; to open or unfurl; to fill to bursting point; brace; stay; support
渴	thirsty
台	Taiwan; surname Tai; you; desk; table; counter; Taiwan; platform; stage; terrace; stand; support; station; broadcasting station; classifier for vehicles or machines; typhoon
篷	sail
丸	ball; pellet; pill
惧	to fear
塑	to modelin clay
挎	to carry
述	to state; to tell; to narrate; to relate
典	canon; law; standard work of scholarship; literary quotation or allusion; ceremony; to be in charge of; to mortgage or pawn
赛	to compete; competition; match; to surpass; better than; superior to; to excel
尊	senior; of a senior generation; to honor; to respect; honorific; classifier for cannons and statues; ancient wine vessel
瘩	sore; boil; scab
俐	clever
省	to save; to economize; to be frugal; to omit; to delete; to leave out; province; provincial capital; a ministry; to scrutinize; to reflect; to come to realize; to pay a visit
乓	bang
复	to go and return; to return; to resume; to return to a normal or original state; to repeat; again; to recover; to restore; to turn over; to reply; to answer; to reply to a letter; to retaliate; to carry out; to repeat; to double; to overlap; complex; compound; composite; double; diplo-; duplicate; overlapping; to duplicate; to reply to a letter
疆	border; boundary
纺	to spin; fine woven silk fabric
笑	to laugh; to smile; to laugh at
据	used in 拮据[jie2 ju1]; according to; to act in accordance with; to depend on; to seize; to occupy
逢	to meet by chance; to come across; to come along; to fall on; to fawn upon
壁	wall; rampart
舒	surname Shu; to stretch; to unfold; to relax; leisurely
械	appliance; tool; weapon; shackles; also pr. [jie4]
烹	cooking method; to boil sb alive
士	surname Shi; member of the senior ministerial class; scholar; bachelor; honorific; soldier; noncommissioned officer; specialist worker
贴	to stick; to paste; to post; to keep close to; to fit snugly; to subsidize; allowance; sticker; classifier for sticking plaster: strip
粉	powder; cosmetic face powder; food prepared from starch; noodles or pasta made from any kind of flour; to turn to powder; to whitewash; white; pink; fan; to be a fan of
煤	coal
踏	see 踏實|踏实[ta1 shi5]; to tread; to stamp; to step on; to press a pedal; to investigate on the spot
家	used in 傢伙|家伙[jia1 huo5] and 傢俱|家俱[jia1 ju4]; home; family; my; classifier for families or businesses; refers to the philosophical schools of pre-Han China; noun suffix for a specialist in some activity, such as a musician or revolutionary, corresponding to English -ist, -er, -ary or -ian
霉	mold; mildew; to become moldy
届	to arrive at; period; to become due; classifier for events, meetings, elections, sporting fixtures, years
影	picture; image; film; movie; photograph; reflection; shadow; trace
雕	to carve; to engrave; shrewd; bird of prey; bird of prey
刀	surname Dao; knife; blade; single-edged sword; cutlass; dollar; classifier for sets of one hundred sheets; classifier for knife cuts or stabs
夹	to press from either side; to place in between; to sandwich; to carry sth under armpit; wedged between; between; to intersperse; to mix; to mingle; clip; folder; Taiwan pr. [jia2]; double-layered; lined; Taiwan pr. used in 夾生|夹生[jia1 sheng1] and 夾竹桃|夹竹桃[jia1 zhu2 tao2]
欠	to owe; to lack; to be deficient in; yawn; to raise slightly
惮	dread; fear; dislike
株	tree trunk; stump; a plant; classifier for trees or plants; strain; to involve others
算	to regard as; to figure; to calculate; to compute
造	to make; to build; to manufacture; to invent; to fabricate; to go to; party; crop; classifier for crops
暧	dim; obscure; clandestine; dubious
元	surname Yuan; the Yuan or Mongol dynasty; currency unit; first; original; primary; basic; fundamental; constituent; part; meta-; argument; variable; era; eon
庭	main hall; front courtyard; law court
饿	hungry; to starve
抄	to make a copy; to plagiarize; to search and seize; to raid; to grab; to go off with; to take a shortcut; to make a turning move; to fold one's arms
浮	to float; superficial; floating; unstable; movable; provisional; temporary; transient; impetuous; hollow; inflated; to exceed; superfluous; excessive; surplus
萨	Bodhisattva; surname Sa
外	outside; in addition; foreign; external
赔	to compensate for loss; to indemnify; to suffer a financial loss
姻	marriage connections
监	to supervise; to inspect; jail; prison; supervisor
堂	hall; large room for a specific purpose; relationship between cousins etc on the paternal side of a family; of the same clan; classifier for classes, lectures etc; classifier for sets of furniture; grand; magnificent; stately; majestic appearance
嗑	to crackbetween one's teeth
杠	flagpole; footbridge; coffin-bearing pole; thick pole; bar; rod; thick line; to mark with a thick line; to sharpen; to get into a dispute with; standard; criterion; hyphen; dash
课	subject; course; class; lesson; to levy; tax; form of divination
棺	coffin
厚	thick; deep or profound; kind; generous; rich or strong in flavor; to favor; to stress
毕	surname Bi; the whole of; to finish; to complete; complete; full; finished
程	surname Cheng; rule; order; regulations; formula; journey; procedure; sequence
渗	to seep; to ooze; to horrify
巷	lane; alley
勘	to investigate; to survey; to collate
迷	to bewilder; crazy about; fan; enthusiast; lost; confused
国	surname Guo; country; nation; state; national
霸	hegemon; tyrant; lord; feudal chief; to rule by force; to usurp; master
受	to receive; to accept; to suffer; subjected to; to bear; to stand; pleasant; 
伤	to injure; injury; wound
拓	surname Tuo; to make a rubbing; to expand; to push sth with the hand; to develop; to open up
子	son; child; seed; egg; small thing; 1st earthly branch: 11 p.m.-1 a.m., midnight, 11th solar month, year of the rat; viscount, fourth of five orders of nobility 五等爵位[wu3 deng3 jue2 wei4]; ancient Chinese compass point: 0°; subsidiary; subordinate;sub-; 
筐	basket
谷	grain; corn; surname Gu; valley
灿	glorious; bright; brilliant; lustrous; resplendent
父	father
难	difficult; problem; difficulty; difficult; not good; disaster; distress; to scold
九	nine; 9
携	old variant of 攜|携[xie2]; to carry; to take along; to bring along; to hold; also pr. [xi1]
料	material; stuff; grain; feed; to expect; to anticipate; to guess
凌	surname Ling; to approach; to rise high; thick ice; to insult or maltreat
破	broken; damaged; worn out; lousy; rotten; to break, split or cleave; to get rid of; to destroy; to break with; to defeat; to capture; to expose the truth of
峰	high and tapered peak or summit; mountain-like in appearance; highest level; classifier for camels
丈	measure of length, ten Chinese feet; to measure; husband; polite appellation for an older male
叫	to shout; to call; to order; to ask; to be called; by
狗	dog; dog; doggie
估	to estimate; used in 估衣[gu4 yi5]
汗	see 可汗[ke4 han2], 汗國|汗国[han2 guo2]; perspiration; sweat; to be speechless
双	surname Shuang; two; double; pair; both; even
砖	variant of 磚|砖[zhuan1]; brick
姑	paternal aunt; husband's sister; husband's mother; nun; for the time being; paternal aunt
潜	hidden; secret; latent; to hide; to conceal; to submerge; to dive
专	for a particular person, occasion, purpose; focused on one thing; special; expert; particular; concentrated; specialized
侣	companion
凝	to congeal; to concentrate attention; to stare
哗	bang; clang; sound of gurgling, splashing or flowing water; wow; clamor; noise; sound used to call cats; sound of gurgling water
肚	tripe; belly
筷	chopstick
群	group; crowd; flock, herd, pack etc
买	to buy; to purchase
供	to provide; to supply; to be for; to lay; offerings; to confess; confession; statement
酒	wine; liquor; spirits; alcoholic beverage
黑	abbr. for Heilongjiang province 黑龍江|黑龙江[Hei1 long2 jiang1]; black; dark; sinister; secret; shady; illegal; to hideaway; to vilify; to hack
嗯	; ; OK, yeah; what?; interjection indicating approval, appreciation or agreement
啰	used in 囉嗦|啰嗦[luo1 suo5]; 
真	really; truly; indeed; real; true; genuine; really; in fact; genuinely; scrupulously
之	; him; her; it
逗	to tease; to entice; to joke; funny; amusing; to stay; to sojourn
拾	to ascend in light steps; to pick up; to collate or arrange; ten
架	to support; frame; rack; framework; classifier for planes, large vehicles, radios etc
左	surname Zuo; left; the Left; east; unorthodox; queer; wrong; differing; opposite
捆	a bunch; to tie together; bundle
君	monarch; lord; gentleman; ruler
弓	surname Gong; a bow; to bend; to arch
揉	to knead; to massage; to rub
茂	luxuriant; cyclopentadiene
盘	plate; dish; tray; board; hard drive; to build; to coil; to check; to examine; to transfer; to make over; classifier for food: dish, helping; to coil; classifier for coils of wire; classifier for games of chess; twisting and turning
哏	funny; amusing; sth comical; old variant of 很[hen3]; also used as an exclamation of anger
猜	to guess
庄	surname Zhuang; farmstead; village; manor; place of business; banker; grave or solemn; holdings of a landlord
啡	/(used in loanwords for its phonetic value)/
笔	pen; pencil; writing brush; to write or compose; the strokes of Chinese characters; classifier for sums of money, deals
大	big; large; great; older; eldest; greatly; freely; fully; father; uncle; see 大夫[dai4 fu5]; greatly; enormously; dad; uncle
遍	everywhere; all over; classifier for actions: one time
序	order; sequence; introductory; initial; preface
轨	rail; track; course; path
叮	to sting or bite; to say repeatedly; to urge insistently; to ask repeatedly; to stick to a point; tinkling or jingling sound; tinkling or jingling sound
楠	variant of 楠[nan2]; Machilus nanmu; Chinese cedar; Chinese giant redwood
腐	decay; rotten
谅	to show understanding; to excuse; to presume; to expect
泊	to anchor; touch at; to moor; lake; Taiwan pr. [bo2]
怀	surname Huai; bosom; heart; mind; to think of; to harbor in one's mind; to conceive
怖	terror; terrified; afraid; frightened
搭	to put up; to build; to hang; to connect; to join; to arrange in pairs; to match; to add; to throw in; to take
松	surname Song; pine; loose; to loosen; to relax; floss
扒	to peel; to skin; to tear; to pull down; to cling to; to dig; to rake up; to steal; to braise; to crawl
圾	used in 垃圾[la1 ji1]; Taiwan pr. [se4]
喉	throat; larynx
在	to exist; to be alive; to beat; 
枯	withered; dried up; dull; boring; residue of pressed oilseeds
震	to shake; to vibrate; to jolt; to quake; excited; shocked; one of the Eight Trigrams 八卦[ba1 gua4], symbolizing thunder; ☳
龄	age; length of experience, membership etc
低	low; beneath; to lower; to let droop; to hang down; to incline
返	to return
旧	old; opposite: new 新; former; worn
骗	to cheat; to swindle; to deceive; to get onby swinging one leg over
能	surname Neng; can; to be able to; might possibly; ability; energy
济	used in place names associated with the Ji River 濟水|济水[Ji3 Shui3]; surname Ji; used in 濟濟|济济[ji3 ji3]; to cross a river; to aid or relieve; to be of help; large number of people
蛮	barbarian; bullying; very; quite; rough; reckless
徙	to change one's residence
溪	creek; rivulet
科	branch of study; administrative section; division; field; branch; stage directions; family; rules; laws; to mete out; to levy; to fine sb
中	China; Chinese; surname Zhong; within; among; in; middle; center; while; during; OK; all right; to hit; to be hit by; to suffer; to win; middling; average; impartial; secondary school that uses Chinese as the medium of instruction
营	camp; barracks; battalion; to build; to operate; to manage; to strive for
毒	poison; to poison; poisonous; malicious; cruel; fierce; narcotics
吧	bar; to puff; bang; abbr. for 貼吧|贴吧[tie1 ba1]; ; ...right?; ...OK?; ...I presume.; smack!
春	surname Chun; spring; gay; joyful; youthful; love; lust; life
嘲	to ridicule; to mock; used in 嘲哳[zhao1 zha1]
必	certainly; must; will; necessarily
啾	wailing of child; chirp; kiss
基	base; foundation; radical; gay
占	to observe; to divine; to take possession of; to occupy; to take up
赞	variant of 贊|赞[zan4]; to praise; to patronize; to support; to praise; to like
腰	waist; lower back; pocket; middle; loins
沿	along; to follow; to carry on; to trim; border; edge
婪	avaricious
衫	garment; jacket with open slits in place of sleeves
疙	pimple; wart
翻	to turn over; to flip over; to overturn; to rummage through; to translate; to decode; to double; to climb over or into; to cross
例	example; precedent; rule; case; instance
跌	to fall; to tumble; to trip; to drop; Taiwan pr. [die2]
栽	to plant; to grow; to insert; to erect; to impose sth on sb; to stumble; to fall down
卸	to unload; to unhitch; to remove or strip; to get rid of
柜	Salix multinervis; cupboard; cabinet; wardrobe
佬	male; man
包	surname Bao; to cover; to wrap; to hold; to include; to take charge of; to contract; package; wrapper; container; bag; to hold or embrace; bundle; packet; bag or purse etc; small bump or pimple; hillock
找	to try to find; to look for; to call on sb; to find; to seek; to return; to give change
歉	to apologize; to regret; deficient
滑	surname Hua; to slip; to slide; slippery; smooth; sly; slippery; not to be trusted
鼠	rat; mouse
盆	basin; flower pot; unit of volume equal to 12 斗[dou3] and 8 升[sheng1], approx 128 liters
叠	variant of 疊|叠[die2]; to fold; to fold over in layers; to furl; to layer; to pile up; to repeat; to duplicate
泌	used in 泌陽|泌阳[Bi4 yang2]; to secrete
搂	to draw towards oneself; to gather; to gather up; to grab; to extort; to hug; to embrace; to hold in one's arms
闹	noisy; cacophonous; to make noise; to disturb; to vent; to fall ill; to have an attack; to go in; to joke
炉	stove; furnace
液	liquid; fluid; Taiwan pr. [yi4]
沸	to boil
萝	radish
响	echo; sound; noise; to make a sound; to sound; to ring; loud; classifier for noises
飘	to float; to flutter; to waft; complacent; frivolous; weak; shaky; wobbly; to float about; to flutter; gay guy; ghost
仇	surname Qiu; hatred; animosity; enmity; foe; enemy; to feel animosity toward; spouse; companion; variant of 仇[chou2]
恶	used in 惡心|恶心[e3 xin1]; evil; fierce; vicious; ugly; coarse; to harm; to hate; to loathe; ashamed; to fear; to slander
祖	surname Zu; ancestor; forefather; grandparents
洲	continent; island in a river
阅	to inspect; to review; to read; to peruse; to go through; to experience
激	to arouse; to incite; to excite; to stimulate; sharp; fierce; violent
么	exclamatory final particle; interrogative final particle; suffix, used to form interrogative 什麼|什么[shen2 me5], what?, indefinite 這麼|这么[zhe4 me5] thus, etc; kissing sound
疾	disease; ailment; swift; to hate; to abhor
吗	what?; used in 嗎啡|吗啡[ma3 fei1]; 
减	to lower; to decrease; to reduce; to subtract; to diminish
形	to appear; to look; form; shape
块	lump; chunk; piece; classifier for pieces of cloth, cake, soap etc; classifier for money and currency units
额	forehead; horizontal tablet or inscribed board; specified number or amount
爸	father; dad; pa; papa; father; dad
讯	to question; to ask; to interrogate; rapid; speedy; fast; news; information
甚	what; very; extremely; any
袭	to raid; to attack; to continue the pattern; to perpetuate; classifier for suits of clothing or sets of bedding
扩	to enlarge
娃	baby; doll; baby; small child; doll
夕	dusk; evening; Taiwan pr. [xi4]
宰	to slaughter; to butcher; to kill; to fleece; to rip off; to overcharge; to govern; to rule; 
岁	years old; classifier for years; year; year
纷	numerous; confused; disorderly; one after another; in succession; one by one; continuously; diverse; in profusion; numerous and confused; pell-mell
时	surname Shi; o'clock; time; when; hour; season; period; often; constantly
像	to resemble; to be like; to look as if; such as; appearance; image; portrait; image under a mapping
妻	wife; to marry off
胳	armpit
晾	to dry in the air; to cold-shoulder
所	actually; place; classifier for houses, small buildings, institutions etc; that which; particle introducing a relative clause or passive
菊	chrysanthemum
当	dong; ding dong; ding dong; to be; to act as; manage; withstand; when; during; ought; should; match equally; equal; same; obstruct; just at; on the spot; right; just at; at or in the very same...; suitable; adequate; fitting; proper; to replace; to regard as; to think; to pawn; to fail; Dangdang; to pawn
舌	used in 喇舌[la3 ji1] to transcribe the Taiwanese word for "tongue"; tongue
豫	abbr. for Henan province 河南 in central China; happy; carefree; at one's ease; old variant of 與|与[yu4]
唇	lip
祸	disaster; misfortune; calamity
快	rapid; quick; speed; rate; soon; almost; to make haste; clever; sharp; forthright; plainspoken; gratified; pleased; pleasant
押	to mortgage; to pawn; to detain in custody; to escort and protect; to sign
颁	to promulgate; to send out; to issue; to grant or confer
膛	hollow space
囊	sack; purse; pocket
解	surname Xie; to divide; to break up; to split; to separate; to dissolve; to solve; to melt; to remove; to untie; to loosen; to open; to emancipate; to explain; to understand; to know; a solution; a dissection; to transport under guard; acrobatic display
吁	sh; hush; to pant; to gasp for breath; to implore
苍	surname Cang; dark blue; deep green; ash-gray; ash gray; vast and hazy; flourishing
枚	surname Mei; classifier for coins, rings, badges, pearls, sporting medals, rockets, satellites etc; tree trunk; whip; wooden peg, used as a gag for marching soldiers
志	aspiration; ambition; the will; sign; mark; to record; to write a footnote
替	to substitute for; to take the place of; to replace; for; on behalf of; to stand in for
裤	underpants; trousers; pants
签	to sign one's name; to write brief comments on a document; visa; inscribed bamboo stick; small wood sliver; label; tag
谊	friendship; also pr. [yi2]
这	this; these; this; the; this; these
姬	surname Ji; family name of the Zhou Dynasty 周代[Zhou1 dai4]; woman; concubine; female entertainer
廷	palace courtyard
炸	to deep fry; to blanch; Taiwan pr. [zha4]; to burst; to explode; to blow up; to bomb; to fly into a rage; to scamper off; to scatter
瘫	paralyzed
抚	to comfort; to console; to stroke; to caress; an old term for province or provincial governor
进	to go forward; to advance; to go in; to enter; to put in; to submit; to take in; to admit; base of a number system; classifier for sections in a building or residential compound
迅	rapid; fast
闻	surname Wen; to hear; news; well-known; famous; reputation; fame; to smell; to sniff at
网	net; network
惫	exhausted
丛	cluster; collection; collection of books; thicket
六	six; 6
逮	to catch; to seize; to arrest; to seize; to overtake; until
驾	surname Jia; to harness; to draw; to drive; to pilot; to sail; to ride; your good self; prefixed word denoting respect
恤	anxiety; sympathy; to sympathize; to give relief; to compensate; anxiety; sympathy; to sympathize; to give relief; to compensate
斗	abbr. for the Big Dipper constellation 北斗星[Bei3 dou3 xing1]; dry measure for grain equal to ten 升[sheng1] or one-tenth of a 石[dan4]; decaliter; peck; cup or dipper shaped object; to fight; to struggle; to condemn; to censure; to contend; to put together; coming together; variant of 鬥|斗[dou4]
鸭	duck; male prostitute
又	again; also; both... and...; and yet; anyway
沙	surname Sha; granule; hoarse; raspy; sand; powder; abbr. for Tsar or Tsarist Russia; rustle
荐	to recommend; to offer sacrifice; grass; straw mat
兜	pocket; bag; to wrap up or hold in a bag; to move in a circle; to canvas or solicit; to take responsibility for; to disclose in detail; combat armor; an undergarment covering chest and abdomen
杏	apricot; almond
滨	water's edge; bank; shore; to border on
横	horizontal; across; crosswise; horizontal stroke; to placeflat; to cross; in a jumble; chaotic; harsh and unreasonable; violent; harsh and unreasonable; unexpected
评	to discuss; to comment; to criticize; to judge; to choose
积	to amass; to accumulate; to store up; product; constipation; indigestion
信	letter; mail; to trust; to believe; to profess faith in; truthful; confidence; trust; at will; at random
馆	building; shop; term for certain service establishments; embassy or consulate; schoolroom
半	half; semi-; incomplete; and a half
疑	to doubt; to suspect
涂	to apply; to smear; to daub; to blot out; to scribble; to scrawl; mud; street; surname Tu
应	surname Ying; Taiwan pr. [Ying4]; to agree; should; ought to; must; shall; to answer; to respond; to comply with; to deal or cope with
添	to add; to increase; to replenish
昏	muddle-headed; twilight; to faint; to lose consciousness
度	to pass; to spend; measure; limit; extent; degree of intensity; degree; kilowatt-hour; classifier for events and occurrences; to estimate; Taiwan pr. [duo4]
校	to check; to collate; to proofread; school; college; field officer
江	surname Jiang; river
幅	width; roll; classifier for textiles or pictures
饱	to eat till full; satisfied
道	road; path; way; reason; principle; a skill; an art; a specialization; the Way; the Dao; to say; to express; to extend; classifier for long thin things, barriers, questions, commands, courses in a meal, steps in a process; circuit
卑	low; base; vulgar; inferior; humble
坍	to collapse
批	to ascertain; to act on; to criticize; to pass on; classifier for batches, lots, military flights; tier
瘸	lame
吸	to breathe; to suck in; to absorb; to inhale
文	surname Wen; language; culture; writing; formal; literary; gentle; classifier for coins; Kangxi radical 67
馈	to make an offering to the gods; food; to make a present
胸	chest; bosom; heart; mind; thorax
斩	to behead; to chop
遛	to stroll; to walk
粘	to glue; to paste; to adhere; to stick to
纪	surname Ji; also pr. [Ji4]; order; discipline; age; era; period; to chronicle
啪	bang; pop; pow
晶	crystal; glistening; gleaming; lustrous
封	surname Feng; to confer; to grant; to bestow a title; to seal; classifier for sealed objects, esp. letters
把	to hold; to grasp; to hold a baby in position to help it urinate or defecate; handlebar; classifier: handful, bundle, bunch; classifier for things with handles; ; handle
泥	mud; clay; paste; pulp; restrained
村	village
汪	surname Wang; expanse of water; ooze; bark; classifier for liquids: pool, puddle; gleaming with tears; woof woof; broad and deep
袜	socks; stockings; variant of 襪|袜[wa4]
膏	ointment; paste; to moisten; to grease; to apply; to dip a brush in ink; to anoint
亲	parent; one's own; relative; related; marriage; bride; close; intimate; in person; first-hand; in favor of; pro-; to kiss; dear; parents-in-law of one's offspring; dear one; to kiss; friendly
陆	surname Lu; six; land
尘	dust; dirt; earth
切	to cut; to slice; to carve; tangential; definitely; absolutely; Yeah, right.; Tut!; to grind; close to; eager; to correspond to; ; urgently; eagerly; worried; be sure to; it is absolutely essential to
摇	surname Yao; to shake; to rock; to row; to crank
缉	to seize; to arrest; Taiwan pr. [qi4]; to stitch finely
媒	medium; intermediary; matchmaker; go-between; abbr. for 媒體|媒体[mei2 ti3], media, esp. news media
畏	to fear
肖	surname Xiao; Taiwan pr. [Xiao4]; similar; resembling; to resemble; to be like
规	compass; a rule; regulation; to admonish; to plan; to scheme
耐	to bear; to endure; to withstand
析	to separate; to divide; to analyze
剂	dose
死	to die; impassable; uncrossable; inflexible; rigid; extremely; damned; rigid; unwavering; unbendable; firm; tenacious
随	surname Sui; to follow; to comply with; varying according to...; to allow; subsequently
香	fragrant; sweet smelling; aromatic; savory or appetizing; with relish; sound; perfume or spice; joss or incense stick
嘿	hey; he he; mischievous laughter
拣	to choose; to pick; to sort out; to pick up
救	to save; to assist; to rescue
港	Hong Kong; surname Gang; harbor; port
伸	to stretch; to extend
腿	leg; hip bone
股	thigh; part of a whole; portion of a sum; share; strand of a thread; low-level administrative unit, translated as "section" or "department" etc, ranked below 科[ke1]; classifier for long winding things like ropes, rivers etc; classifier for smoke, smells etc: thread, puff, whiff; classifier for bands of people, gangs etc; classifier for sudden forceful actions
落	to leave out; to be missing; to leave behind or forget to bring; to lag or fall behind; colloquial reading for 落[luo4] in certain compounds; to fall or drop; to set; to go out; to lower; to decline or sink; to lag or fall behind; to fall onto; to rest with; to get or receive; to write down; whereabouts; settlement
锁	to lock; to lock up; a lock
伺	used in 伺候[ci4 hou5]; to watch; to wait; to examine; to spy
矶	breakwater; jetty
蛋	egg; oval-shaped thing; balls
除	to get rid of; to remove; to exclude; to eliminate; to wipe out; to divide; except; not including
纸	paper; classifier for documents, letter etc
陷	pitfall; trap; to get stuck; to sink; to cave in; to frame; to capture; to fall; defect
沦	to sink; to be reduced to
杀	to kill; to slay; to murder; to attack; to weaken; to reduce; to smart; extremely
叶	to be in harmony; surname Ye; leaf; page; lobe; period; classifier for small boats
割	to cut; to cut apart
纤	boatman's tow-rope; fine; delicate; minute; slim; slender
热	to warm up; to heat up; hot; heat; fervent
化	to make into; to change into; -ization; to ... -ize; to transform; abbr. for 化學|化学[hua4 xue2]
烘	to bake; to heat by fire; to set off by contrast
罗	surname Luo; gauze; to collect; to gather; to catch; to sift
叛	to betray; to rebel; to revolt
抗	to resist; to fight; to defy; anti-
副	secondary; auxiliary; deputy; assistant; vice-; abbr. for 副詞|副词 adverb; classifier for pairs, sets of things & facial expressions
各	each; every
滋	to grow; to nourish; to increase; to cause; juice; taste; to spout; to spurt
勾	surname Gou; to attract; to arouse; to tick; to strike out; to delineate; to collude; used in 勾當|勾当[gou4 dang4]
蕾	bud
擅	without authority; to usurp; to arrogate to oneself; to monopolize; expert in; to be good at
友	friend
忙	busy; hurriedly; to hurry; to rush
肥	fat; fertile; loose-fitting or large; to fertilize; to become rich by illegal means; fertilizer; manure
便	plain; informal; suitable; convenient; opportune; to urinate or defecate; equivalent to 就[jiu4]: then; in that case; even if; soon afterwards; used in 便宜|便宜[pian2 yi5]; used in 便便[pian2 pian2]; used in 便嬛[pian2 xuan1]; to poo poo; also pr. [bian3 bian3]; obese; bulging
晋	surname Jin; the Jin Dynasties; Western Jin 西晉|西晋[Xi1 Jin4], Eastern Jin 東晉|东晋[Dong1 Jin4]and Later Jin Dynasty; short name for Shanxi province 山西[Shan1 xi1]; to move forward; to promote; to advance
翘	outstanding; to raise; to stick up; to rise on one end; to tilt
卫	surname Wei; vassal state during the Zhou Dynasty, located in present day Henan and Hebei Provinces; to guard; to protect; to defend; abbr. for 衛生|卫生, hygiene; health; abbr. for 衛生間|卫生间, toilet
俏	good-looking; charming; in great demand; to season
滤	to strain; to filter
惚	indistinct
哄	roar of laughter; hubbub; to roar; to deceive; to coax; to amuse; tumult; uproar; commotion; disturbance
慢	slow; slowly
咬	to bite; to nip
乞	to beg
较	to compare; to dispute; compared to; relatively; comparatively; rather; also pr. [jiao3]
冠	surname Guan; hat; crown; crest; cap; to put on a hat; to be first; to dub
际	border; edge; boundary; interval; between; inter-; to meet; time; occasion; to meet with
沟	ditch; gutter; groove; gully; ravine
恭	respectful
订	to agree; to conclude; to draw up; to subscribe to; to order
散	scattered; loose; to come loose; to fall apart; leisurely; powdered medicine; to scatter; to break up; to disperse; to disseminate; to dispel; to sack
七	seven; 7
线	thread; string; wire; line; tier
亿	100 million
感	to feel; to move; to touch; to affect; feeling; emotion; sense of ~
虫	lower form of animal life, including insects, insect larvae, worms and similar creatures; person with a particular undesirable characteristic
眉	eyebrow; upper margin
的	of; ~'s; ; ; ; also pr. [di4] or [di5] in poetry and songs; a taxi; a cab; really and truly; bull's-eye; target
寞	lonesome
瞎	blind; groundlessly; foolishly; to no purpose
概	general; approximate
为	as; to take sth as; to act as; to serve as; to behave as; to become; to be; to do; by; because of; for; to; variant of 為|为[wei4]
薪	firewood; fuel; salary
诊	to examine or treat medically
失	to lose; to miss; to fail
妨	to hinder; harm; harm
雄	male; staminate; grand; imposing; powerful; mighty; person or state having great power and influence
侮	to insult; to ridicule; to disgrace
迎	to welcome; to meet; to forge ahead; to meet face to face
券	bond; contract; deed; ticket; voucher; certificate
麅	/variant of 狍[pao2]/
戚	grief; sorrow; sorrowful; distressed; surname Qi; relatives; kin; grief; sorrow; battle-axe; intimate; closely related; sorrowful; distressed
准	to allow; to grant; in accordance with; in the light of; accurate; standard; definitely; certainly; about to become; quasi-; para-
倡	to initiate; to instigate; to introduce; to lead
羡	to envy
魄	soul; mortal soul
秒	second; arc second; instantly
微	surname Wei; ancient Chinese state near present day Chongqing; Taiwan pr. [Wei2]; tiny; miniature; slightly; profound; abtruse; to decline; one millionth part of; micro-; Taiwan pr. [wei2]; slight; faint; humble
〇	zero
欢	joyous; happy; pleased; hubbub; clamor; a breed of horse
胃	stomach
害	to do harm to; to cause trouble to; harm; evil; calamity
贤	worthy or virtuous person; honorific used for a person of the same or a younger generation
聋	deaf
昨	yesterday
浪	wave; breaker; unrestrained; dissipated; to stroll; to ramble
哆	quiver; woolen cloth
梨	pear
绘	to draw; to paint; to depict; to portray
纫	to thread; to sew; to stitch; very grateful
青	abbr. for 青海[Qing1 hai3], Qinghai Province; green; blue; black; youth; young
蔽	to cover; to shield; to screen; to conceal
厕	restroom; toilet; lavatory; to be mingled with; to be involved in; used in 茅廁|茅厕[mao2 si5]
肯	to agree; to consent; to be willing to
塘	dyke; embankment; pool or pond; hot-water bathing pool
秤	steelyard; Roman balance
运	to move; to transport; to use; to apply; fortune; luck; fate
瘾	addiction; craving
隙	crack; crevice; gap or interval; loophole; discord; rift
改	to change; to alter; to transform; to correct
伞	umbrella; parasol; damask silk
痒	to itch; to tickle; to itch; to tickle; to itch; to tickle
矮	low; short
登	to scale; to ascend; to mount; to publish or record; to enter; to press down with the foot; to step or tread on; to put on; to be gathered and taken to the threshing ground
绍	surname Shao; to continue; to carry on
尸	person representing the dead; to put a corpse on display; corpse; corpse
汤	surname Tang; rushing current; soup; hot or boiling water; decoction of medicinal herbs; water in which sth has been boiled
骑	saddle horse; mounted soldier; to sit astride; to ride; classifier for saddle horses
厢	box; side room; side
仰	surname Yang; to face upward; to look up; to admire; to rely on
扫	to sweep; broom
畔	side; edge; boundary
由	to follow; from; because of; due to; by; via; through; it is for ... to ...
转	see 轉文|转文[zhuai3 wen2]; to turn; to change direction; to transfer; to forward; to share; to revolve; to turn; to circle about; to walk about; classifier for revolutions: revs, rpm; classifier for repeated actions; to stroll
损	to decrease; to lose; to damage; to harm; to ridicule; to deride; caustic; sarcastic; nasty; mean; one of the 64 hexagrams of the Book of Changes: ䷨
脉	arteries and veins; vein; see 脈脈|脉脉[mo4 mo4]; affectionate; loving
悄	used in 悄悄[qiao1 qiao1]; quiet; sad; quiet; making little or no noise; surreptitious; stealthy; anxious; worried; Taiwan pr. [qiao3 qiao3]
酸	sour; tart; sick at heart; grieved; sore; aching; pedantic; impractical; to make sarcastic remarks about sb; an acid
置	to install; to place; to put; to buy
肿	to swell; swelling; swollen
栋	classifier for houses or buildings; ridgepole
念	to read; to study; to attend; to read aloud; to givea tongue-lashing; to miss; idea; remembrance; twenty
号	roar; cry; ordinal number; day of a month; mark; sign; business establishment; size; ship suffix; horn; bugle call; assumed name; to take a pulse; classifier used to indicate number of people
眨	to blink; to wink
瘦	thin; to lose weight; tight; lean; unproductive
恒	surname Heng; permanent; constant; fixed; usual; ordinary; rule; one of the 64 hexagrams of the Book of Changes
筋	muscle; tendon; veins visible under the skin; sth resembling tendons or veins
勉	to exhort; to make an effort
服	clothes; dress; garment; to serve; to obey; to be convinced; to convince; to admire; to acclimatize; to take; mourning clothes; to wear mourning clothes; classifier for medicine: dose; Taiwan pr. [fu2]; clothes
障	to block; to hinder; to obstruct
彩	color; variety; applause; applaud; lottery prize
俩	two; both; some; used in 伎倆|伎俩[ji4 liang3]
让	to yield; to permit; to let sb do sth; to have sb do sth; to make sb; by
康	surname Kang; healthy; peaceful; abundant
陌	raised path; street; Momo, GPS-based app for messaging, and potentially meeting up with, other Momo usersin one's vicinity, launched in 2011
劣	inferior
术	method; technique; various genera of flowers of Asteracea family, including Atractylis lancea
悬	to hang or suspend; to worry; public announcement; unresolved; baseless; without foundation
酱	thick paste of fermented soybean; marinated in soy paste; paste; jam
私	personal; private; selfish
胀	to swell; dropsical; swollen; bloated
迸	to burst forth; to spurt; to crack; split
统	to gather; to unite; to unify; whole; totally
暑	heat; hot weather; summer heat
季	surname Ji; season; the last month of a season; fourth or youngest amongst brothers; classifier for seasonal crop yields
问	to ask; to inquire
误	mistake; error; to miss; to harm; to delay; to neglect; mistakenly
利	surname Li; sharp; favorable; advantage; benefit; profit; interest; to do good to; to benefit
倔	used in 倔強|倔强[jue2 jiang4]; gruff; surly
仗	weaponry; to hold; to wield; to rely on; to depend on; war; battle
宗	surname Zong; school; sect; purpose; model; ancestor; clan; to take as one's model; classifier for batches, items, cases, reservoirs
挨	in order; in sequence; close to; adjacent to; to suffer; to endure; to pull through; to delay; to stall; to play for time; to dawdle
品	article; commodity; product; goods; grade; rank; kind; type; variety; character; disposition; nature; temperament; to taste sth; to sample; to criticize; to comment; to judge; to size up; fret
堪	may; can; to endure; to bear; heaven
隧	tunnel; underground passage
角	surname Jue; angle; corner; horn; horn-shaped; unit of money equal to 0.1 yuan, or 10 cents; role; to compete; ancient three legged wine vessel; third note of pentatonic scale
降	to drop; to fall; to come down; to descend; to surrender; to capitulate; to subdue; to tame
岛	island
兑	surname Dui; to cash; to exchange; to add; to blend; one of the Eight Trigrams 八卦[ba1 gua4], symbolizing swamp; ☱
根	root; basis; classifier for long slender objects, e.g. cigarettes, guitar strings; radical
迄	as yet; until
档	shelves; pigeonholes; files; crosspiece; grade; vendor's open-air stall; timeslot for a show or program; classifier for shows; classifier for events, affairs etc; Taiwan pr. [dang3]
燕	Yan, a vassal state of Zhou in modern Hebei and Liaoning; north Hebei; the four Yan kingdoms of the Sixteen Kingdoms, namely: Former Yan 前燕[Qian2 Yan1], Later Yan 後燕|后燕[Hou4 Yan1], Southern Yan 南燕[Nan2 Yan1], Northern Yan 北燕[Bei3 Yan1]; surname Yan; swallow; variant of 燕[yan4]
靠	to lean against or on; to stand by the side of; to come near to; to depend on; to trust; to fuck; traditional military costume drama where the performers wear armor
抬	to lift; to raise; to carry
睹	to observe; to see
芽	bud; sprout
慰	to comfort; to console; to reassure
阻	to hinder; to block; to obstruct
负	to bear; to carry; to turn one's back on; to be defeated; negative
麦	surname Mai; wheat; barley; oats
蔑	to belittle; nothing; defiled with blood
梢	tip of branch
奉	to offer; to present respectfully; to esteem; to revere; to believe in; to wait upon; to accept orders
邀	to invite; to request; to intercept; to solicit; to seek
女	female; woman; daughter
路	surname Lu; road; journey; route; line; sort; kind
炭	wood charcoal; coal
爪	foot of a bird or animal; paw; claws; talons; foot of an animal or bird; foot supporting a cooking pot etc
现	to appear; present; now; existing; current
索	surname Suo; abbr. for 索馬里|索马里[Suo3 ma3 li3], Somalia; to search; to demand; to ask; to exact; large rope; isolated; trembling
钦	surname Qin; to respect; to admire; to venerate; by the emperor himself
授	to confer; to give; to teach; to instruct; to appoint
峻	high; harsh or severe
姨	mother's sister; aunt
被	quilt; to cover; to suffer; used to indicate passive voice; used to indicate that the following word should be regarded as being in air quotes
升	to ascend; to rise to the rank of; to promote; to hoist; liter; measure for dry grain equal to one-tenth dou 斗[dou3]; variant of 升[sheng1]
乙	second of the ten Heavenly Stems 十天干[shi2 tian1 gan1]; second in order; letter "B" or Roman "II" in list "A, B, C", or "I, II, III" etc; second party; ethyl; bent; winding; radical in Chinese characters; ancient Chinese compass point: 105°; turning stroke, aka 折[zhe2]
林	surname Lin; Japanese surname Hayashi; woods; forest; circle; a collection
喷	to spout; to spurt; to spray; to puff; to criticize scathingly; strong; peak season; 
涕	tears; nasal mucus
篮	basket; basket
病	illness; disease; to fall ill; defect
廓	extensive; vast; outline; general shape; to expand; to extend
灌	to irrigate; to pour; to install; to record
烛	candle; to illuminate
任	surname Ren; Ren County 任縣|任县[Ren2 Xian4] in Hebei; to assign; to appoint; to take up a post; office; responsibility; to let; to allow; to give free rein to; no matter; classifier for terms served in office, or for spouses, girlfriends etc
源	root; source; origin
异	different; other; hetero-; unusual; strange; surprising; to distinguish; to separate; to discriminate
濒	to approach; to border on; near
锤	hammer; to hammer into shape; weight; to strike with a hammer
依	to depend on; to comply with or listen to sb; according to; in the light of; reluctant to part; soft and pliable, swaying in the wind
蜘	see 蜘蛛[zhi1 zhu1]
尖	pointed; tapering; sharp; shrill; piercing; sharp; acute; keen; to makeshrill; sharp point; tip; the best of sth; the cream of the crop; sharp; pointed
惑	to confuse; to be puzzled
篇	sheet; piece of writing; bound set of bamboo slips used for record keeping; classifier for written items: chapter, article
嫂	older brother's wife; sister-in-law; older brother's wife; sister-in-law; sister
乳	breast; milk
诽	slander
葩	corolla of flower
壕	moat; trench
正	first month of the lunar year; straight; upright; proper; main; principal; to correct; to rectify; exactly; just; right; positive; neat; orderly; just in time
申	old name for Shanghai 上海[Shang4 hai3]; surname Shen; to extend; to state; to explain; 9th earthly branch: 3-5 p.m., 7th solar month, year of the Monkey; ancient Chinese compass point: 240°; cozy and comfortable; to repeat endlessly
遏	to restrain; to check; to hold back
躁	impatient; hot-tempered
伏	surname Fu; to lean over; to fall; to hide; to conceal oneself; to lie low; hottest days of summer; to submit; to concede defeat; to overcome; to subdue; volt
陡	steep; precipitous; abrubtly; suddenly; unexpectedly
恨	to hate; to regret
膀	upper arm; wing; used in 吊膀子[diao4 bang4 zi5]; puffed; bladder
橙	orange tree; orange
拼	to piece together; to join together; to stake all; adventurous; at the risk of one's life; to spell
苟	surname Gou; if indeed; careless; negligent; temporarily
筑	short name for Guiyang 貴陽|贵阳[Gui4 yang2]; five-string lute; Taiwan pr. [zhu2]; to build; to construct; to ram; to hit; Taiwan pr. [zhu2]
菌	germ; bacteria; fungus; mold; Taiwan pr. [jun4]; mushroom
户	a household; door; family
径	footpath; track; diameter; straight; directly
备	to prepare; to equip; fully; in every possible way
盈	full; filled; surplus
争	to strive for; to vie for; to argue or debate; deficient or lacking; how or what
映	to reflect; to shine; to project
银	silver; silver-colored; relating to money or currency
避	to avoid; to shun; to flee; to escape; to keep away from; to leave; to hide from
躬	body; to bow; oneself; personally
唾	saliva; to spit
对	right; correct; towards; at; for; concerning; regarding; to treat; to face; opposite; facing; matching; to match together; to adjust; to fit; to suit; to answer; to reply; to add; to pour in; to check; to compare; classifier: couple; pair
魅	demon; magic; to charm
站	station; to stand; to halt; to stop; branch of a company or organization; website
智	wise; wisdom
你	you; you
端	end; extremity; item; port; to hold sth level with both hands; to carry; regular; start; origin
近	near; close to; approximately
讥	to ridicule
俄	Russia; Russian; abbr. for 俄羅斯|俄罗斯[E2 luo2 si1]; Taiwan pr. [E4]; suddenly; very soon
哦	to chant; oh; oh; sentence-final particle that conveys informality, warmth, friendliness or intimacy; may also indicate that one is stating a fact that the other person is not aware of
乱	in confusion or disorder; in a confused state of mind; disorder; upheaval; riot; illicit sexual relations; to throw into disorder; to mix up; indiscriminate; random; arbitrary
勇	brave
饥	hungry
张	surname Zhang; to open up; to spread; sheet of paper; classifier for flat objects, sheet; classifier for votes
般	sort; kind; class; way; manner; see 般樂|般乐[pan2 le4]
牌	mahjong tile; playing card; game pieces; signboard; plate; tablet; medal
兵	soldiers; a force; an army; weapons; arms; military; warlike
视	variant of 示[shi4]; to look at
拆	to tear open; to tear down; to tear apart; to open
刷	to brush; to paint; to daub; to paste up; to skip class; to fire from a job; to select
坑	pit; depression; hollow; tunnel; hole in the ground; to bury alive; to hoodwink; to cheat
抖	to tremble; to shake out; to reveal; to make it in the world
级	level; grade; rank; step; classifier: step, level
努	to exert; to strive
甩	to throw; to fling; to swing; to leave behind; to throw off; to dump
高	surname Gao; high; tall; above average; loud; your
枕	pillow; to pillow; to rest one's head on
声	sound; voice; tone; noise; reputation; classifier for sounds
强	surname Qiang; stubborn; unyielding; strong; powerful; better; slightly more than; vigorous; violent; best in their category, e.g. see 百強|百强[bai3 qiang2]; to force; to compel; to strive; to make an effort; variant of 強|强[qiang2]
吟	to chant; to recite; to moan; to groan; cry; song
窍	hole; opening; orifice; key
捍	to ward off; to withstand; to defend
膜	membrane; film
八	eight; 8
倍	-fold; times; double; to increase or multiply
汇	to remit; to converge; to exchange; class; collection
陶	surname Tao; pottery; pleased
咀	to chew; to masticate
腾	to gallop; to prance; to soar; to hover; to make room; to clear out; to vacate; ; steaming; scathing
攒	to bring together; to collect; to hoard; to accumulate; to save
妹	younger sister; younger sister; young woman
始	to begin; to start; then; only then
懵	stupid
写	to write
奥	Austria; Olympics; obscure; mysterious
寓	to reside; to imply; to contain; residence
锲	to cut; to carve; to engrave; to chisel; fig. to chisel away at
臊	to smell of urine; shame; bashfulness; to shame; to humiliate
捧	to hold or offer with both hands; to sing the praises of; classifier for what can be held in both hands
墨	surname Mo; abbr. for 墨西哥[Mo4 xi1 ge1], Mexico; ink stick; China ink; corporal punishment consisting of tattooing characters on the victim's forehead
舞	to dance; to wield; to brandish
井	Jing, one of the 28 constellations of Chinese astronomy; surname Jing; a well; neat; orderly; always clean; orderly; methodical
列	to arrange; to line up; file; series; column; row
取	to take; to get; to choose; to fetch
单	surname Shan; bill; list; form; single; only; sole; odd number; only; merely; just
协	to cooperate; to harmonize; to help; to assist; to join
客	customer; visitor; guest
恍	in a hazy state of mind; to snap out of that state; used in 恍如[huang3 ru2] and 恍若[huang3 ruo4]
锻	to forge; to discipline; wrought
方	surname Fang; square; power or involution; upright; honest; fair and square; direction; side; party; place; method; prescription; just when; only or just; classifier for square things; abbr. for square or cubic meter
乐	surname Le; surname Yue; happy; cheerful; to laugh; music
咱	see 咱[zan2]; I or me; we
溅	to splash
履	shoe; to tread on
央	center; end; to beg; to plead
遭	to meet by chance; classifier for events: time, turn, incident
著	to make known; to show; to prove; to write; book; outstanding
胖	healthy; at ease; fat; plump
叔	uncle; father's younger brother; husband's younger brother; Taiwan pr. [shu2]; father's younger brother; uncle; Taiwan pr. [shu2 shu5]
续	to continue; to replenish; continuous; on and on; running
资	resources; capital; to provide; to supply; to support; money; expense
沐	to bathe; to cleanse; to receive; to be given
丽	Korea; beautiful; Lili
午	7th earthly branch: 11 a.m.-1 p.m., noon, 5th solar month, year of the Horse; ancient Chinese compass point: 180°
甭	need not; please don't; very
辈	lifetime; generation; group of people; class; classifier for generations; classifier for people
寨	stronghold; stockade; camp; village
钟	surname Zhong; handleless cup; goblet; to concentrate; clock; o'clock; time as measured in hours and minutes; bell
庇	to protect; cover; shelter; hide or harbor
扬	abbr. for 揚州|扬州[Yang2 zhou1]; surname Yang; to raise; to hoist; the action of tossing or winnowing; scattering; to flutter; to propagate
迫	to persecute; to oppress; embarrassed; used in 迫擊炮|迫击炮[pai3 ji1 pao4]; to force; to compel; to approach or go towards; urgent; pressing
含	to keep in the mouth; to contain
犹	as if; like; just as; still; yet
非	abbr. for 非洲[Fei1 zhou1], Africa; to not be; not; wrong; incorrect; non-; un-; in-; de-; to reproach; to blame; to insist on; simply must
灵	quick; alert; efficacious; effective; to come true; spirit; departed soul; coffin
旬	ten days; ten years; full period
郎	surname Lang; minister; official; noun prefix denoting function or status; a youth
投	to throw; to cast; to cast; to put in; to send; to throw oneself into; to go to; to seek refuge; to place oneself into the hands of; to rinsein water
探	to explore; to search out; to scout; to visit; to stretch forward
铭	to engrave; inscribed motto
掷	to toss; to throw dice; Taiwan pr. [zhi2]
辨	to distinguish; to recognize
珠	bead; pearl
素	raw silk; white; plain, unadorned; vegetarian; essence; nature; element; constituent; usually; always; ever
竖	to erect; vertical; vertical stroke
蓄	to store up; to grow; to entertain
舍	to give up; to abandon; to give alms; surname She; residence
益	surname Yi; benefit; profit; advantage; beneficial; to increase; to add; all the more
学	to learn; to study; to imitate; science; -ology
船	boat; vessel; ship
乒	ping; bing
茶	tea; tea plant
厘	Li, sixth of the legendary Flame Emperors 炎帝[Yan2 di4] descended from Shennong 神農|神农[Shen2 nong2] Farmer God, also known as Ai 哀[Ai1]; one hundredth; centi-
干	surname Gan; dry; dried food; empty; hollow; taken in to nominal kinship; adoptive; foster; futile; in vain; rude; blunt; to cold-shoulder; surname Gan; to have to do with; to concern oneself with; one of the ten heavenly stems 天干[tian gan1]; shield; tree trunk; main part of sth; to manage; to work; to do; capable; cadre; to kill; to fuck; pissed off; annoyed
扰	to disturb
麻	hemp; surname Ma; generic name for hemp, flax etc; hemp or flax fiber for textile materials; sesame; rough or coarse; pocked; pitted; to have pins and needles or tingling; to feel numb
踪	footprint; trace; tracks
稿	manuscript; draft; stalk of grain
场	threshing floor; classifier for events and happenings: spell, episode, bout; large place used for a specific purpose; stage; scene; classifier for sporting or recreational activities; classifier for number of exams; variant of 場|场[chang3]
位	position; location; place; seat; classifier for people; classifier for binary bits; potential
吹	to blow; to play a wind instrument; to blast; to puff; to boast; to brag; to end in failure; to fall through
魔	evil spirit; devil; supernatural; magical
援	to help; to assist; to aid
阵	disposition of troops; wave; spate; burst; spell; short period of time; classifier for events or states of short duration
挫	obstructed; to fail; to oppress; to repress; to lower the tone; to bend back; to dampen
乖	obedient, well-behaved; clever; shrewd; alert; perverse; contrary to reason; irregular; abnormal; well-behaved; obediently; darling; sweetie; goodness gracious!; oh my lord!
往	to go; to; towards; bound for; past; previous; usually; in many cases; more often than not
摸	to feel with the hand; to touch; to stroke; to grope; to steal; to abstract
鲁	surname Lu; Lu, ancient state of China 魯國|鲁国[Lu3 guo2]; Lu, short name for Shandong 山東|山东[Shan1 dong1]; crass; stupid; rude; 
勒	bridle; halter; headstall; to rein in; to compel; to force; to carve; to engrave; to command; to lead; lux; to strap tightly; to bind
训	to teach; to train; to admonish; instruction; teachings; rule
下	down; downwards; below; lower; later; next; second; to decline; to go down; to arrive at; measure word to show the frequency of an action
丢	to lose; to put aside; to throw
洒	to sprinkle; to spray; to spill; to shed
罢	to stop; to cease; to dismiss; to suspend; to quit; to finish; 
搁	to place; to put aside; to shelve; to bear; to stand; to endure
绿	green; to cheat on
码	weight; number; code; to pile; to stack; classifier for length or distance, happenings etc
忠	loyal; devoted; faithful
霾	haze
轰	explosion; bang; boom; rumble; to attack; to shoo away; to expel; booming; roaring
矛	spear; lance; pike
断	to break; to snap; to cut off; to give up or abstain from sth; to judge; absolutely; definitely; decidedly
值	value; worth; to happen to; to be on duty
怼	to attack verbally; to publicly criticize; to call out; dislike; hate
秀	refined; elegant; graceful; beautiful; superior; excellent; show; to grow; to bloom;to produce ears
颗	classifier for small spheres, pearls, corn grains, teeth, hearts, satellites etc
颠	top; apex; to fall forwards; inverted; to jolt; glad and diligent
岗	hillock; mound; sentry post; policeman's beat; job; post
羞	shy; ashamed; shame; bashful; delicacies
掠	to take over by force; to rob; to plunder; to brush over; to skim; to sweep
倒	to fall; to collapse; to lie horizontally; to fail; to go bankrupt; to overthrow; to change; to move around; to resell at a profit; to invert; to place upside down or frontside back; to pour out; to tip out; to dump; inverted; upside down; reversed; to go backward; contrary to what one might expect; but; yet
少	few; less; to lack; to be missing; to stop; seldom; young
草	grass; straw; manuscript; draft; careless; rough; carelessly; hastily
宅	residence; to stay in at home; to hang around at home
熟	ripe; mature; thoroughly cooked; done; familiar; acquainted; experienced; skilled; deep; profound; also pr. [shou2]
扣	to fasten; to button; button; buckle; knot; to arrest; to confiscate; to deduct; discount; to knock; to smash, spike or dunk; to cover; to tag a label on sb; code; QQ instant messenger; button
沫	foam; suds
渣	slag; dregs
京	abbr. for Beijing; surname Jing; Jing ethnic minority; capital city of a country; big; algebraic term for a large number; artificial mound
债	debt
独	alone; independent; single; sole; only; alone
愉	pleased
惦	to think of; to remember; to miss
欣	happy
氏	clan name; maiden name; see 月氏[Yue4 zhi1] and 閼氏|阏氏[yan1 zhi1]
婴	infant; baby
耽	to indulge in; to delay
岂	old variant of 凱|凯[kai3]; how?
平	surname Ping; flat; level; equal; to tie; to draw; calm; peaceful; abbr. for 平聲|平声[ping2 sheng1]; average; mediocre
黄	surname Huang or Hwang; yellow; pornographic; to fall through
崎	mountainous
丹	red; pellet; powder; cinnabar
广	"house on a cliff" radical in Chinese characters, occurring in 店, 序, 底 etc; surname Guang; wide; numerous; to spread
田	surname Tian; field; farm
击	to hit; to strike; to break; Taiwan pr. [ji2]
库	warehouse; storehouse; library
喊	to yell; to shout; to call out for
众	abbr. for 眾議院|众议院[Zhong4 yi4 yuan4], House of Representatives; crowd; multitude; many; numerous
掉	to fall; to drop; to lag behind; to lose; to go missing; to reduce; fall; to lose; to wag; to swing; to turn; to change; to exchange; to swap; to show off; to shed; 
武	surname Wu; martial; military
途	way; route; road
哭	to cry; to weep
墟	ruins; village; country fair
具	tool; device; utensil; equipment; instrument; talent; ability; to possess; to have; to provide; to furnish; to state; classifier for devices, coffins, dead bodies
审	to examine; to investigate; carefully; to try
古	surname Gu; ancient; old; paleo-
悔	to regret; to repent
奖	prize; award; encouragement
卵	egg; ovum; spawn; testicles; penis; fucking
队	squadron; team; group
保	Bulgaria; to defend; to protect; to keep; to guarantee; to ensure; civil administration unit in the baojia 保甲[bao3 jia3] system
测	to survey; to measure; to conjecture
商	Shang Dynasty; surname Shang; commerce; merchant; dealer; to consult; 2nd note in pentatonic scale; quotient
班	surname Ban; team; class; grade; squad; work shift; classifier for groups of people and scheduled transport vehicles
雪	surname Xue; snow; to wipe away
雹	hail
穴	cave; cavity; hole; acupuncture point; Taiwan pr. [xue4]
着	move; trick; all right!; to add; to touch; to come in contact with; to feel; to be affected by; to catch fire; to burn; to fall asleep; hitting the mark; succeeding in; aspect particle indicating action in progress or ongoing state; to wear; to contact; to use; to apply
血	blood; colloquial pr. [xie3]
餐	meal; to eat; classifier for meals
寝	to lie down to sleep or rest; bedroom; imperial tomb; to stop; to cease
宵	night
纹	line; trace; mark; pattern; grain
厌	to loathe; to be fed up with; to satiate; to satisfy
员	person engaged in a certain field of activity; member
嚷	to shout; to bellow; to make a big deal of sth; to make a fuss about sth; to argue noisily; to shout; to make widely known; to reproach
手	hand; to hold; person engaged in certain types of work; person skilled in certain types of work; personal; convenient; classifier for skill
练	to practice; to train; to drill; to perfect; exercise; white silk; to boil and scour raw silk
傍	near; approaching; to depend on; to have an intimate relationship with sb; Taiwan pr. [pang2], [bang1], [bang4]
判	to differentiate; to distinguish; clearly; to judge; to decide; to grade; to sentence
紫	purple; violet
聊	to chat; temporarily; for a while; somewhat; slightly; to depend upon
斥	to blame; to reprove; to reprimand; to expel; to oust; to reconnoiter; to expand; saline marsh
孔	surname Kong; hole; classifier for cave dwellings
昼	daytime
玫	; used in 玫瑰[mei2 gui1]
观	surname Guan; to look at; to watch; to observe; to behold; to advise; concept; point of view; outlook; Taoist monastery; palace gate watchtower; platform
册	book; booklet; classifier for books
毁	to destroy; to ruin; to defame; to slander; to destroy by fire; to defame; to slander
膊	shoulder; upper arm
猛	ferocious; fierce; violent; brave; suddenly; abrupt; awesome
犬	dog; Kangxi radical 94
沾	to moisten; to be infected by; to receive benefit or advantage through a contact; to touch; to moisten
拦	to block sb's path; to obstruct; to flag down
执	to execute; to grasp
塔	pagoda; tower; minaret; stupa
支	surname Zhi; to support; to sustain; to erect; to raise; branch; division; to draw money; classifier for rods such as pens and guns, for army divisions and for songs or compositions
喂	hello; hey; to feed; to feed
售	to sell; to make or carry out
工	work; worker; skill; profession; trade; craft; labor
乃	to be; thus; so; therefore; then; only; thereupon
碾	stone roller; roller and millstone; to grind; to crush; to husk
禽	generic term for birds and animals; birds; to capture
腔	cavity; tune; accent; 
承	surname Cheng; Cheng, third of the legendary Flame Emperors 炎帝[Yan2 di4] descended from Shennong 神農|神农[Shen2 nong2] Farmer God; to bear; to carry; to hold; to continue; to undertake; to take charge; owing to; due to; to receive
范	pattern; model; example; surname Fan
扮	to disguise oneself as; to dress up; to play; to put on
式	type; form; pattern; style
睁	to open
寻	to search; to look for; to seek
累	to accumulate; to involve or implicate; continuous; repeated; tired; weary; to strain; to wear out; to work hard; clusters of; piles of; heaps of; gaunt; haggard; wretched; Taiwan pr. [lei3 lei3]; again and again; innumerable; repeated; riddled with; accumulated; surname Lei; rope; to bind together; to twist around
廊	corridor; veranda; porch
舶	ship
偶	accidental; image; pair; mate
桥	bridge
迟	surname Chi; late; delayed; slow; late; slow
杯	cup; trophy cup; classifier for certain containers of liquids: glass, cup; variant of 杯[bei1]; trophy cup; classifier for certain containers of liquids: glass, cup
摧	to break; to destroy; to devastate; to ravage; to repress
跑	to paw; to run; to run away; to escape; to run around; to leak or evaporate; away; off
壶	pot; classifier for bottled liquid
次	next in sequence; second; the second; secondary; vice-; sub-; infra-; inferior quality; substandard; order; sequence; hypo-; classifier for enumerated events: time
慕	to admire
尾	tail; remainder; remnant; extremity; sixth of the 28 constellations; classifier for fish; horse's tail; pointed posterior section of a locust etc
骤	sudden; unexpected; abrupt; suddenly; Taiwan pr. [zou4]
狱	prison
埋	to bury; used in 埋怨[man2 yuan4]
心	heart; mind; intention; center; core
思	to think; to consider
胎	fetus; classifier for litters; padding; womb carrying a fetus; origin; source; tire
巢	surname Chao; nest
嫖	to visit a prostitute
丝	silk; thread-like thing;shreds or julienne strips; classifier: a trace, a tiny bit etc
暴	surname Bao; sudden; violent; cruel; to show or expose; to injure
汹	torrential rush; tumultuous
焰	flame
琢	to cut; used in 琢磨[zuo2 mo5]; Taiwan pr. [zhuo2]
性	nature; character; property; quality; attribute; sexuality; sex; gender; suffix forming adjective from verb; suffix forming noun from adjective, corresponding to -ness or -ity; essence
萄	used in 葡萄[pu2 tao5]
讨	to invite; to provoke; to demand or ask for; to send armed forces to suppress; to denounce or condemn; to marry; to discuss or study
获	to catch; to capture; to get; to obtain; to win; to reap; to harvest
窝	nest; pit or hollow on the human body; lair; den; place; to harbor or shelter; to hold in check; to bend; classifier for litters and broods
刚	hard; firm; strong; just; barely; exactly; just recently; just a moment ago
鸦	crow
踢	to kick; to play; butch
杂	mixed; miscellaneous; various; to mix
娘	mother; young lady; effeminate; queen; empress; imperial concubine; Goddess, esp. Xi Wangmu 王母娘娘 or 西王母, Queen Mother of the West; mother; aunt
灾	disaster; calamity; old variant of 災|灾[zai1]
稠	dense; crowded; thick; many
并	and; furthermore; also; together with; at all; simultaneously; to combine; to join; to merge; to combine; to amalgamate; short name for Taiyuan 太原[Tai4 yuan2]
晃	to dazzle; to flash past; to sway; to shake; to wander about
漠	desert; unconcerned
撒	to let go; to cast; to let loose; to discharge; to give expression to; to pee; to scatter; to sprinkle; to spill
圣	to dig; holy; sacred; saint; sage
噪	to chirp; to make a cacophonous noise
头	head; hair style; the top; end; beginning or end; a stub; remnant; chief; boss; side; aspect; first; leading; classifier for pigs or livestock; suffix for nouns; head; chief
秋	surname Qiu; autumn; fall; harvest time; see 鞦韆|秋千[qiu1 qian1]
囧	emoticon signifying embarrassment, shock, helplessness etc
辕	shafts of cart; yamen
睬	to pay attention; to take notice of; to care for
惕	fearful; respectful
洞	cave; hole; zero
莓	berry; strawberry
熏	to smoke; to fumigate; to assail the nostrils; to perfume; fragrance; warm; to educate; to smoke; to fumigate
察	short name for Chahar Province 察哈爾|察哈尔[Cha2 ha1 er3]; to examine; to inquire; to observe; to inspect; to look into; obvious; clearly evident; clean; spotless
带	band; belt; girdle; ribbon; tire; area; zone; region; to wear; to carry; to take along; to bear; to lead; to bring; to look after; to raise
蝴	used in 蝴蝶[hu2 die2]
景	surname Jing; scenery; circumstance; situation; scene; sunlight
辟	king; monarch; to summon to official service; to repel; penal law; to open; to open up; to dispel; to refute; to repudiate; penetrating; incisive
烁	bright; luminous; flickering; glittering
灯	lamp; light; lantern
鐵	no definition found
哪	how; which; ; used in 哪吒[Ne2 zha1]; Taiwan pr. [nuo2]; which?
稚	infantile; young; variant of 稚[zhi4]
俱	all; both; entirely; without exception; to be together; to be alike
哑	sound of cawing; sound of infant learning to talk; mute; dumb; incapable of speech; hoarse; husky; dud
马	surname Ma; abbr. for Malaysia 馬來西亞|马来西亚[Ma3 lai2 xi1 ya4]; horse; horse or cavalry piece in Chinese chess; knight in Western chess
疗	to treat; to cure; therapy
俗	custom; convention; popular; common; coarse; vulgar; secular
种	seed; species; kind; type; classifier for types, kinds, sorts; to plant; to grow; to cultivate; all kinds of
胁	flank; to coerce; to threaten
节	see 節骨眼|节骨眼[jie1 gu5 yan3]; joint; node; section; segment; solar term; seasonal festival; to economize; to save; moral integrity; chastity; classifier for segments: lessons, train wagons, biblical verses etc; knot; step by step; little by little
洛	surname Luo; old name of several rivers; used in transliteration
播	to sow; to scatter; to spread; to broadcast; Taiwan pr. [bo4]
帖	fitting snugly; appropriate; suitable; to paste; to obey; invitation card; notice; rubbing from incised inscription
曝	to air; to sun
吞	to swallow; to take
显	to make visible; to reveal; prominent; conspicuous; phanero-
寡	few; scant; widowed
肪	animal fat
免	to excuse sb; to exempt; to remove or dismiss from office; to avoid; to avert; to escape; to be prohibited
誉	to praise; to acclaim; reputation
核	pit; stone; nucleus; nuclear; to examine; to check; to verify; to investigate
烫	to scald; to burn; to blanch; to heatup in hot water; to perm; to iron; scalding hot
胆	gall bladder; courage; guts; gall; inner container
门	surname Men; gate; door; gateway; doorway; opening; valve; switch; way to do something; knack; family; house; sect; school; class; category; phylum or division; classifier for large guns; classifier for lessons, subjects, branches of technology; -gate
求	to seek; to look for; to request; to demand; to beseech
杰	hero; heroic; outstanding person; prominent; distinguished
离	mythical beast; surname Li; to leave; to part from; to be away from; from; without; independent of; one of the Eight Trigrams 八卦[ba1 gua4], symbolizing fire; ☲
令	used in 脊令[ji2 ling2]; used in 令狐[Ling2 hu2]; classifier for a ream of paper; to order; to command; an order; warrant; writ; to cause; to make sth happen; virtuous; honorific title; season; government position; type of short song or poem
撸	to rub one's hand along; to fire; to reprimand
技	skill
培	to bank up with earth; to cultivate; to train
排	a row; a line; to set in order; to arrange; to line up; to eliminate; to drain; to push open; platoon; raft; classifier for lines, rows etc
璃	; Taiwan pr. [li4]; colored glaze; glass
屿	islet
艇	vessel; small ship
辫	a braid or queue; to plait
铺	store; to spread; to display; to set up; holder for door-knocker; plank bed; place to sleep; shop; store; relay station
缺	deficiency; lack; scarce; vacant post; to run short of
茄	phonetic character used in loanwords for the sound "jia", although 夾|夹[jia2] is more common; eggplant
税	taxes; duties
譬	to give an example
隘	pass; defile; narrow; confined; in distress
枝	branch; classifier for sticks, rods, pencils etc
接	to receive; to answer; to meet or welcome sb; to connect; to catch; to join; to extend; to take one's turn on duty; to take over for sb
瑰	; extraordinary
粒	grain; granule; classifier for small round things
揭	surname Jie; to take the lid off; to expose; to unmask
疯	insane; mad; wild
旁	one side; other; different; lateral component of a Chinese character
措	to handle; to manage; to put in order; to arrange; to administer; to execute; to take action on; to plan
彰	clear; conspicuous; manifest; obvious; manifest; clearly visible
咽	throat; pharynx; narrow pass; to choke; to swallow
控	to control; to accuse; to charge; to sue; to invert a container to empty it; buff; enthusiast; devotee; -phile or -philia
紊	involved; tangled; disorderly; confused; chaotic; Taiwan pr. [wen4]
溶	to dissolve; soluble
奈	used in expressions that convey frustration and futility, such as 無奈|无奈[wu2 nai4] and 莫可奈何|莫可奈何[mo4 ke3 nai4 he2]; used for its phonetic value in writing foreign words
督	to supervise
防	to protect; to defend; to guard against; to prevent
耀	brilliant; glorious
殃	calamity
摔	to throw down; to fall; to drop and break
拱	to cup one's hands in salute; to surround; to arch; to dig earth with the snout; arched
哺	to feed; to eat; evening meal
跨	to step across; to stride over; to straddle; to span
饭	cooked rice; meal; fan; devotee
嗦	suck
痕	scar; traces
书	abbr. for 書經|书经[Shu1 jing1]; book; letter; document; to write
驳	variegated; heterogeneous; to refute; to contradict; to ship by barge; a barge; a lighter
界	boundary; border; realm
则	but; then; standard; norm; principle; to imitate; to follow; classifier for written items
爽	bright; clear; crisp; open; frank; straightforward; to feel well; fine; pleasurable; invigorating; to deviate
礼	surname Li; abbr. for 禮記|礼记[Li3 ji4], Classic of Rites; gift; rite; ceremony; propriety; etiquette; courtesy
呢	particle indicating that a previously asked question is to be applied to the preceding word; particle for inquiring about location; particle signaling a pause, to emphasize the preceding words and allow the listener time to take them on board; particle indicating continuation of a state or action; particle indicating strong affirmation; woolen material; garrulous; talkative
肩	shoulder; to shoulder
拒	to resist; to repel; to refuse
膨	swollen
啊	interjection of surprise; Ah!; Oh!; interjection expressing doubt or requiring answer; Eh?; what?; interjection of surprise or doubt; Eh?; My!; what's up?; interjection or grunt of agreement; uhm; Ah, OK; expression of recognition; Oh, it's you!; modal particle ending sentence, showing affirmation, approval, or consent
贵	expensive; highly valued; precious; noble; of high rank; your
衣	clothes; Kangxi radical 145; to dress; to wear; to put on
椒	pepper
肺	lung
宏	great; magnificent; macro; macro-
谋	to plan; to seek; scheme
眠	to sleep; to hibernate
听	smile; to listen to; to hear; to heed; to obey; a can; classifier for canned beverages; to let be; to allow; to administer; to deal with
偏	to lean; to slant; oblique; prejudiced; to deviate from average; to stray from the intended line; stubbornly; contrary to expectations; unfortunately; as it happened; stubbornly; contrarily; against reason; precisely; only; of all people
澈	clear; thorough
乘	surname Cheng; to ride; to mount; to make use of; to avail oneself of; to take advantage of; to multiply; Buddhist sect or creed; four horse military chariot; four; generic term for history books
敲	to hit; to strike; to tap; to rap; to knock; to rip sb off; to overcharge
畅	free; unimpeded; smooth; at ease; free from worry; fluent
混	brainless; foolish; Taiwan pr. [hun4]; to mix; to mingle; muddled; to drift along; to muddle along; to pass for; to get along with sb; thoughtless; reckless
霑	no definition found
何	surname He; what; how; why; which; carry
电	lightning; electricity; electric; to getan electric shock; phone call or telegram etc; to send via telephone or telegram etc
间	between; among; within a definite time or space; room; section of a room or lateral space between two pairs of pillars; classifier for rooms; gap; to separate; to thin out; to sow discontent
裙	skirt
孙	surname Sun; grandson; descendant
肌	flesh; muscle
附	to add; to attach; to be close to; to be attached
别	surname Bie; to leave; to part; to differentiate; to distinguish; other; another; different; don't ...!; to fasten with a pin or clip; to stick in; to insert; category; to make sb change their ways, opinions etc
鼻	nose
毛	surname Mao; hair; feather; down; wool; mildew; mold; coarse or semifinished; young; raw; careless; unthinking; nervous; scared; to devalue or depreciate; classifier for Chinese fractional monetary unit; 
妇	woman
姥	grandma; governess; old woman; mother's mother; maternal grandmother
汉	Han ethnic group; Chinese; the Han dynasty; man
灶	kitchen stove; kitchen; mess; canteen
赌	to bet; to gamble
蹒	used in 蹣跚|蹒跚[pan2 shan1]; Taiwan pr. [man2]
歪	askew; at a crooked angle; devious; noxious; to lie on one's side; to sprain
耕	to plow; to till
善	good; benevolent; well-disposed; good at sth; to improve or perfect
步	surname Bu; a step; a pace; walk; march; stages in a process; situation; step by step; at every step
今	now; the present time; current; contemporary; this
脏	viscera; organ; dirty; filthy; to getdirty; dirty
捉	to clutch; to grab; to capture
碳	carbon
疼	hurts; sore; to love dearly
酬	variant of 酬[chou2]; to entertain; to repay; to return; to reward; to compensate; to reply; to answer
唠	to chatter; to gossip; to chat
煎	to pan fry; to sauté
菜	vegetable; greens; dish; weak; poor; type
砂	sand; gravel; granule
瓦	roof tile; abbr. for 瓦特[wa3 te4]
衷	inner feelings
会	can; to have the skill; to know how to; to be likely to; to be sure to; to meet; to get together; meeting; gathering; union; group; association; a moment; to balance an account; accounting; accountant
挣	used in 掙扎|挣扎[zheng1 zha2]; to struggle to get free; to strive to acquire; to make
从	surname Cong; from; through; via; to follow; to obey; to engage in; ever; retainer; attendant; assistant; auxiliary; subordinate; related by common paternal grandfather or earlier ancestor
通	to go through; to know well; expert; to connect; to communicate; open; to clear; classifier for letters, telegrams, phone calls etc; classifier for an activity, taken in its entirety; all; entire; complete
目	eye; to look; to regard; eye; mesh; mesh size; grit size; item; section; list; catalogue; order; name; title
您	you
狼	wolf
律	surname Lü; law
斧	hatchet
尬	embarrassing; awkward
懂	to understand; to comprehend
肉	meat; flesh; pulp; squashy; flabby; irresolute; Kangxi radical 130
捡	to pick up; to collect; to gather
弥	full; to fill; completely; more; brimming or overflowing
纬	latitude; woof; weft
橡	oak; Quercus serrata
它	it
购	to buy; to purchase
啤	beer
扛	to raise aloft with both hands; to carry sth together; to carry on one's shoulder; to take on
佳	surname Jia; beautiful; fine; good
歐	no definition found
跃	to jump; to leap
涨	to rise; to swell; to distend
柬	abbr. for 柬埔寨[Jian3 pu3 zhai4], Cambodia; card; note; letter
打	dozen; to beat; to strike; to hit; to break; to type; to mix up; to build; to fight; to fetch; to make; to tie up; to issue; to shoot; to calculate; to play; since; from
荣	surname Rong; glory; honor; thriving
赚	to earn; to make a profit; to cheat; to swindle
戾	to bend; to violate; to go against; ruthless and tyrannical
撤	to remove; to take away
徒	surname Tu; disciple; apprentice; believer; on foot; bare; empty; to no avail; only; prison sentence
挤	to crowd in; to cram in; to force others aside; to press; to squeeze; to find
荤	strong-smelling vegetable; non-vegetarian food; vulgar; obscene
注	to inject; to pour into; to concentrate; to pay attention; stake; classifier for sums of money; to register; to annotate; note; comment
萎	to wither; to drop; to decline; spiritless; Taiwan pr. [wei1]
榨	to press; to extract; to press; to extract; device for extracting juice, oils etc
扁	surname Pian; flat; to beatup; small boat
仅	barely; only; merely; barely; only; merely; only
旨	imperial decree; purport; aim; purpose
苏	used in 嚕囌|噜苏[lu1 su1]; to revive; surname Su; abbr. for Soviet Union 蘇維埃|苏维埃 or 蘇聯|苏联; abbr. for Jiangsu province 江蘇|江苏; abbr. for Suzhou city 蘇州|苏州; Perilla frutescens; place name; to revive; used as phonetic in transliteration
铅	lead
握	to hold; to grasp; to clench; to have in one's control; classifier: a handful
牲	domestic animal; sacrificial animal
裕	abundant
朵	flower; earlobe; fig. item on both sides; classifier for flowers, clouds etc
咖	used in 咖喱[ga1 li2]; coffee; class; grade
嗨	oh alas; hey!; hi!; a high
骚	to disturb; to disrupt; flirty; coquettish; abbr. for 離騷|离骚[Li2 Sao1]; literary writings; poetry; male
针	needle; pin; injection; stitch
寒	cold; poor; to tremble
碗	variant of 碗[wan3]; bowl; cup
放	to put; to place; to release; to free; to let go; to let out; to set off
重	to repeat; repetition; again; re-; classifier: layer; heavy; serious; to attach importance to; layer upon layer; one after another; heavily; severely
无	not to have; no; none; not; to lack; un-; -less
老	prefix used before the surname of a person or a numeral indicating the order of birth of the children in a family or to indicate affection or familiarity; old; venerable; experienced; of long standing; always; all the time; of the past; very; outdated; tough; maternal grandmother; same as 姥姥
毫	hair; drawing brush; least; one thousandth; currency unit, 0.1 yuan
筒	tube; cylinder; to encase in sth cylindrical
籍	surname Ji; book or record; registry; roll; place of one's family or ancestral records; membership; noisy; of high reputation; intricate
戳	to jab; to poke; to stab; to sprain; to blunt; to fuck; to stand; to standupright; stamp; seal
愿	honest and prudent; wish; hope; desire; to be willing; to wish; may ...; vow; pledge
逝	to pass by; to pass away; to die
侨	emigrant; to reside abroad
雌	female; Taiwan pr. [ci1]
拐	to turn; to kidnap; to swindle; to misappropriate; seven; cane; walking stick; crutch; old man's staff
两	two; both; some; a few; tael, unit of weight equal to 50 gramsor 1⁄16 of a catty 斤[jin1]
荷	Holland; the Netherlands; abbr. for 荷蘭|荷兰[He2 lan2]; lotus; to carry on one's shoulder or back; burden; responsibility
凰	phoenix
格	square; frame; rule; case; style; character; standard; pattern; case; to obstruct; to hinder; to arrive; to come; to investigate; to study exhaustively; princess
晤	to meet
垮	to collapse
公	public; collectively owned; common; international; make public; fair; just; Duke, highest of five orders of nobility 五等爵位[wu3 deng3 jue2 wei4]; honorable; father-in-law; male; husband's father; father-in-law; grandpa; grandad; form of address for a eunuch
拟	doubtful; suspicious; to emulate; to imitate; to plan to; to draft; to imitate; to assess; to compare; pseudo-
释	to explain; to release; Buddha; Buddhism
宁	abbr. for Ningxia Hui Autonomous Region 寧夏回族自治區|宁夏回族自治区[Ning2 xia4 Hui2 zu2 Zi4 zhi4 qu1]; abbr. for Nanjing 南京[Nan2 jing1]; surname Ning; peaceful; to pacify; to visit; would rather; to prefer; how; Taiwan pr. [ning2]
啃	to gnaw; to nibble; to bite
霜	frost; white powder or cream spread over a surface; frosting; cream
屉	drawer; tier; tray
健	healthy; to invigorate; to strengthen; to be good at; to be strong in
司	surname Si; to take charge of; to manage; department
痛	ache; pain; sorrow; deeply; thoroughly
份	classifier for gifts, newspaper, magazine, papers, reports, contracts etc
衅	quarrel; dispute; a blood sacrifice
锦	brocade; embroidered work; bright
温	surname Wen; warm; lukewarm; to warm up; temperature; mild; soft; tender; to review; fever; mild
讲	to speak; to explain; to negotiate; to emphasize; to be particular about; as far as sth is concerned; speech; lecture
御	imperial; royal; to drive; to manage; to govern; to defend; to resist
盖	surname Ge; lid; top; cover; canopy; to cover; to conceal; to build
爷	grandpa; old gentleman; father's father; paternal grandfather
腻	greasy; soft; unctuous; intimate; tired of
浑	muddy; turbid; brainless; foolish; simple; natural; whole; entire; all over
知	to know; to be aware
噩	startling
米	surname Mi; rice; meter
捏	to hold between the thumb and fingers; to pinch; to mold; to hold; to join together; to fabricate
须	must; to have to; to wait; beard; mustache; feeler; tassel
贿	bribery
上	used in 上聲|上声[shang3 sheng1]; up; upper; above; previous; first; to climb; to get onto; to go up; to attend; up; on; above
邻	neighbor; adjacent; close to
凉	the five Liang of the Sixteen Kingdoms, namely: Former Liang 前涼|前凉, Later Liang 後涼|后凉, Northern Liang 北涼|北凉, Southern Liang 南涼|南凉[Nan2 Liang2], Western Liang 西涼|西凉; cool; cold; to let sth cool down; slightly cold; cool; to be done for; about to be obliterated; desolate
痹	paralysis; numbness
殊	different; unique; special; very; to behead; to die; to cut off; to separate; to surpass
坛	altar; platform; rostrum; circles; world; earthen jar
代	to substitute; to act on behalf of others; to replace; generation; dynasty; age; period; era; eon; from generation to generation; generation after generation
刘	surname Liu; a type of battle-ax; to kill; to slaughter
浅	sound of moving water; shallow; light
凹	concave; depressed; sunken; indented; female; 
布	to announce; to spread; cloth; to declare; to announce; to spread; to make known
葬	to bury; to inter
赠	to give as a present; to repel; to bestow an honorary title after death
帮	old variant of 幫|帮[bang1]; to help; to assist; to support; for sb; hired; side; outer layer; upper; group; gang; clique; party; secret society
竞	to compete; to contend; to struggle
货	goods; money; commodity
持	to hold; to grasp; to support; to maintain; to persevere; to manage; to run; to control
富	surname Fu; rich; abundant; wealthy
尼	Buddhist nun; 
相	surname Xiang; each other; one another; mutually; fret on the neck of a pipa 琵琶[pi2 pa5]; appearance; portrait; picture; government minister; phase; to appraise; to read sb's fortune
车	surname Che; car; vehicle; machine; to shape with a lathe; Kangxi radical 159; war chariot; rook; rook
图	diagram; picture; drawing; chart; map; to plan; to scheme; to attempt; to pursue; to seek
母	mother; elderly female relative; origin; source; female
帅	surname Shuai; commander-in-chief; to lead; to command; handsome; graceful; dashing; elegant; cool!; sweet!; general
扭	to turn; to twist; to wring; to sprain; to swing one's hips
尤	surname You; outstanding; particularly, especially; a fault; to express discontentment against
侄	variant of 姪|侄[zhi2]; brother's son; nephew
鸽	pigeon; dove
歹	bad; wicked; evil; Kangxi radical 78
模	to imitate; model; norm; pattern; mold; die; matrix; pattern
蠢	stupid; stupid; sluggish; clumsy; to wiggle; to move in a disorderly fashion
绣	to embroider; embroidery
犯	to violate; to offend; to assault; criminal; crime; to make a mistake; recurrence
抵	to press against; to support; to prop up; to resist; to equal; to balance; to make up for; to mortgage; to arrive at; to claplightly
奔	to hurry; to rush; to run quickly; to elope; to go to; to head for; towards; Taiwan pr. [ben1]; variant of 奔[ben4]; variant of 奔[ben4]
硬	hard; stiff; solid; strong; firm; resolutely; uncompromisingly; laboriously; with great difficulty; good; able; filling; substantial
辆	classifier for vehicles
挚	surname Zhi; sincere
婊	prostitute
昧	to conceal; dark
伍	surname Wu; squad of five soldiers; to associate with; five
驶	to go fast; to speed; to run; to go; to sail
顿	to stop; to pause; to arrange; to lay out; to kowtow; to stamp; at once; classifier for meals, beatings, scoldings etc: time, bout, spell, meal
趴	to lie on one's stomach; to lean forward, resting one's upper body; percent
咪	sound for calling a cat; oboe-like musical instrument used in folk music of Gansu, Qinghai etc; meow; kitty kitty!; Mimi; tits
蓬	surname Peng; fleabane; disheveled; classifier for luxuriant plants, smoke, ashes, campfires: clump, puff; luxuriant; abundant; booming sound of wind; overgrown; unkempt
椎	to hammer; to bludgeon; vertebra
朴	surname Piao; Korean surname; also pr. [Pu2]; Celtis sinensis var. japonica; plain and simple; Taiwan pr. [pu2]
浓	concentrated; dense; strong
嚏	sneeze
陈	surname Chen; Chen, a Zhou dynasty state; Chen, one of the Southern Dynasties 南朝[Nan2 Chao2]; to lay out; to exhibit; to display; to narrate; to state; to explain; to tell; old; stale
碰	to touch; to meet with; to bump
逼	to compel; to pressure; to force; to compel; to press for; to extort; to press on towards; to press up to; to close in on; to rattle on; to talk drivel
亮	bright; light; to shine; to flash; loud and clear; to show; to make public
集	to gather; to collect; collected works; classifier for sections of a TV series etc: episode; Jiji or Chichi Town in Nantou County 南投縣|南投县[Nan2 tou2 Xian4], central Taiwan
丘	surname Qiu; mound; hillock; grave; classifier for fields
衍	to spread out; to develop; to overflow; to amplify; superfluous
期	period; cycle; a period of time; phase; stage; classifier for issues of a periodical, courses of study; time; term; period; to hope; Taiwan pr. [qi2]
齿	tooth
玛	agate; cornelian
尴	used in 尷尬|尴尬[gan1 ga4]
诗	abbr. for Shijing 詩經|诗经[Shi1 jing1], the Book of Songs; poem; poetry; verse
差	difference; discrepancy; difference; a little; somewhat; slightly; different; wrong; mistaken; to fall short; to lack; not up to standard; inferior; Taiwan pr. [cha1]; to send; person sent on such an errand; job; official post; used in 參差|参差[cen1 ci1]
咳	sound of sighing; oh; damn; wow; cough
嗔	to be angry at; to be displeased and annoyed
婆	grandmother; matron; mother-in-law; femme; husband's mother; mother-in-law; grandma
久	time; duration of time; for a very long time
袍	gown
意	Italy; Italian; idea; meaning; thought; to think; wish; desire; intention; to expect; to anticipate
沛	copious; abundant
岭	used only in 岭巆|岭𫶕[ling2 ying2]; mountain range; mountain ridge
责	duty; responsibility; to reproach; to blame
莲	lotus
姆	woman who looks after small children; female tutor
享	to enjoy; to benefit; to have the use of
伙	meals; companion; partner; group; classifier for groups of people; to combine; together
归	surname Gui; to return; to go back to; to give back to; to be taken care of by; to belong to; to gather together; despite; to marry; division on the abacus with a one-digit divisor
俊	smart; eminent; handsome; talented; ; cool; neat
涮	to rinse; to trick; to fool sb; to cook by dipping finely sliced ingredients briefly in boiling water or soup
者	one who...; person involved in ...; -er; -ist; ; ; ; this
医	medical; medicine; doctor; to cure; to treat
余	surname Yu; I; me; extra; surplus; remaining; remainder after division; or more; in excess of; residue; after; I; me
炎	flame; inflammation; -itis; scorching
传	to pass on; to spread; to transmit; to infect; to transfer; to circulate; to conduct; biography; historical narrative; commentaries; relay station
联	to ally oneself with; to unite; to combine; to join; antithetical couplet
妙	clever; wonderful
瑜	excellence; luster of gems
尿	to urinate; urine; urine; to pee
产	to give birth; to reproduce; to produce; product; resource; estate; property
伯	one hundred; father's elder brother; senior; paternal elder uncle; eldest of brothers; respectful form of address; Count, third of five orders of nobility 五等爵位[wu3 deng3 jue2 wei4]; father's elder brother; uncle
疲	weary
鱼	surname Yu; fish
弟	younger brother; junior male; I; younger brother
堡	an earthwork; castle; position of defense; stronghold; used in place names, often as phonetic bao for "burg" or "bad"; village; used in place names
却	but; yet; however; while; to go back; to decline; to retreat; nevertheless; even though
地	-ly; structural particle: used before a verb or adjective, linking it to preceding modifying adverbial adjunct; earth; ground; field; place; land
诬	to accuse falsely
粑	a round flat cake
髦	bang; fashionable; mane
铸	to cast or found metals
小	small; tiny; few; young; very small; very few; very minor
忧	to worry; to concern oneself with; worried; anxiety; sorrow; to observe mourning
泣	to sob
帘	flag used as a shop sign; hanging screen or curtain
互	mutual
棕	palm; palm fiber; coir; brown
销	to melt; to cancel; to annul; to sell; to expend; to spend; pin; bolt; to fasten with a pin or bolt
梗	branch; stem; stalk; to block; to hinder; memorable creative idea; prominent feature of a creative work
惭	ashamed
口	mouth; classifier for things with mouths; classifier for bites or mouthfuls
慈	compassionate; gentle; merciful; kind; humane
阶	rank or step; stairs
虏	prisoner of war; to capture; to take prisoner; northern barbarian; slave
拳	fist; boxing; earnest; sincere
脸	face
浴	bath; to bathe
案	case; incident; record; file; table
效	to imitate; effect; efficacy; to imitate
硕	large; big
愚	to be stupid; to cheat or deceive; me or I
貌	appearance
第	; grades in which successful candidates in the imperial examinations were placed; residence of a high official; but; however; only; just
惰	lazy
哈	abbr. for 哈薩克斯坦|哈萨克斯坦[Ha1 sa4 ke4 si1 tan3], Kazakhstan; abbr. for 哈爾濱|哈尔滨[Ha1 er3 bin1], Harbin; ha!; ; to be infatuated with; to adore; husky; a Pekinese; a pug; to scold; laughing out loud
镇	to press down; to calm; to subdue; to suppress; to guard; garrison; small town; to cool or chill
仔	young man; used in 仔肩[zi1 jian1]; meticulous; young
愁	to worry about
游	surname You; to swim; to walk; to tour; to roam; to travel
前	front; forward; ahead; first; top; future; ago; before; BC; former; formerly
荒	desolate; shortage; scarce; out of practice; absurd; uncultivated; to neglect
话	dialect; language; spoken words; speech; talk; words; conversation; what sb said
厦	abbr. for Xiamen or Amoy 廈門|厦门[Xia4 men2], Fujian; tall building; mansion; rear annex; lean-to; also pr. [xia4]
漆	paint; lacquer; to paint
北	north; to be defeated
透	to penetrate; to seep through; to tell secretly; to leak; thoroughly; through and through; to appear; to show
细	thin or slender; finely particulate; thin and soft; fine; delicate; trifling; quiet; frugal; attentive; careful
荜	bean; pulse
瞒	to conceal from; to keepin the dark
龚	surname Gong
妖	goblin; witch; devil; bewitching; enchanting; monster; phantom; demon
净	clean; completely; only; net; painted face male role
段	surname Duan; paragraph; section; segment; stage; classifier for stories, periods of time, lengths of thread etc
过	surname Guo; to cross; to go over; to pass; to celebrate; to live; to get along; excessively; too-; 
桑	surname Sang; mulberry tree
浏	clear; deep; swift
棋	chess; chess-like game; a game of chess; chess piece
纳	surname Na; to receive; to accept; to enjoy; to bring into; to pay; nano-; to reinforce sole of shoes or stockings by close sewing
仓	barn; granary; storehouse; cabin; hold
虎	tiger; vigorous; formidable; strong
柔	soft; flexible; supple; yielding; rho
豪	grand; heroic
眼	eye; small hole; crux; classifier for big hollow things
耸	to excite; to raise up; to shrug; high; lofty; towering
均	equal; even; all; uniform
泄	to leak out; to discharge;to divulge
擦	to rub; to scratch; to wipe; to polish; to apply; to brush; to shred
允	just; fair; to permit; to allow
啬	stingy
黎	Li ethnic group of Hainan Province; surname Li; abbr. for Lebanon 黎巴嫩[Li2 ba1 nen4]; black; dark; many; multitude
延	surname Yan; to prolong; to extend; to delay
火	surname Huo; fire; urgent; ammunition; fiery or flaming; internal heat; hot; classifier for military units; Kangxi radical 86
植	to plant
拘	to capture; to restrain; to constrain; to adhere rigidly to; inflexible
臭	stench; smelly; to smell; repulsive; loathsome; terrible; bad; severely; ruthlessly; dud; sense of smell; smell bad
署	office; bureau; to sign; to arrange
刊	to print; to publish; publication; periodical; to peel with a knife; to carve; to amend; to peel with a knife; to carve; to amend
计	surname Ji; to calculate; to compute; to count; to regard as important; to plan; ruse; meter; gauge
店	inn; old-style hotel; shop; store
阿	abbr. for Afghanistan 阿富汗[A1 fu4 han4]; prefix used before monosyllabic names, kinship terms etc to indicate familiarity; used in transliteration; also pr. [a4]; to flatter; to curry favor with
陋	low; humble; plain; ugly; mean; vulgar
球	ball; sphere; globe; ball game; match
闪	surname Shan; to dodge; to duck out of the way; to beat it; shaken; to sprain; to pull a muscle; lightning; spark; a flash; to flash; to leave behind; "dazzlingly" saccharine; flickering; sparkling; glistening; glittering
咙	used in 喉嚨|喉咙[hou2 long2]
卧	to lie; to crouch
坚	strong; solid; firm; unyielding; resolute
跳	to jump; to hop; to skip over; to bounce; to palpitate
润	moist; glossy; sleek; to moisten; to lubricate; to embellish; to enhance; profit; remuneration; to emigrate
倦	tired
抽	to draw out; to pull out from in between; to remove part of the whole; to sprout or bud; to whip or thrash
辅	to assist; to complement; auxiliary
牢	firm; sturdy; fold; sacrifice; prison; firmly; safely
描	to depict; to trace; to copy; to touch up
霞	rose-tinted sky or clouds at sunrise or sunset
稀	rare; uncommon; watery; sparse
伶	actor; actress; 
崇	surname Chong; high; sublime; lofty; to esteem; to worship
姐	older sister; older sister
窗	variant of 窗[chuang1]; window
吨	ton; Taiwan pr. [dun4]
氧	oxygen
空	empty; air; sky; in vain; to empty; vacant; unoccupied; space; leisure; free time; empty; vacuous; nothing; vacant; in vain; all for nothing; air-to-air
勤	diligent; industrious; hardworking; frequent; regular; constant; attentive; solicitous; earnest; sincere; industrious; solicitous
极	extremely; pole; utmost; top
悠	long or drawn out; remote in time or space; leisurely; to swing; pensive; worried; lasting for ages; long drawn out; remote in time or space; unhurried; a great number; preposterous; pensive
宇	room; universe
射	to shoot; to launch; to allude to; radio-
融	to melt; to thaw; to blend; to merge; to be in harmony; in harmony; happy; warm relations
凤	surname Feng; phoenix
舆	chassis of a carriage; the earth; land; territory; carriage; sedan chair; palanquin; the multitudes; the people; the public
属	category; genus; family members; dependents; to belong to; subordinate to; affiliated with; be born in the year of; to be; to prove to be; to constitute; to join together; to fix one's attention on; to concentrate on
鹅	goose
偷	to steal; to pilfer; to snatch; thief; stealthily; stealthily; secretly; covertly; furtively; on the sly
记	to record; to note; to memorize; to remember; mark; sign; classifier for blows, kicks, shots
还	surname Huan; still; still in progress; still more; yet; even more; in addition; fairly; passably; as early as; even; also; else; to pay back; to return
照	to shine; to illuminate; according to; in accordance with; to shine; to illuminate; to reflect; to look at; to take; photo; as requested; as before
晨	morning; dawn; daybreak
身	body; life; oneself; personally; one's morality and conduct; the main part of a structure or body; pregnant; classifier for sets of clothes: suit, twinset; Kangxi radical 158
渡	to cross; to pass through; to ferry
噜	grumble; chatter
留	to leave; to retain; to stay; to remain; to keep; to preserve
舟	boat
哎	hey!; 
交	to hand over; to deliver; to pay; to turn over; to make friends; to intersect
也	surname Ye; also; both ... and ...; particle having functions similar to 啊[a5]
宙	eternity; eon
弧	arc
蔚	surname Yu; place name; Artemisia japonica; luxuriant; resplendent; impressive
牙	tooth; ivory
史	surname Shi; history; annals; title of an official historian in ancient China
逃	to escape; to run away; to flee
侈	extravagant; wasteful; exaggerating
验	to examine; to test; to check
但	but; yet; however; still; merely; only; just
综	heddle; Taiwan pr. [zong4]; to synthesize; to combine; Taiwan pr. [zong4]
阴	surname Yin; overcast; cloudy; shady; Yin; negative; feminine; moon; implicit; hidden; genitalia
匹	mate; one of a pair; classifier for horses, mules etc; Taiwan pr. [pi1]; ordinary person; classifier for cloth: bolt; horsepower; classifier for cloth: bolt
婚	to marry; marriage; wedding; to take a wife
得	to obtain; to get; to gain; to catch; proper; suitable; proud; contented; to allow; to permit; ready; finished; structural particle: used after a verb, linking it to following phrase indicating effect, degree, possibility etc; to have to; must; ought to; to need to
吼	to roar; to howl; to shriek; roar or howl of an animal; bellow of rage
巧	opportunely; coincidentally; as it happens; skillful; timely
款	section; paragraph; funds; classifier for versions or models; leisurely; sincerely
策	surname Ce; policy; plan; scheme; bamboo slip for writing; to whip; to encourage; riding crop with sharp spines; essay written for the imperial examinations; upward horizontal stroke in calligraphy; variant of 策[ce4]
敌	enemy; to be a match for; to rival; to resist; to withstand
咆	to roar
睦	amicable; harmonious
败	to defeat; to damage; to lose; to fail; to wither
政	political; politics; government
煌	brilliant
瞄	to take aim; to aim one's looks at; to glance at
院	courtyard; institution
芯	the pith of the rush plant; used in 芯子[xin4 zi5]; Taiwan pr. [xin1]
籽	seeds
海	surname Hai; ocean; sea; great number of people or things; numerous
喻	surname Yu; to describe sth as; an analogy; a simile; a metaphor; an allegory
走	to walk; to go; to run; to move; to visit; to leave; to go away; to die; from; through; away; to change
贩	to deal in; to buy and sell; to trade in; to retail; to peddle
皇	surname Huang; emperor; magnificent; variant of 遑遑[huang2 huang2]
木	surname Mu; tree; wood; unresponsive; numb; wooden
捎	to bring sth to sb; to deliver
催	to urge; to press; to prompt; to rush sb; to hasten sth; to expedite
仍	still; yet; to remain; frequently; often
终	end; finish
尽	to the greatest extent; furthest or extreme; to be within the limits of; to give priority to; to use up; to exhaust; to end; to finish; to the utmost; exhausted; finished; to the limit; all; entirely
涉	to wade across a body of water; to experience; to undergo; to be involved; to concern
挖	to dig; to excavate; to scoop out
祝	surname Zhu; to pray for; to wish; person who invokes the spirits during sacrificial ceremonies
槽	trough; manger; groove; channel; hard drive
那	surname Na; surname Nuo; that; the; those; that; then; many; beautiful; how
检	to check; to examine; to inspect; to exercise restraint
再	again; once more; re-; second; another; then; no matter how ...也[ye3] or 都[dou1] for emphasis)
尔	thus; so; like that; you; thou
迁	to move; to shift; to change; to promote
稍	somewhat; a little; see 稍息[shao4 xi1]; somewhat; a little; slightly
勿	do not
毯	blanket; rug
赋	poetic essay; taxation; to bestow on; to endow with
赴	to go; to visit; to attend
亭	pavilion; booth; kiosk; erect
呻	to recite; to chant; to intone; groan
拄	to lean on; to prop on
预	to advance; in advance; beforehand; to prepare
征	journey; trip; expedition; to go on long campaign; to attack; to invite; to recruit; to levy; to draft; phenomenon; symptom; characteristic sign; evidence
钞	money; paper money
觅	to seek; to find
汁	juice
雷	surname Lei; thunder; mine, as in 地雷[di4 lei2] land mine; to shock; to stun; to astound; spoiler; to reveal plot details to
岳	surname Yue; wife's parents and paternal uncles; surname Yue; high mountain; highest peak of a mountain ridge
活	to live; alive; living; work; workmanship; while still alive; simply; totally
辙	rut; track of a wheel; the direction of traffic; a rhyme; way; idea
况	moreover; situation
湾	bay; gulf; to cast anchor; to moor
星	star; heavenly body; satellite; small amount; a star; the stars in the sky
遇	surname Yu; to encounter; to happen upon; to meet unplanned; to treat; to receive
浊	turbid; muddy; impure
岔	fork in road; bifurcation; branch in road, river, mountain range etc; to branch off; to turn off; to diverge; to stray; to change the subject; to interrupt; to stagger
劫	variant of 劫[jie2]; to rob; to plunder; to seize by force; to coerce; calamity; abbr. for kalpa 劫波[jie2 bo1]
换	to exchange; to change; to substitute; to switch; to convert
适	see 李适[Li3 Kuo4]; surname Shi; to fit; suitable; proper; just; comfortable; well; to go; to follow or pursue
屋	house; room
脆	brittle; fragile; crisp; crunchy; clear and loud voice; neat; crispy
钻	to drill; to bore; to get into; to make one's way into; to enter; to thread one's way through; to study intensively; to dig into; to curry favor for personal gain; an auger; diamond
拗	to bend in two so as to break; to defy; to disobey; also pr. [ao3]; stubborn; obstinate
访	to visit; to call on; to seek; to inquire; to investigate
谴	to censure; to reprimand
消	to diminish; to subside; to consume; to reduce; to idle away; to need; to require; to take
睛	eye; eyeball
迹	footprint; mark; trace; vestige; sign; indication; Taiwan pr. [ji1]; variant of 跡|迹[ji4]
竟	unexpectedly; actually; to go so far as to; indeed
楚	surname Chu; abbr. for Hubei 湖北省[Hu2 bei3 Sheng3] and Hunan 湖南省[Hu2 nan2 Sheng3] provinces together; Chinese kingdom during the Spring and Autumn and Warring States Periods; distinct; clear; orderly; pain; suffering; deciduous bush used in Chinese medicine; punishment cane; neat; lovely
梁	Liang Dynasty; Later Liang Dynasty; surname Liang; roof beam; beam; bridge
航	boat; ship; craft; to navigate; to sail; to fly
沼	pond; pool
说	to persuade; to speak; to talk; to say; to explain; to comment; to scold; to tell off; theory; doctrine; to say sth
憋	to choke; to stifle; to restrain; to hold back; to hold in; to hold
管	surname Guan; to take care; to control; to manage; to be in charge of; to look after; to run; to care about; tube; pipe; woodwind; classifier for tube-shaped objects; particle similar to 把[ba3] in 管...叫 constructions; writing brush; to; towards
昔	surname Xi; former times; the past; Taiwan pr. [xi2]
冰	ice; to chill sth; to feel cold; cold; unfriendly; methamphetamine
蝶	butterfly
踊	leap; leap
儿	"person" radical in Chinese characters, occurring in 兒, 兀, 兄 etc; child; son; non-syllabic diminutive suffix; retroflex final
烟	cigarette or pipe tobacco; smoke; mist; vapour; tobacco plant; to be irritated by smoke
绸	silk
梯	ladder; stairs
贬	to diminish; to demote; to reduce or devaluate; to disparage; to censure; to depreciate
背	to be burdened; to carry on the back or shoulder; the back of a body or object; to turn one's back; to hide something from; to learn by heart; to recite from memory; unlucky; hard of hearing
湖	lake
南	surname Nan; south
泳	swimming; to swim
碍	to hinder; to obstruct; to block
楼	surname Lou; house with more than 1 story; storied building; floor
搬	to move; to move; to shift; to copy indiscriminately
骨	bone
里	lining; interior; inside; internal; also written 裏|里[li3]; Li; li, ancient measure of length, approx. 500 m; neighborhood; ancient administrative unit of 25 families; borough, administrative unit between the township 鎮|镇[zhen4] and neighborhood 鄰|邻[lin2] levels
土	Tu; surname Tu; earth; dust; clay; local; indigenous; crude opium; unsophisticated; one of the eight categories of ancient musical instruments 八音[ba1 yin1]
沃	fertile; rich; to irrigate; to wash
傲	proud; arrogant; to despise; unyielding; to defy
蚂	dragonfly; ant; grasshopper
趁	to avail oneself of; to take advantage of
鞭	whip or lash; to flog; to whip; conductor's baton; segmented iron weapon; penis
宽	surname Kuan; wide; broad; loose; relaxed; lenient
采	to pick; to pluck; to collect; to select; to choose; to gather; color; complexion; looks; variant of 採|采[cai3]; allotment to a feudal noble
恕	to forgive
且	and; moreover; yet; for the time being; to be about to; both
氓	used in 流氓[liu2 mang2]; common people
缀	to sew; to stitch together; to combine; to link; to connect; to put words together; to compose; to embellish
清	Qingdynasty of imperial China; surname Qing; clear; clean; quiet; still; pure; uncorrupted; clear; distinct; to clear; to settle
宝	jewel; gem; treasure; precious; darling; baby
本	root; stem; origin; source; one's own; this; this; the current; original; inherent; originally; initially; capital; principal; classifier for books, periodicals, files etc; notebook computer; laptop
功	meritorious deed or service; achievement; result; service; accomplishment; work
巨	very large; huge; tremendous; gigantic
娶	to take a wife; to marry
弱	weak; feeble; young; inferior; not as good as; slightly less than
桃	peach
饰	decoration; ornament; to decorate; to adorn; to hide; to conceal; excuse; to play a role; to impersonate
阐	to express; to disclose; to enlighten; to open
咯	; ; to cough up; also pr. [ka3]; gurgle
顺	to obey; to follow; to arrange; to make reasonable; along; favorable
弄	lane; alley; to do; to manage; to handle; to play with; to fool with; to mess with; to fix; to toy with; variant of 弄[long4]
辽	short name for Liaoning 遼寧|辽宁[Liao2 ning2] province; Liao or Khitan dynasty; distant; faraway
劈	to hack; to chop; to split open; to strike; to split in two; to divide
劝	to advise; to urge; to try to persuade; to exhort; to console; to soothe
远	far; distant; remote; by far; much; to distance oneself from; distant; by far
鲜	variant of 尟|鲜[xian3]; fresh; bright; delicious; tasty; delicacy; aquatic foods; few; rare; fish; old variant of 鮮|鲜[xian3]
颈	used in 脖頸兒|脖颈儿[bo2 geng3 r5]; neck
铃	bell
楂	fell trees; raft; to hew; Chinese hawthorn
什	what; ten; assorted; miscellaneous
辞	to resign; to dismiss; to decline; to take leave; ballad
吐	to spit; to send out; to say; to pour out; to vomit; to throw up
澳	Macao; Australia; deep bay; cove; harbor
拙	awkward; clumsy; dull; inelegant; my; Taiwan pr. [zhuo2]
短	short; brief; to lack; weak point; fault
闺	small arched door; boudoir; lady's chamber; women
狮	lion
市	market; city
速	fast; rapid; quick; velocity
困	to trap; to surround; hard-pressed; stranded; destitute; sleepy; tired
暂	temporary; Taiwan pr. [zhan4]; to scurry
锋	point of a spear; edge of a tool; vanguard; forward
崖	precipice; cliff; Taiwan pr. [yai2]
等	to wait for; to await; by the time; when; till; and so on; etc.; et al.; class; rank; grade; equal to; same as; ; ; et cetera; and so on ...; wait a minute!; hold on!
账	account; bill; debt
衡	to weigh; weight; measure
姓	family name; surname; to be surnamed
稳	settled; steady; stable
怠	idle; lazy; negligent; careless
耍	surname Shua; to play with; to wield; to act; to display
围	surname Wei; to encircle; to surround; all around; to wear by wrapping around
讶	astounded
历	old variant of 歷|历[li4]; calendar; to experience; to undergo; to pass through; all; each; every; history
帽	hat; cap
抱	to hold; to carry; to hug; to embrace; to surround; to cherish; to fit nicely; to hug; to give a cuddle
琴	guqin 古琴[gu3 qin2]; musical instrument in general
澄	surname Cheng; clear; limpid; to clarify; to purify; to settle; to become clear
确	variant of 埆[que4]; authenticated; solid; firm; real; true
咨	to consult
织	to weave
瞬	to wink
叹	to sigh; to exclaim
塞	Serbia; Serbian; abbr. for 塞爾維亞|塞尔维亚[Sai1 er3 wei2 ya4]; to stop up; to squeeze in; to stuff; cork; stopper; strategic pass; tactical border position; to stop up; to stuff; to cope with
直	surname Zhi; Zhi, fifth of the legendary Flame Emperors 炎帝[Yan2 di4] descended from Shennong 神農|神农[Shen2 nong2] Farmer God; straight; to straighten; fair and reasonable; frank; straightforward; ; vertical; vertical downward stroke in Chinese characters
而	and; as well as; and so; but; yet; ; ; 
宠	to love; to pamper; to spoil; to favor
红	surname Hong; red; popular; revolutionary; bonus
器	device; tool; utensil
伴	partner; companion; comrade; associate; to accompany
叨	garrulous; to receive the benefit of; to chatter; to hog the conversation
辱	disgrace; dishonor; to insult; to bring disgrace or humiliation to; to be indebted to; self-deprecating; Taiwan pr. [ru4]
搅	to disturb; to annoy; to mix; to stir
糯	variant of 糯[nuo4]; glutinous rice; sticky rice
斤	catty; weight equal to 500 g; weight equal to 600 g; slightly over 604 g
秘	see 秘魯|秘鲁[Bi4 lu3]; secret; secretary
职	office; duty
套	to cover; to encase; cover; sheath; to overlap; to interleave; to model after; to copy; formula; harness; loop of rope; to fish for; to obtain slyly; classifier for sets, collections; bend; tau; methods; the old tricks; condom
躺	to recline; to lie down
企	to stand on tiptoe and look; to anticipate; to look forward to; abbr. for 企業|企业[qi3 ye4]; Taiwan pr. [qi4]
阳	positive; sun; male principle; Yang, opposite: 陰|阴[yin1]
查	surname Zha; to research; to check; to investigate; to examine; to refer to; to look up
埃	abbr. for Egypt 埃及[Ai1 ji2]; dust; dirt; angstrom; phonetic ai or e
朋	friend
瓜	melon; gourd; squash
送	to send; to deliver; to transmit; to give; to seeoff; to accompany; to go along with
熄	to extinguish; to put out; to quench; to stop burning; to go out; to come to an end; to wither away; to die out; Taiwan pr. [xi2]
滥	overflowing; excessive; indiscriminate
苗	Hmong or Miao ethnic group of southwest China; surname Miao; sprout
墓	grave; tomb; mausoleum
够	enough; enough; really; to reach by stretching out
质	character; nature; quality; plain; to pawn; pledge; hostage; to question; Taiwan pr. [zhi2]
叼	to hold with one's mouth
力	surname Li; power; force; strength; ability; strenuously
窄	narrow; narrow-minded; badly off
踩	to step on; to tread; to stamp; to press a pedal; to pedal; to downvote
熊	surname Xiong; bear; to scold; to rebuke; weak; incapable; raging; flaming
熬	to boil; to simmer; to cook on a slow fire; to extract by heating; to decoct; to endure
捕	to catch; to seize; to capture
兄	elder brother
杆	pole; stick; pole; lever; classifier for long objects such as guns
猴	monkey
驰	to run fast; to speed; to gallop; to disseminate; to spread
将	will; shall; to use; to take; to checkmate; just a short while ago; ; a general; to command; to lead; general; to desire; to invite; to request
克	abbr. for 克羅地亞|克罗地亚[Ke4 luo2 di4 ya4], Croatia; abbr. for 克羅埃西亞|克罗埃西亚[Ke4 luo2 ai1 xi1 ya4], Croatia; to be able to; to subdue; to restrain; to overcome; gram; Tibetan unit of land area, about 6 ares; Ke, seventh of the legendary Flame Emperors, 炎帝[Yan2 di4] descended from Shennong 神農|神农[Shen2 nong2] Farmer God; to subdue; to overthrow; to restrain
福	surname Fu; abbr. for Fujian province 福建省[Fu2 jian4 sheng3]; good fortune; happiness; luck
伐	to cut down; to fell; to dispatch an expedition against; to attack; to boast; Taiwan pr. [fa1]
辰	5th earthly branch: 7-9 a.m., 3rd solar month, year of the Dragon; ancient Chinese compass point: 120°
逆	contrary; opposite; backwards; to go against; to oppose; to betray; to rebel
庙	temple; ancestral shrine; temple fair; great imperial hall; imperial
瑟	a type of standing harp, smaller than konghou 箜篌, with 5-25 strings; trembling; rustling
剑	double-edged sword; classifier for blows of a sword
读	comma; phrase marked by pause; to read out; to read aloud; to read; to attend; to study; to pronounce
拧	to pinch; wring; mistake; to twist; stubborn
杭	surname Hang; Hangzhou
诧	to be surprised; to be astonished
玉	jade
婷	graceful
汰	to discard; to eliminate
做	to make; to produce; to write; to compose; to do; to engage in; to hold; to be; to become; to serve as; to be used for; to assume
兼	double; twice; simultaneous; holding two or moreposts at the same time
串	to string together; to skewer; to connect wrongly; to gang up; to rove; string; bunch; skewer; classifier for things that are strung together, or in a bunch, or in a row: string of, bunch of, series of; to make a swift or abrupt linear movement; to move across
十	ten; 10
欧	Europe; surname Ou; 
尝	to taste; to try; to experience; ever; once; old variant of 嘗|尝[chang2]
都	surname Du; all; both; entirely; even; already; at all; capital city; metropolis
屑	bits; fragments; crumbs; filings; trifling; trivial; to condescend to
精	essence; extract; vitality; energy; semen; sperm; mythical goblin spirit; highly perfected; elite; the pick of sth; proficient; extremely; selected rice
分	to divide; to separate; to distribute; to allocate; to distinguish; branch of; sub-; fraction; one tenth; unit of length equivalent to 0.33 cm; minute; minute; a point; 0.01 yuan; part; share; ingredient; component
农	surname Nong; agriculture
幕	curtain or screen; canopy or tent; headquarters of a general; act; curtain; screen
咸	surname Xian; all; everyone; each; widespread; harmonious; salted; salty; stingy; miserly
嫉	jealousy; to be jealous of
跚	used in 蹣跚|蹒跚[pan2 shan1]
皮	surname Pi; leather; skin; fur; pico-; naughty
假	used in 假掰[gei1 bai1]; fake; false; artificial; to borrow; if; suppose; vacation; to borrow
穿	to wear; to put on; to dress; to bore through; to pierce; to perforate; to penetrate; to pass through; to thread
衰	to decay; to decline; to wane
五	five; 5; 50-50; equal
提	used in 提防[di1 fang5] and 提溜[di1 liu5]; to carry; to lift; to put forward; to mention; to raise; upwards character stroke; lifting brush stroke; scoop for measuring liquid; calm; poised
顶	apex; crown of the head; top; roof; most; to carry on the head; to push to the top; to go against; to replace; to substitute; to be subjected to; to "bump" a forum thread to raise its profile; classifier for headwear, hats, veils etc
惊	to startle; to be frightened; to be scared; alarm
耳	ear; handle; and that is all
哼	to groan; to snort; to hum; to croon; humph!
池	surname Chi; pond; reservoir; moat
氪	krypton
普	general; popular; everywhere; universal
捐	to relinquish; to abandon; to contribute; to donate; tax; levy
构	variant of 夠|够[gou4]; to reach by stretching; to construct; to form; to make up; to compose; literary composition; paper mulberry
齐	; surname Qi; neat; even; level with; identical; simultaneous; all together; to even sth out
妈	ma; mom; mother; mama; mommy; mother
癌	cancer; carcinoma; also pr. [yan2]
惩	to punish; to reprimand; to warn
绎	continuous; to interpret; to unravel; to draw silk
盼	to hope for; to long for; to expect
博	extensive; ample; rich; obtain; aim; to win; to get; plentiful; to gamble
祈	to implore; to pray; to request
字	letter; symbol; character; word; courtesy or style name traditionally given to males aged 20 in dynastic China
尺	one of the characters used to represent a musical note in gongche notation, 工尺譜|工尺谱[gong1 che3 pu3]; a Chinese foot; one-third of a meter; a ruler; a tape-measure; one of the three acupoints for measuring pulse in Chinese medicine
捣	to pound; to beat; to hull; to attack; to disturb; to stir
月	moon; month; monthly; every month
厉	surname Li; strict; severe
惨	miserable; wretched; cruel; inhuman; disastrous; tragic; dim; gloomy
狭	narrow; narrow-minded
炫	to dazzle; to boast; to show off; cool; awesome
以	old variant of 以[yi3]; abbr. for Israel 以色列[Yi3 se4 lie4]; to use; by means of; according to; in order to; because of; at
韧	old variant of 韌|韧[ren4]; annealed; pliable but strong; tough; tenacious
变	to change; to become different; to transform; to vary; rebellion
挠	to scratch; to thwart; to yield
旋	to revolve; a loop; a circle; to whirl; immediately
妥	suitable; adequate; ready; settled
谍	to spy
扎	to prick; to run or stickinto; mug or jug used for serving beer; used in 掙扎|挣扎[zheng1 zha2]; crunch; variant of 紮|扎[zha1]; to tie; to bind; classifier for flowers, banknotes etc: bundle; Taiwan pr. [zha2]; to be stationed; Taiwan pr. [zha2]
至	to arrive; most; to; until
钥	key; also pr. [yao4]
贺	surname He; to congratulate
继	to continue; to follow after; to go on with; to succeed; to inherit; then; afterwards
烂	soft; mushy; well-cooked and soft; to rot; to decompose; rotten; worn out; chaotic; messy; utterly; thoroughly; crappy; bad
滔	to inundate; deluge; torrent; torrential
溺	to drown; to indulge; addicted to; to spoil
悚	frightened
崩	to collapse; to fall into ruins; death of king or emperor; demise
颤	to tremble; to shiver; to shake; to vibrate; Taiwan pr. [zhan4]
掘	to dig
拯	to raise; to aid; to support; to save; to rescue
忍	to bear; to endure; to tolerate; to restrain oneself
裂	to split; to crack; to break open; to rend
抛	to throw; to toss; to fling; to cast; to abandon
肆	four; unrestrained; wanton; shop
昂	to lift; to raise; to raise one's head; high; high spirits; soaring; expensive; high-spirited; brave-looking
鉴	old variant of 鑒|鉴[jian4]; bronze mirror; to reflect; to mirror; sth that serves as a warning or a lesson; to examine; to scrutinize
闷	stuffy; shut indoors; to smother; to cover tightly; bored; depressed; melancholy; sealed; airtight; tightly closed
伦	human relationship; order; coherence
垫	pad; cushion; mat; to pad out; to fill a gap; to pay for sb; to advance
栏	fence; railing; hurdle; column or box
雅	elegant
肾	kidney
钉	nail; to follow closely; to keep at sb; to join things together by fixing them in place at one or more points; to nail; to pin; to staple; to sew on; DingTalk, business communication platform developed by Alibaba
摆	to arrange; to exhibit; to move to and fro; a pendulum
关	surname Guan; mountain pass; to close; to shut; to turn off; to confine; to lockup; to shut; to concern; to involve
四	four; 4
蛛	spider; spider
他	he; him; ; ; other
停	to stop; to halt; to park
祥	auspicious; propitious
辩	to dispute; to debate; to argue; to discuss
唤	to call
弃	to abandon; to relinquish; to discard; to throw away
谜	see 謎兒|谜儿[mei4 r5], riddle; riddle
财	money; wealth; riches; property; valuables
钱	surname Qian; coin; money; unit of weight, one tenth of a tael 兩|两[liang3]
优	excellent; superior
窃	to steal; secretly; I; privately; secretly; unobtrusively
候	to wait; to inquire after; to watch; season; climate; period of five days
要	to demand; to coerce; to want; to need; to ask for; will; shall; about to; need to; should; if; important
奶	breast; milk; to breastfeed; grandma; mistress of the house; boobies; breasts; mother
唯	only; alone; -ism; yes
迦	/(phonetic sound for Buddhist terms)/
荡	variant of 燙|烫[tang4]; to wash; to squander; to sweep away; to move; to shake; dissolute; pond; fluttering
僻	remote; out of the way; off-center; eccentric
聪	acute; clever; intelligent; sharp
蹄	hoof; pig's trotters
顾	surname Gu; to look after; to take into consideration; to attend to
果	fruit; result; resolute; indeed; if really; fruit
饲	to raise; to rear; to feed
灭	to extinguish or put out; to go out; to exterminate or wipe out; to drown
因	cause; reason; because
脖	neck
袖	sleeve; to tuck inside one's sleeve
山	surname Shan; mountain; hill; small bundle of straw for silkworms to spin cocoons on
枉	to twist; crooked; unjust; in vain
花	surname Hua; flower; blossom; fancy pattern; florid; to spend; lecherous; lustful; variant of 花[hua1]; flower; blossom; also pr. [wei3]
举	to lift; to hold up; to cite; to enumerate; to act; to raise; to choose; to elect; act; move; deed
颧	cheek bones
牛	surname Niu; ox; cow; bull; newton; awesome
及	and; to reach; up to; in time for
啦	sound of singing, cheering etc; ; to chat; sentence-final particle, contraction of 了啊, indicating exclamation; particle placed after each item in a list of examples
致	fine; delicate; exquisite; to send; to transmit; to convey; to cause; to lead to; consequently
遗	to leave behind
嵌	see 赤嵌樓|赤嵌楼[Chi4 kan3 lou2]; to inlay; to embed; Taiwan pr. [qian1]
奏	to play music; to achieve; to present a memorial to the emperor
蹋	to step on
棍	stick; rod; truncheon; scoundrel; villain
周	surname Zhou; Zhou Dynasty; to make a circuit; to circle; circle; circumference; lap; cycle; complete; all; all over; thorough; to help financially; week; weekly
叙	abbr. for Syria 敘利亞|叙利亚[Xu4 li4 ya4]; to narrate; to chat
可	can; may; able to; -able; to approve; to permit; to suit; certainly; very; used in 可汗[ke4 han2]; cocoa
谤	to slander; to defame; to speak ill of
覆	to cover; to overflow; to overturn; to capsize
滴	a drop; to drip; DiDi, app-based transportation company
最	old variant of 最[zui4]; most; the most; -est
馒	used in 饅頭|馒头[man2 tou5]
情	feelings; emotion; sentiment; passion; situation; condition
欺	to take unfair advantage of; to deceive; to cheat
晚	evening; night; late
吉	surname Ji; abbr. for 吉林[Ji2 lin2] Jilin Province; lucky; giga-
示	to show; to reveal
望	full moon; to hope; to expect; to visit; to gaze; to look towards; towards; 15th day of month
泻	to flow out swiftly; to flood; a torrent; diarrhea; laxative
共	common; general; to share; together; total; altogether; abbr. for 共產黨|共产党[Gong4 chan3 dang3], Communist party
和	surname He; and; together with; with; sum; to make peace; to draw; to tie; harmonious; Japan; Japanese; to compose a poem in replyusing the same rhyme sequence; to join in the singing; to chime in with others; to complete a set in mahjong or playing cards; to combine a powdery substancewith water; Taiwan pr. [huo4]; to mixtogether; to blend; classifier for rinses of clothes; classifier for boilings of medicinal herbs; harmonious
类	kind; type; class; category; similar; like; to resemble
充	sufficient; full; to fill; to serve as; to act as; to act falsely as; to pose as
劳	to toil; labor; laborer; to put sb to trouble; meritorious deed; to console
三	surname San; three; 3
础	foundation; base
语	dialect; language; speech; to tell to
填	to fill or stuff; to fill in
幻	fantasy
擎	to raise; to hold up; to lift up
汽	steam; vapor
泛	variant of 泛[fan4]; general; non-specific; extensive; pan-; to flood; to float about; to be suffused with
奸	wicked; crafty; traitor; to fornicate; to defile; adultery; rape
邮	post; mail
出	to go out; to come out; to arise; to occur; to produce; to yield; to go beyond; to exceed; ; classifier for dramas, plays, operas etc
匙	spoon; used in 鑰匙|钥匙[yao4 shi5]
漫	free; unrestrained; to inundate; long; endless; boundless
镶	to inlay; to embed; ridge; border
役	forced labor; corvée; obligatory task; military service; to use as servant; to enserf; servant; war; campaign; battle
媳	daughter-in-law
州	prefecture; province; administrative division; state; oblast; canton
娇	lovable; pampered; tender; delicate; frail
宜	surname Yi; proper; should; suitable; appropriate
建	to establish; to found; to set up; to build; to construct
孤	lone; lonely
夺	to seize; to take away forcibly; to wrest control of; to compete or strive for; to force one's way through; to leave out; to lose
座	seat; base; stand; suffix used in a respectful form of address, e.g. 师座|师座[shi1 zuo4]; classifier for buildings, mountains and similar immovable objects
坏	bad; spoiled; broken; to break down; to the utmost
蹲	to crouch; to squat; to stay
补	to repair; to patch; to mend; to make up for; to fill; to supplement
饪	cooked food; to cook
导	to transmit; to lead; to guide; to conduct; to direct
约	to weigh in a balance or on a scale; to make an appointment; to invite; approximately; pact; treaty; to economize; to restrict; to reduce; concise
娱	to amuse
狂	mad; wild; violent
钝	blunt; stupid
洁	clean
即	namely; that is; i.e.; prompt; at once; at present; even if; prompted; to approach; to come into contact; to assume; to draw near
借	to borrow; to lend; to make use of; to avail oneself of; by; with
波	Poland; Polish; abbr. for 波蘭|波兰[Bo1 lan2]; wave; ripple; storm; surge
合	100 ml; one-tenth of a peck; measure for dry grain equal to one-tenth of sheng 升 or liter, or one-hundredth dou 斗; to close; to join; to fit; to be equal to; whole; together; round; conjunction; 1st note of pentatonic scale; variant of 合[he2]
扔	to throw; to throw away
椭	ellipse
恩	favor; grace; kindness
引	to draw; to pull; to stretch sth; to extend; to lengthen; to involve or implicate in; to attract; to lead; to guide; to leave; to provide evidence or justification for; old unit of distance equal to 10 丈[zhang4], one-thirtieth of a km or 33.33 meters
戒	to guard against; to exhort; to admonish or warn; to give up or stop doing sth; Buddhist monastic discipline; ring
爬	to crawl; to climb; to get up or sit up
吵	to quarrel; to make a noise; noisy; to disturb by making a noise; to make a racket; to quarrel
饮	to drink; to givewater to drink
圈	to confine; to lock up; to pen in; livestock enclosure; pen; fold; sty; circle; ring; loop; classifier for loops, orbits, laps of race etc; to surround; to circle; to draw a circle; cliques; circles
幽	remote; hidden away; secluded; serene; peaceful; to imprison; in superstition indicates the underworld; ancient district spanning Liaonang and Hebei provinces; faint; indistinct
穆	surname Mu; solemn; reverent; calm; burial position in an ancestral tomb
寸	a unit of length; inch; thumb
助	to help; to assist
址	site; location; islet
隔	to separate; to partition; to stand or lie between; at a distance from; after or at an interval of
侃	upright and honest; cheerful; to chat idly; to boast; to talk smoothly; to possess assurance and composure
窜	to flee; to scuttle; to exile or banish; to amend or edit
煞	to terminate; to cut short; to bring to a stop; to squeeze; to tighten; to damage; fiend; demon; very; SARS
摘	to take; to pick; to pluck; to remove; to take off; to select; to pick out; to borrow money at a time of urgent need
英	United Kingdom; British; England; English; abbr. for 英國|英国[Ying1 guo2]; hero; outstanding; excellent; flower; blossom
经	surname Jing; classics; sacred book; scripture; to pass through; to undergo; to bear; to endure; warp; longitude; menstruation; channel; abbr. for economics 經濟|经济[jing1 ji4]
睡	to sleep; to lie down
载	to record in writing; to carry; Taiwan pr. [zai4]; year; to carry; to convey; to load; to hold; to fill up; and; also; as well as; simultaneously
状	accusation; suit; state; condition; strong; great; -shaped
亚	Asia; Asian; Taiwan pr. [Ya3]; second; next to; inferior; sub-; Taiwan pr. [ya3]
掀	to lift; to rock; to convulse
糟	dregs; draff; pickled in wine; rotten; messy; ruined
滞	sluggish
是	to be; correct; right; true; very well; 
潮	tide; damp; moist; humid; fashionable; trendy; inferior; substandard
编	to weave; to plait; to organize; to group; to arrange; to edit; to compile; to write; to compose; to fabricate; to make up
簸	to winnow; to toss up and down; used in 簸箕[bo4 ji1]
柿	persimmon
辜	surname Gu; crime; sin
译	to translate; to interpret
掩	to cover up; to conceal; to close; to getcaught when closing a door or lid; to launch a surprise attack
诸	surname Zhu; all; various
塌	to collapse; to droop; to settle down
佣	commission; brokerage fee; to hire; to employ; servant; hired laborer; domestic help
局	narrow; office; situation; classifier for games: match, set, round etc; cramped; narrow
惯	accustomed to; used to; indulge; to spoil
比	Belgium; Belgian; abbr. for 比利時|比利时[Bi3 li4 shi2]; to compare; more {adj.} than {noun}; ratio; to gesture; 
权	surname Quan; authority; power; right; to weigh; expedient; temporary
截	to cut off; to stop; to intercept; section; chunk; length
些	classifier indicating a small amount or small number greater than 1: some, a few, several
虑	to think over; to consider; anxiety
白	surname Bai; white; snowy; pure; bright; empty; blank; plain; clear; to make clear; in vain; gratuitous; free of charge; reactionary; anti-communist; funeral; to stare coldly; to write wrong character; to state; to explain; vernacular; spoken lines in opera; in vain; to no purpose; for nothing; white
芒	awn; arista; tip; Miscanthus sinensis
匀	even; well-distributed; uniform; to distribute evenly; to share
卖	to sell; to betray; to spare no effort; to show off or flaunt
休	surname Xiu; to rest; to stop doing sth for a period of time; to cease; don't
薄	surname Bo; thin; cold in manner; indifferent; weak; light; infertile; meager; slight; weak; ungenerous or unkind; frivolous; to despise; to belittle; to look down on; to approach or near; see 薄荷[bo4 he5]
明	Ming Dynasty; surname Ming; Ming, fourth of the legendary Flame Emperors, 炎帝[Yan2 di4] descended from Shennong 神農|神农[Shen2 nong2] Farmer God; bright; opposite: dark 暗[an4]; clear; to understand; next; public or open; wise; generic term for a sacrifice to the gods; obviously; plainly; undoubtedly; definitely
纲	head rope of a fishing net; guiding principle; key link; class; outline; program
链	chain; cable; chain; to chain; to enchain
故	happening; instance; reason; cause; intentional; former; old; friend; therefore; hence; to die, dead
恋	to feel attached to; to long for; to love; reluctant
西	the West; abbr. for Spain 西班牙[Xi1 ban1 ya2]; Spanish; west; cubic centimeter
妆	to adorn oneself; makeup; adornment; trousseau; stage makeup and costume
徘	used in 徘徊[pai2 huai2]
潇	deep and clear; howling and pounding; pattering
愤	indignant; anger; resentment; extremely angry
砸	to smash; to pound; to fail; to muck up; to bungle
域	field; region; area; domain
呵	expel breath; my goodness; gentle laughter; chuckle
盲	blind
臂	arm
习	surname Xi; to practice; to study; habit; custom; blowing gently; abundant; flying
扇	to fan; to slap sb on the face; fan; sliding, hinged or detachable flat part of sth; classifier for doors, windows etc
乌	abbr. for Ukraine 烏克蘭|乌克兰[Wu1 ke4 lan2]; surname Wu; crow; black
居	surname Ju; sentence-final particle expressing a doubting attitude; to reside; to be; to store up; to be at a standstill; residence; house; restaurant; classifier for bedrooms
佩	to respect; to wear; girdle ornaments
油	oil; fat; grease; petroleum; to apply tung oil, paint or varnish; oily; greasy; glib; cunning; oily
件	item; component; classifier for events, things, clothes etc
袋	pouch; bag; sack; pocket
欲	desire; appetite; passion; lust; greed; to wish for; to desire
遥	distant; remote; far away; distant; remote
绪	beginnings; clues; mental state; thread
勺	spoon; ladle; abbr. for 公勺[gong1 shao2], centiliter
壳	shell; case; casing; housing; shell; Taiwan pr. [ke2]
殿	palace hall
想	to think; to think of; to devise; to think; to believe; to desire; to want; to miss
肝	liver; to put in long hours, typically late into the night, playing; involving a lot of repetition in order to progress; grindy
醋	vinegar; jealousy
输	to lose; to be beaten; to transport; to donate; to contribute; to enter
肠	intestines
吊	to suspend; to hang up; to hang a person; a string of 100 cash; to lament; to condole with
折	to snap; to break; to sustain a loss; to turn sth over; to turn upside down; to tip sth out; to break; to fracture; to snap; to suffer loss; to bend; to twist; to turn; to change direction; convinced; to convert into; discount; rebate; tenth; classifier for theatrical scenes; to fold; accounts book; to fold
社	society; organization; agency; god of the land
环	surname Huan; ring; hoop; loop; link; classifier for scores in archery etc; to surround; to encircle; to hem in
突	to dash; to move forward quickly; to bulge; to protrude; to break through; to rush out; sudden; Taiwan pr. [tu2]; beating of the heart; pitapat; pulsation of a machine
万	used in 万俟[Mo4 qi2]; surname Wan; ten thousand; a great number; absolutely; wholly
箱	box; trunk; chest
搀	to take by the arm and assist; to mix; to blend; to dilute; to adulterate
蟑	cockroach
谢	surname Xie; to thank; to apologize; to wither; to decline; to thank; thanks; thank you
呕	vomit
廉	old variant of 廉[lian2]; surname Lian; incorruptible; honest; inexpensive; to investigate; side wall of a traditional Chinese house
捷	quick; nimble; Czech; Czech Republic; abbr. for 捷克[Jie2 ke4]; victory; triumph; quick; nimble; prompt
饺	dumplings with meat filling
男	male; Baron, lowest of five orders of nobility 五等爵位[wu3 deng3 jue2 wei4]
盯	to watch attentively; to fix one's attention on; to stare at; to gaze at
晒	to shine on; to bask in; to dryin the sun; to expose and shareon the Web; to give the cold shoulder to
翅	wing
开	to open; to start; to turn on; to put in operation; to operate; to run; to boil; to write out; away; off; carat; abbr. for Kelvin, 開爾文|开尔文[Kai1 er3 wen2]; abbr. for 開本|开本[kai1 ben3], book format
摩	to rub
惜	to cherish; to begrudge; to pity; Taiwan pr. [xi2]
碑	a monument; an upright stone tablet; stele
郊	surname Jiao; suburbs; outskirts
彼	that; those; another
治	to rule; to govern; to manage; to control; to harness; to treat; to wipe out; to punish; to research
呼	to call; to cry; to shout; to breath out; to exhale; sound of the wind or the breathing of sb who is sound asleep; to shout; to call out
箭	arrow
芹	Chinese celery
喧	clamor; noise; old variant of 諼|谖[xuan1]
移	to move; to shift; to change; to alter; to remove
区	surname Ou; area; region; district; small; distinguish; insignificant; trifling; merely
轮	wheel; disk; ring; steamship; to take turns; to rotate; classifier for big round objects: disk, or recurring events: round, turn
怨	to blame; resentment; hatred; grudge
诱	to induce; to entice
雀	a freckle; lentigo; small bird; sparrow; also pr. [qiao3]
酿	to ferment; to brew; to make honey; to lead to; to form gradually; wine; stuffed vegetables
屁	fart; flatulence; nonsense; what; a damn thing; buttocks; bottom
淹	to flood; to submerge; to drown; to irritate the skin; to delay
到	to reach; to arrive; to leave for; to go to; to; until; up to; ; considerate; thoughtful; thorough
战	to fight; fight; war; battle
铲	to level off; to root up; to shovel; to remove; spade; shovel
结	to produce; Taiwan pr. [jie2]; knot; sturdy; bond; to tie; to bind; to check out
庆	to celebrate
俭	frugal; thrifty
革	animal hide; leather; to reform; to remove; to expel
年	surname Nian; year; year after year; yearly; every year; annually; grain; harvest
茫	vast, with no clear boundary; fig. hazy; indistinct; unclear; confused; boundless; vast and obscure
姿	beauty; disposition; looks; appearance
扶	to support with the hand; to help sb up; to support oneself by holding onto something; to help
议	to comment on; to discuss; to suggest
猾	sly
按	to press; to push; to leave aside or shelve; to control; to restrain; to keep one's hand on; to check or refer to; according to; in the light of; to make a comment
颖	head of grain; husk; tip; point; clever; gifted; outstanding
卡	to stop; to block; slow; card; truck; calorie; cassette; to block; to be stuck; to be wedged; customs station; a clip; a fastener; a checkpost; Taiwan pr. [ka3]
筹	chip; token; ticket; to prepare; to plan; to raise; resource; way; means
诈	to cheat; to swindle; to pretend; to feign; to draw sb out; to try to extract information by deceit or bluff
插	to insert; stick in; pierce; to take part in; to interfere; to interpose
丑	surname Chou; clown; 2nd earthly branch: 1-3 a.m., 12th solar month, year of the Ox; ancient Chinese compass point: 30°; shameful; ugly; disgraceful
伪	false; fake; forged; bogus; pseudo-; Taiwan pr. [wei4]
数	to count; to count as; to regard as; to enumerate; to list; number; figure; several; a few; frequently; repeatedly; to count; to reckon
党	surname Dang; party; association; club; society
犀	rhinoceros; sharp
侧	the side; to incline towards; to lean; inclined; lateral; side; lean on one side
拌	to mix; to mix in; to toss
嗅	to smell; to sniff; to nose
章	surname Zhang; chapter; section; clause; movement; seal; badge; regulation; order
弦	bow string; string of musical instrument; watchspring; chord; hypotenuse
纵	vertical; north-south; from front to back; longitudinal; lengthwise; military unit corresponding to an army corps; to release; to indulge; to leap up; even if
渐	to imbue; gradual; gradually; gradually
沧	blue-green or azure; vast; cold
践	to fulfill; to tread; to walk
起	to rise; to raise; to get up; to set out; to start; to appear; to launch; to initiate; to draft; to establish; to get; verb suffix, to start; starting from; classifier for occurrences or unpredictable events: case, instance; classifier for groups: batch, group
甲	first of the ten Heavenly Stems 十天干[shi2 tian1 gan1]; ; first; letter "A" or roman "I" in list "A, B, C", or "I, II, III" etc; armor plating; shell or carapace; nail; bladed leather or metal armor; ranking system used in the Imperial examinations; civil administration unit in the baojia 保甲[bao3 jia3] system; ancient Chinese compass point: 75°
讳	to avoid mentioning; taboo word; name of deceased emperor or superior
险	danger; dangerous; rugged
闭	to close; to stop up; to shut; to obstruct
担	to undertake; to carry; to shoulder; to take responsibility; picul; two buckets full; carrying pole and its load; classifier for loads carried on a shoulder pole
冬	winter; surname Dong; beating a drum; rat-a-tat
镜	mirror; lens
眶	eye socket; Taiwan pr. [kuang1]
渔	fisherman; to fish
搏	to fight; to combat; to seize; to beat
叒	obedient; ancient mythical tree
丐	to beg for alms; beggar; variant of 丐[gai4]
罩	to cover; to spread over; a cover; a shade; a hood; bamboo fish trap; bamboo chicken coop; to protect; to have sb's back; awesome; incredible; to have things under control; to be able to handle it
煮	to cook; to boil
撇	to cast away; to fling aside; to throw; to cast; left-slanting downward brush stroke
慧	intelligent
霍	surname Huo; suddenly; sound of sharpening a knife
币	money; coins; currency; silk
艘	classifier for ships; Taiwan pr. [sao1]
泪	tears
幼	young
甜	sweet
歌	song; to sing
蕉	banana; see 蕉萃[qiao2 cui4]
孝	filial piety or obedience; mourning apparel
剩	to remain; to be left; to have as remainder
初	at first; beginning; first; junior; basic
萃	collect; collection; dense; grassy; thick; assemble; gather
晰	clear; distinct; white
有	to have; there is; having; with; -ful; -ed; -al
敏	quick; nimble; agile; quick-witted; smart
倘	used in 倘佯[chang2 yang2]; if; supposing; in case
夸	used in 夸克[kua1 ke4]; to boast; to exaggerate; to praise
牧	surname Mu; to herd; to breed livestock; to govern; government official
入	to enter; to go into; to join; to become a member of; to confirm or agree with; abbr. for 入聲|入声[ru4 sheng1]
旱	drought
限	to limit; to restrict; limit; bound
绑	to tie; bind or fasten together; to kidnap
王	surname Wang; king or monarch; best or strongest of its type; grand; great; to rule; to reign over
鄙	rustic; low; base; mean; to despise; to scorn
咋	dialectal equivalent of 怎麼|怎么[zen3 me5]; gnaw; loud noise; shout; suddenly
试	to test; to try; experiment; examination; test
好	good; appropriate; proper; all right!; easy to; good to; so; ; close; on intimate terms; hello; to be fond of; to have a tendency to; to be prone to; well; carefully; nicely; properly
嘱	to enjoin; to implore; to urge
天	day; sky; heaven; every day
诞	birth; birthday; brag; boast; to increase
瀑	shower; waterfall
筛	a sieve; to sieve; to sift; to filter; to eliminate through selection; to warm a pot of rice wine; to pour; to strike
豆	legume; pulse; bean; pea; stemmed sacrificial vessel
曲	surname Qu; bent; crooked; wrong; tune; song; yeast; Aspergillus; Taiwan pr. [qu2]
拉	to pull; to play; to drag; to draw; to chat; to empty one's bowels; Lala, Philippines; lesbian; Labrador retriever
递	to hand over; to pass on; to deliver; progressively; in the proper order
绅	member of gentry
诉	to complain; to sue; to tell
紧	tight; strict; close at hand; near; urgent; tense; hard up; short of money; to tighten; closely; tightly
了	; ; ; to finish; to achieve; to understand clearly; to realize clearly; to settle a matter; to get it over with; bright; clear-sighted; to understand clearly
世	surname Shi; life; age; generation; era; world; lifetime; epoch; descendant; noble; from age to age
恰	exactly; just; exactly; just; precisely
展	surname Zhan; to spread out; to open up; to exhibit; to put into effect; to postpone; to prolong; exhibition
滩	beach; shoal; rapids; classifier for liquids: pool, puddle
斯	Slovakia; Slovak; abbr. for 斯洛伐克[Si1 luo4 fa2 ke4]; ; this
惠	surname Hui; act of kindness; kind
赁	to rent
烧	to burn; to cook; to stew; to bake; to roast; to heat; to boil; fever; to run a temperature; to let things go to one's head
材	material; timber; ability; aptitude; a capable individual; coffin
痪	illness; numbness of the limbs
骂	to scold; to abuse; to curse
嗓	throat; voice
凭	to lean against; to rely on; on the basis of; no matter; proof
夜	night; every night
金	surname Jin; surname Kim; Jurchen Jin dynasty; gold; chemical element Au; generic term for lustrous and ductile metals; money; golden; highly respected; one of the eight categories of ancient musical instruments 八音[ba1 yin1]
藏	Tibet; abbr. for Xizang or Tibet Autonomous Region 西藏[Xi1 zang4]; to conceal; to hide away; to harbor; to store; to collect; storehouse; depository; Buddhist or Taoist scripture
美	the Americas; USA; beautiful; very satisfactory; good; to beautify; to be pleased with oneself
谦	modest
符	surname Fu; mark; sign; talisman; to seal; to correspond to; tally; symbol; written charm; to coincide
边	side; edge; margin; border; boundary; simultaneously; suffix of a noun of locality
艾	surname Ai; Chinese mugwort or wormwood; moxa; to stop or cut short; phonetic "ai" or "i"; abbr. for 艾滋病[ai4 zi1 bing4], AIDS; to mow; to cut; to reap; to redress
恼	to get angry
酥	flaky pastry; crunchy; limp; soft; silky
宣	surname Xuan; to declare; to announce
屡	time and again; repeatedly; frequently; again and again; repeatedly
枣	jujube; Chinese date
军	army; military
堆	to pile up; to heap up; a mass; pile; heap; stack; large amount
堤	dike; Taiwan pr. [ti2]
染	to dye; to catch; to acquire; to contaminate; to add color washes to a painting
刻	quarter; moment; to carve; to engrave; to cut; oppressive; classifier for short time intervals
超	to exceed; to overtake; to surpass; to transcend; to pass; to cross; ultra-; super-
贪	to have a voracious desire for; to covet; greedy; corrupt
我	I; me; my
仿	to imitate; to copy; seemingly
疤	scar; scab
己	self; oneself; sixth of the ten Heavenly Stems 十天干[shi2 tian1 gan1]; sixth in order; letter "F" or Roman "VI" in list "A, B, C", or "I, II, III" etc; hexa
朝	abbr. for 朝鮮|朝鲜[Chao2 xian3] Korea; imperial or royal court; government; dynasty; reign of a sovereign or emperor; court or assembly held by a sovereign or emperor; to make a pilgrimage to; facing; towards; morning; every day
钢	steel
瓶	bottle; vase; pitcher; classifier for wine and liquids
缴	to hand in; to hand over; to seize
席	surname Xi; woven mat; seat; banquet; place in a democratic assembly; classifier for banquets, conversations etc; woven mat
就	in that case; then; as soon as; immediately after; merely; nothing else but; simply; just; precisely; exactly; only; as little as; as much as; as many as; to approach; to move towards; to undertake; to engage in; taking advantage of; to go with; with regard to; concerning; even if ... still ...; if not ... then must be ...
竹	bamboo; Kangxi radical 118
舔	to lick; to lap
摄	to take in; to absorb; to assimilate; to take; to conserve; to act for
色	color; look; appearance; sex; color; used in 色子[shai3 zi5]
牵	to lead along; to pull; to involve; to draw in
誓	oath; vow; to swear; to pledge
掐	to pick; to pinch; to nip; to pinch off; to clutch; to fight
羊	surname Yang; sheep; goat
巾	towel; general purpose cloth; women's headcovering; Kangxi radical 50
默	silent; to write from memory; in silence; not speaking
薯	potato; yam
搜	to search
猝	abruptly; suddenly; unexpectedly
吻	kiss; to kiss; mouth
磋	deliberate; to polish
坞	dock; low wall
剖	to cut open; to analyze; Taiwan pr. [pou3]
舰	warship
蚁	ant
绝	to cut short; extinct; to disappear; to vanish; absolutely; by no means
帐	curtain; tent; canopy
孩	child
咐	used in 吩咐[fen1fu5] and 囑咐|嘱咐[zhu3fu5]
蹭	to rub against; to walk slowly; to freeload
夏	the Xia or Hsia dynasty c. 2000 BC; Xia of the Sixteen Kingdoms; surname Xia; summer
项	surname Xiang; back of neck; item; thing; term; sum; classifier for principles, items, clauses, tasks, research projects etc
介	to introduce; to lie between; between; shell; armor
挡	to resist; to obstruct; to hinder; to keep off; to block; to get in the way of; cover; gear; to arrange; to put in order
暖	warm; to warm; Nuannuan District of Keelung City 基隆市[Ji1 long2 Shi4], Taiwan; variant of 暖[nuan3], warm
燥	dry; parched; impatient; vexed; minced meat
倾	to overturn; to collapse; to lean; to tend; to incline; to pour out
郑	Zheng state during the Warring States period; surname Zheng; abbr. for 鄭州|郑州[Zheng4 zhou1]; bound form used in 鄭重|郑重[zheng4 zhong4] and 雅鄭|雅郑[ya3 zheng4]
脊	spine; backbone; ridge
距	to be at a distance of ... from; to be apart from; distance; spur
瘤	tumor
树	tree; to cultivate; to set up
寺	Buddhist temple; mosque; government office
票	ticket; ballot; banknote; person held for ransom; amateur performance of Chinese opera; classifier for groups, batches, business transactions
调	to transfer; to move; to investigate; to enquire into; accent; view; argument; key; mode; tune; tone; melody; to harmonize; to reconcile; to blend; to suit well; to adjust; to regulate; to season; to provoke; to incite
连	surname Lian; to link; to join; to connect; continuously; in succession; including; even; company; repeatedly; again and again
稼	to sow grain; crop
委	surname Wei; same as 逶 in 逶迤 winding, curved; to entrust; to cast aside; to shift; to accumulate; roundabout; winding; dejected; listless; committee member; council; end; actually; certainly
瞧	to look at; to see; to see; to visit
河	river
啥	dialectal equivalent of 什麼|什么[shen2 me5]; also pr. [sha4]
民	surname Min; the people; inhabitants of a country
部	ministry; department; section; part; division; troops; board; classifier for works of literature, films, machines etc
酗	drunk
予	I; me; to give
恳	earnest
酌	to pour wine; to drink wine; to deliberate; to consider
杉	China fir; Cunninghamia lanceolata; also pr. [sha1]
竭	to exhaust
静	still; calm; quiet; not moving
逐	to pursue; to chase away; individually; one by one
熙	; bright; prosperous; splendid; genial
亦	also
飞	to fly
披	to drape over one's shoulders; to open; to unroll; to split open; to spread out
泽	pool; pond; luster; favor or beneficence; damp; moist
刺	whoosh; thorn; sting; thrust; to prick; to pierce; to stab; to assassinate; to murder
穷	poor; destitute; to use up; to exhaust; thoroughly; extremely; persistently and pointlessly
奠	to fix; to settle; a libation to the dead
寿	surname Shou; long life; old age; age; life; birthday; funerary
究	after all; to investigate; to study carefully; Taiwan pr. [jiu4]
触	to touch; to make contact with sth; to stir up sb's emotions
价	price; value; valence; great; good; middleman; servant
增	to increase; to augment; to add to
愣	to look distracted; to stare blankly; distracted; blank; unexpectedly; rash; rashly
脂	fat; rouge; resin
泡	puffed; swollen; spongy; small lake; classifier for urine or feces; bubble; foam; blister; to soak; to steep; to infuse; to dawdle; to loiter; to pick up; to get off with; classifier for occurrences of an action; classifier for number of infusions; bubbles
羽	feather; 5th note in pentatonic scale
偿	to repay; to compensate for; to recompense; to fulfill
逊	to abdicate; modest; yielding; unpretentious; inferior to; to suck
坡	slope; sloping; slanted
忘	to forget; to overlook; to neglect
哨	a whistle; sentry
怎	how
体	body; form; style; system; substance; to experience; aspect
揍	to hit; to beat; to smash
叉	fork; pitchfork; prong; pick; cross; intersect; "X"; to cross; be stuck; to diverge; to open
捞	to fish up; to dredge up
蚀	to nibble away at sth; to eat into; to erode
狈	a legendary wolf; distressed; wretched
只	only; merely; just; but; grain that has begun to ripen; classifier for birds and certain animals, one of a pair, some utensils, vessels etc
刹	Buddhist monastery, temple or shrine; to brake
喜	to be fond of; to like; to enjoy; to be happy; to feel pleased; happiness; delight; glad
蔓	used in 蔓菁[man2 jing5]; creeper; to spread
泉	spring; mouth of a spring; coin
点	point; dot; drop; speck; o'clock; point; to draw a dot; to check on a list; to choose; to order; to touch briefly; to hint; to light; to ignite; to pour a liquid drop by drop; one fifth of a two-hour watch 更[geng1]; dot stroke in Chinese characters; classifier for items; Diandian; point; speck
伽	traditionally used as phonetic for "ga"; also pr. [ga1]; also pr. [qie2]
止	to stop; to prohibit; until; only
告	to say; to tell; to announce; to report; to denounce; to file a lawsuit; to sue
贝	surname Bei; cowrie; shellfish; currency
促	of short duration; hasty; rapid; to hasten; to hurry; to urge; close by; pressed against
贸	commerce; trade
讼	litigation
褂	Chinese-style unlined garment; gown
组	surname Zu; to form; to organize; group; team; classifier for sets, series, groups of people, batteries
剥	to peel; to skin; to shell; to shuck; to peel; to skin; to flay; to shuck
缠	to wind around; to wrap round; to coil; tangle; to involve; to bother; to annoy
瑞	lucky; auspicious; propitious; rayl
错	surname Cuo; mistake; wrong; bad; interlocking; complex; to grind; to polish; to alternate; to stagger; to miss; to let slip; to evade; to inlay with gold or silver
首	head; chief; first; classifier for poems, songs etc
唐	Tang dynasty; surname Tang; to exaggerate; empty; in vain
裁	to cut out; to cut; to trim; to reduce; to diminish; to cut back; decision; judgment
菇	mushroom
蹬	to step on; to tread on; to put on; to wear; to dump; Taiwan pr. [deng4]
哥	elder brother; older brother
丙	third of the ten Heavenly Stems 十天干[shi2 tian1 gan1]; third in order; letter "C" or Roman "III" in list "A, B, C", or "I, II, III" etc; ancient Chinese compass point: 165°; propyl
蹈	to tread on; to trample; to stamp; to fulfill; Taiwan pr. [dao4]
谱	chart; list; table; register; score; spectrum; to set to music
辛	surname Xin; hot or pungent; hard; laborious; suffering; eighth in order; eighth of the ten Heavenly Stems 十天干[shi2 tian1 gan1]; letter "H" or Roman "VIII" in list "A, B, C", or "I, II, III" etc; ancient Chinese compass point: 285°; octa
趟	to wade; to trample; to turn the soil; classifier for times, round trips or rows; a time; a trip
迪	to enlighten
污	dirty; filthy; foul; corrupt; to smear; to defile; dirt; filth
樱	cherry
易	surname Yi; abbr. for 易經|易经[Yi4 jing1], the Book of Changes; easy; amiable; to change; to exchange; prefix corresponding to the English adjective suffix "-able" or "-ible"
付	surname Fu; to pay; to hand over to; classifier for pairs or sets of things
用	to use; to employ; to have to; to eat or drink; expense or outlay; usefulness; hence; therefore
页	head; page; leaf
李	surname Li; plum
垃	used in 垃圾[la1 ji1]; Taiwan pr. [le4]
言	words; speech; to say; to talk
劲	strength; energy; enthusiasm; spirit; mood; expression; interest; Taiwan pr. [jing4]; stalwart; sturdy; strong; powerful
虐	oppressive; tyrannical
德	Germany; German; abbr. for 德國|德国[De2 guo2]; virtue; goodness; morality; ethics; kindness; favor; character; kind; variant of 德[de2]
急	urgent; pressing; rapid; hurried; worried; to makeanxious
循	to follow; to adhere to; to abide by
名	name; noun; place; famous; classifier for people
条	strip; item; article; clause; classifier for long thin things
惹	to provoke; to irritate; to vex; to stir up; to anger; to attract; to cause
疏	surname Shu; to dredge; to clear away obstruction; thin; sparse; scanty; distant; not close; to neglect; negligent; to present a memorial to the Emperor; commentary; annotation; sparse; blurred; old for 楚楚[chu3 chu3]; neat; lovely
翼	surname Yi; alternative name for 絳|绛[Jiang4] capital of the Jin State during the Spring and Autumn Period; wing; area surrounding the bullseye of a target; to assist; one of the 28 constellations of Chinese astronomy; cautious; prudent
希	to hope; to admire
删	to delete
招	to recruit; to provoke; to beckon; to incur; to infect; contagious; a move; a maneuver; device; trick; to confess
辑	to gather up; to collect; to edit; to compile
谈	surname Tan; to speak; to talk; to converse; to chat; to discuss; to discuss; to have a chat
画	to draw; to paint; picture; painting; stroke of a Chinese character; to draw; to paint
演	to perform; to stage; to develop; to play out; to carry out
杜	surname Du; birchleaf pear; to stop; to prevent; to restrict
葛	surname Ge; kudzu; hemp cloth
胶	to glue; glue; gum; rubber
莱	name of weed plant; Chenopodium album
桨	oar; paddle
渺	vast; distant and indistinct; tiny or insignificant
警	to alert; to warn; police
壮	Zhuang ethnic group of Guangxi, the PRC's second most numerous ethnic group; to strengthen; strong; robust
冤	injustice; grievance; wrong
加	Canada; surname Jia; to add; plus; ; to applyto; to giveto
患	to suffer; to contract; misfortune; trouble; danger; worry
哒	; command to a horse; clatter
钓	to fish with a hook and bait
缸	jar; vat; classifier for loads of laundry
献	to offer; to present; to dedicate; to donate; to show; to put on display; worthy person
满	Manchu ethnic group; to fill; full; filled; packed; fully; completely; quite; to reach the limit; to satisfy; satisfied; contented; full; closely packed
糖	sugar; sweets; candy
参	to take part in; to participate; to join; to attend; to counsel; unequal; varied; irregular; uneven; not uniform; abbr. for 參議院|参议院 Senate, Upper House; used in 參差|参差[cen1 ci1]; ginseng; one of the 28 constellations; variant of 參|参[shen1]
津	abbr. for Tianjin 天津[Tian1 jin1]; saliva; sweat; a ferry crossing; a ford; enthusiastic; ardent; great relish
屈	surname Qu; bent; to feel wronged
腊	dried meat; also pr. [xi2]; ancient practice of offering sacrifices to the gods in the 12th lunar month; the 12th lunar month; cured in winter, esp. in the 12th lunar month
看	to look after; to take care of; to watch; to guard; to see; to look at; to read; to watch; to visit; to call on; to consider; to regard as; to look after; to treat; to depend on; to feel; to give it a try; to watch out for; to take a look at; to examine; to survey; pretty soon
蘇	no definition found
需	to require; to need; to want; necessity; need
鼾	snore; to snore; to snore
新	abbr. for Xinjiang 新疆[Xin1 jiang1] or Singapore 新加坡[Xin1 jia1 po1]; surname Xin; new; newly; meso-
跟	heel; to follow closely; to go with; to marry sb; with; compared with; to; towards; and
浇	to pour liquid; to irrigate; to water; to cast; to mold
略	brief; sketchy; outline; summary; to omit; a bit; somewhat; slightly; plan; strategy; to capture; slightly; roughly; briefly; very generally
命	life; fate; order or command; to assign a name, title etc
蜓	see 蜻蜓[qing1 ting2]
梦	dream; to dream
敞	open to the view of all; spacious; to open wide; to disclose
庞	surname Pang; huge; numerous and disordered; face
表	exterior surface; family relationship via females; to show; a model; a table; a form; a meter; watch; meter; gauge
珍	precious thing; treasure; culinary delicacy; rare; valuable; to value highly
挽	to pull; to draw; to roll up; to coil; to carry on the arm; to lament the dead; to pull against; to recover; to draw; to lament the dead
赤	red; scarlet; bare; naked
达	surname Da; to attain; to reach; to amount to; to communicate; eminent
鞋	shoe
糕	cake
矩	carpenter's square; rule; regulation; pattern; to carve
于	surname Yu; to go; to take; sentence-final interrogative particle; in; at; on; to; toward; vis-à-vis; with regard to; for; from; out of; than; by
瞻	to gaze; to view
蔼	friendly; luxuriant
怜	to pity
苹	; duckweed; used in 蘋果|苹果[ping2 guo3]
趣	interesting; to interest
才	ability; talent; sb of a certain type; a capable individual; then and only then; just now; only; only
涵	to contain; to include; culvert
杖	a staff; a rod; cane; walking stick; to flog with a stick
剁	to chop up; to chop off
戏	trick; drama; play; show
墅	villa
搓	to rub or roll between the hands or fingers; to twist
费	surname Fei; to cost; to spend; fee; wasteful; expenses
丁	surname Ding; male adult; the 4th of the 10 Heavenly Stems 天干[tian1 gan1]; fourth; small cube of meat or vegetable; to encounter; ancient Chinese compass point: 195°; butyl; Tintin, cartoon character; penis; sound of chopping wood, chess pieces hitting the board etc
斜	inclined; slanting; oblique; tilting
葡	Portugal; Portuguese; abbr. for 葡萄牙[Pu2 tao2 ya2]; used in 葡萄[pu2 tao5]
诫	commandment; to prohibit
兴	surname Xing; to rise; to flourish; to become popular; to start; to encourage; to get up; to permit or allow; maybe; feeling or desire to do sth; interest in sth; excitement
请	to ask; to invite; please; to treat; to request
安	surname An; calm; peaceful; to calm; to set at ease; safe; secure; in good health; content; satisfied; to placein a suitable position; to install; to fix; to fit; to bring; to harbor; ampere; Greetings!
笨	stupid; foolish; silly; slow-witted; clumsy
雇	to employ; to hire; to rent
饶	surname Rao; rich; abundant; exuberant; to add for free; to throw in as bonus; to spare; to forgive; despite; although
甘	surname Gan; abbr. for Gansu Province 甘肅省|甘肃省[Gan1 su4 Sheng3]; sweet; willing
矿	mineral deposit; ore deposit; ore; a mine
键	key; button; chemical bond; linchpin
悦	pleased
呈	to present to a superior; memorial; petition; to present; to assume; to be
后	surname Hou; empress; queen; monarch; ruler; back; behind; rear; afterwards; after; later; post-
磁	magnetic; magnetism; porcelain
赖	surname Lai; LINE messaging app; to depend on; to hang on in a place; bad; to renege; to disclaim; to rat; rascally; to blame; to put the blame on
翔	to soar; to glide; shit
疫	epidemic; plague
息	breath; news; interest; to cease; to stop; to rest; Taiwan pr. [xi2]
深	deep; deep; profound
人	person; people; everyone; every person
逛	to stroll; to visit; to roam around; to have a stroll
城	city walls; city; town
盛	surname Sheng; to hold; to contain; to ladle; to pick up with a utensil; flourishing; vigorous; magnificent; extensively
怒	anger; fury; flourishing; vigorous
炒	to sauté; to stir-fry; to speculate; to scalp; to hype up; to sack; to fire
挂	to hang; to suspend; to hang up; to be dead; to be worried; to be concerned; to make a phone call; to register; to make an appointment; to kill; to die; to be finished; to fail; classifier for sets or clusters of objects
勃	flourishing; prosperous; suddenly; abruptly; thriving; vigorous; exuberant
派	used in 派司[pa1 si5]; clique; school; group; faction; to dispatch; to send; to assign; to appoint; pi; the circular ratio pi = 3.1415926; pie
劉	no definition found
乡	country or countryside; native place; home village or town; township
帆	sail; Taiwan pr. [fan2], except 帆布[fan1 bu4] canvas; to gallop; Taiwan pr. [fan2]
糙	rough; coarse
千	thousand; see 鞦韆|秋千[qiu1 qian1]
许	surname Xu; to allow; to permit; to promise; to praise; somewhat; perhaps
固	hard; strong; solid; sure; assuredly; undoubtedly; of course; indeed; admittedly
扯	to pull; to tear; to buy; to chat; to gossip; ridiculous; hokey; to pull; to tear
柱	pillar
系	to connect; to relate to; to tie up; to bind; to be; system; department; faculty; to tie; to fasten; to button up; to connect; to arrest; to worry
苦	bitter; hardship; pain; to suffer; to bring suffering to; painstakingly; strenuously; persistently; hard; painful
势	power; influence; potential; momentum; tendency; trend; situation; conditions; outward appearance; sign; gesture; male genitals
肘	elbow; pork shoulder
狡	crafty; cunning; sly
炼	to refine; to smelt; variant of 煉|炼[lian4]
发	to send out; to show; to issue; to develop; to make a bundle of money; classifier for gunshots; hair; Taiwan pr. [fa3]
榜	notice or announcement; list of names; public roll of successful examinees
侵	to invade; to encroach; to infringe; to approach
收	to receive; to accept; to collect; to put away; to restrain; to stop; in care of
墙	wall; to block
凡	ordinary; commonplace; mundane; temporal; of the material world; every; all; whatever; altogether; gist; outline; note of Chinese musical scale
存	to exist; to deposit; to store; to keep; to survive
危	surname Wei; danger; to endanger; Taiwan pr. [wei2]
茴	fennel
法	France; French; abbr. for 法國|法国[Fa3 guo2]; Taiwan pr. [Fa4]; law; method; way; to emulate; dharma; the Legalists; farad; law
鼓	drum; to drum; to strike; to rouse; to bulge; to swell; bulging; bursting
成	surname Cheng; to succeed; to finish; to complete; to accomplish; to become; to turn into; to be all right; OK!; one tenth
殖	to grow; to reproduce
童	surname Tong; child
识	to know; knowledge; Taiwan pr. [shi4]; to record; to write a footnote
压	to press; to push down; to keep under; pressure; used in 壓根兒|压根儿[ya4 gen1 r5] and 壓馬路|压马路[ya4 ma3 lu4] and 壓板|压板[ya4 ban3]
淋	to sprinkle; to drip; to pour; to drench; to filter; to strain; to drain; gonorrhea; strangury
罐	can; jar; pot
室	surname Shi; room; work unit; grave; scabbard; family or clan; one of the 28 constellations of Chinese astronomy
已	already; to stop; then; afterwards
赂	bribe; bribery
掌	palm of the hand; sole of the foot; paw; horseshoe; to slap; to hold in one's hand; to wield
瞩	to gaze at; to stare at
团	round; lump; ball; to roll into a ball; to gather; regiment; group; society; classifier for a lump or a soft mass: wad, ball, cloud; dumpling
嫌	to dislike; suspicion; resentment; enmity; abbr. for 嫌犯[xian2 fan4], criminal suspect
该	should; ought to; probably; must be; to deserve; to owe; to be sb's turn to do sth; that; the above-mentioned
越	generic word for peoples or states of south China or south Asia at different historical periods; abbr. for Vietnam 越南; to exceed; to climb over; to surpass; the more... the more
拽	to drag; to haul; to throw; to fling; alternate writing of 跩[zhuai3]; to pull; to tug at
园	surname Yuan; land used for growing plants; site used for public recreation; abbr. for a place ending in 園|园, such as a botanical garden 植物園|植物园, kindergarten 幼兒園|幼儿园 etc
蹦	to jump; to bounce; to hop
韭	leek
谣	popular ballad; rumor
领	neck; collar; to lead; to receive; classifier for clothes, mats, screens etc
阂	obstruct
亡	to die; to lose; to be gone; to flee; deceased
酝	to brew
启	variant of 啟|启[qi3]; Qi son of Yu the Great 禹[Yu3], reported founder of the Xia Dynasty 夏朝[Xia4 Chao2]; to open; to start; to initiate; to enlighten or awaken; to state; to inform
蕴	to accumulate; to hold in store; to contain; to gather together; to collect; depth; inner strength; profundity
推	to push; to cut; to refuse; to reject; to decline; to shirk; to put off; to delay; to push forward; to nominate; to elect; massage
原	surname Yuan; Hara; former; original; primary; raw; level; cause; source
赢	to beat; to win; to profit
蜡	candle; wax
处	to reside; to live; to dwell; to be in; to be situated at; to stay; to get along with; to be in a position of; to deal with; to discipline; to punish; place; location; spot; point; office; department; bureau; respect; classifier for locations or items of damage: spot, point; everywhere; in all respects
研	to grind; study; research
退	to retreat; to withdraw; to reject; to return; to decline
宿	surname Su; lodge for the night; old; former; night; classifier for nights; constellation
拨	to push aside with the hand, foot, a stick etc; to dial; to allocate; to set aside; to poke; to pluck; to turn round; classifier: group, batch
鸣	to cry; to make a sound; to voice
刑	surname Xing; punishment; penalty; sentence; torture; corporal punishment
掏	to fish out; to scoop
吩	used in 吩咐[fen1fu5]; used in transliteration of chemical compounds
膝	knee
片	disk; sheet; thin piece; flake; a slice; film; TV play; to slice; to carve thin; partial; incomplete; one-sided; classifier for slices, tablets, tract of land, area of water; classifier for CDs, movies, DVDs etc; used with numeral 一[yi1]: classifier for scenario, scene, feeling, atmosphere, sound etc; Kangxi radical 91
护	to protect
瞪	to openwide; to stare at; to glare at
遵	to observe; to obey; to follow; to comply with
罪	guilt; crime; fault; blame; sin
妄	absurd; fantastic; presumptuous; rash
皂	soap; black
绒	velvet; woolen
肢	limb
磨	to rub; to grind; to polish; to sharpen; to wear down; to die out; to waste time; to pester; to insist; grindstone; to grind; to turn round
袱	bundle wrapped in cloth
若	to seem; like; as; if
淘	to wash; to clean out; to cleanse; to eliminate; to dredge
题	surname Ti; topic; problem for discussion; exam question; subject; to inscribe; to mention
逻	patrol
如	as; as if; such as
业	surname Ye; line of business; industry; occupation; job; employment; school studies; enterprise; property; karma; deed; to engage in; already
报	to announce; to inform; report; newspaper; recompense; revenge
回	to circle; to go back; to turn around; to answer; to return; to revolve; Hui ethnic group; time; classifier for acts of a play; section or chapter; Hui ethnic group; time and again; every time; to curve; to return; to revolve
谁	who; also pr. [shui2]
蜂	bee; wasp
董	surname Dong; to supervise; to direct; director
冲	to dash against; to mix with water; to infuse; to rinse; to flush; to develop; to rise in the air; to clash; to collide with; excitedly; thoroughfare; to go straight ahead; to rush; to clash; powerful; vigorous; pungent; towards; in view of
寄	to send; to mail; to entrust; to depend on; to attach oneself to; to live; to lodge; foster
涩	astringent; tart; acerbity; unsmooth; rough; hard to understand; obscure
奴	slave
络	small net; net-like object; to hold sth in place with a net; to wind; to twist; channels in the human body
装	adornment; to adorn; dress; clothing; costume; to play a role; to pretend; to install; to fix; to wrap; to load; to pack
裹	to wrap around; bundle; parcel; package; to press into service; to pressgang; to make off with
药	leaf of the iris; medicine; drug; substance used for a specific purpose; to poison
内	inside; inner; internal; within; interior; panties
句	sentence; clause; phrase; classifier for phrases or lines of verse
屏	see 屏營|屏营[bing1 ying2]; to get rid of; to put aside; to reject; to keep control; to hold; screen
坐	surname Zuo; to sit; to take a seat; to take; to bear fruit
弊	detriment; fraud; harm; defeat
雾	fog; mist
衔	variant of 銜|衔[xian2]; bit; to hold in the mouth; to harbor; to link; to accept; rank; title
繁	complicated; many; in great numbers; abbr. for 繁體|繁体[fan2 ti3], traditional form of Chinese characters
徊	used in 徘徊[pai2 huai2]
铜	copper; see also 紅銅|红铜[hong2 tong2]
括	to enclose; to include; also pr. [gua1]
伟	big; large; great
实	real; true; honest; really; solid; fruit; seed; definitely
奇	odd; strange; odd; weird; wonderful; surprisingly; unusually
旗	flag; banner; flag; Manchu; administrative subdivision in inner Mongolia equivalent to 縣|县[xian4] county
云	to say; and so on; so and so; many and confused; surname Yun; abbr. for Yunnan Province 雲南省|云南省[Yun2 nan2 Sheng3]; cloud
个	used in 自個兒|自个儿[zi4 ge3 r5]; ; individual; each one individually; each and every
晴	clear; fine
爆	to explode or burst; to quick fry or quick boil
骄	proud; arrogant
啸	to whistle; to screech; to howl; to roar
振	to shake; to flap; to vibrate; to resonate; to rise up with spirit; to rouse oneself
梳	to comb; a comb
迈	to take a step; to stride
妒	to envy; jealous
灰	ash; dust; lime; gray; discouraged; dejected
录	to carve wood; surname Lu; diary; record; to hit; to copy
托	to hold up in one's hand; to support with one's palm; sth serving as a support: a prop, a rest; a shill; torr; to trust; to entrust; to be entrusted with; to act as trustee
官	surname Guan; government official; governmental; official; public; organ of the body
作	worker; workshop; troublesome; high-maintenance; to do; to engage in; to write; to compose; to pretend; to feign; to regard as; to consider to be; to be; to act the part of; to feel; writings; works
脾	spleen
似	used in 似的[shi4 de5]; to seem; to appear; to resemble; similar; -like; pseudo-; than
拿	variant of 拿[na2]; to hold; to seize; to catch; to apprehend; to take; 
定	to fix; to set; to make definite; to subscribe to; to book; to order; to congeal; to coagulate; definitely
宪	statute; constitution
凸	to stick out; protruding; convex; male; Taiwan pr. [tu2]; convex on both sides; biconvex
颂	ode; eulogy; to praise in writing; to wish
侥	by mere luck; used in 僬僥|僬侥[Jiao1 Yao2]
悲	sad; sadness; sorrow; grief
搞	to do; to make; to go in for; to set up; to get hold of; to take care of
诶	hey; hey; hey; hey; sigh
洋	ocean; vast; foreign; silver dollar or coin; vast; impressive; self-satisfied; immensely pleased with oneself
来	to come; ; hither; ever since; for the past; the coming ...; the next ...; in order to; approximately; 
赏	to bestow; to give; to hand down; a reward; to appreciate
床	bed; couch; classifier for beds
猫	cat; to hide oneself; modem
叕	to join together; to lack; narrow and shallow
坦	flat; open-hearted; level; smooth
帜	flag
嘛	used in 唵嘛呢叭咪吽[an3 ma2 ni2 ba1 mi1 hong1]; what?; modal particle indicating that sth is obvious; particle indicating a pause for emphasis
闯	to rush; to charge; to dash; to break through; to temper oneself
音	sound; noise; note; tone; news; syllable; reading
主	owner; master; host; individual or party concerned; God; Lord; main; to indicate or signify; trump card
匆	hurried; hasty; hurriedly; variant of 匆[cong1]
滚	to boil; to roll; to take a hike; Get lost!; nickname for a panda; to surge on; to roll on
严	surname Yan; tight; stern; strict; rigorous; severe; father
野	erroneous variant of 野[ye3]; field; plain; open space; limit; boundary; rude; feral
东	surname Dong; east; host; landlord; thing; item; stuff
某	some; a certain; sb or sth indefinite; such-and-such; so-and-so; such-and-such
叭	denote a sound or sharp noise
零	zero; nought; zero sign; fractional; fragmentary; odd; ; fraction; remainder; extra; to wither and fall; to wither
沮	to destroy; to stop
肴	meat dishes; mixed viands
施	surname Shi; to put into effect; to distribute; to apply
攻	to attack; to accuse; to study
厂	"cliff" radical in Chinese characters, occurring in 原, 历, 压 etc; factory; yard; depot; workhouse; works; plant
缩	to withdraw; to pull back; to contract; to shrink; to reduce; abbreviation; also pr. [su4]
帝	emperor
遮	to cover up; to screen off; to hide; to conceal
屎	feces; excrement; a stool; secretion
既	already; since; both...
寂	silent; solitary; Taiwan pr. [ji2]; quiet
务	affair; business; matter; to be engaged in; to attend to; by all means
冻	to freeze; to feel very cold; aspic or jelly
鬼	disembodied spirit; ghost; devil; person with a certain vice or addiction etc; one of the 28 constellations of ancient Chinese astronomy
弯	to bend; bent; a bend; a turn; Wan Wan, Taiwanese blogger and cartoonist
罚	to punish; to penalize; to fine
碌	used in 碌碡[liu4 zhou5]; Taiwan pr. [lu4]; 
泼	to splash; to spill; rough and coarse; brutish
鸡	fowl; chicken; prostitute; penis
碎	to break into pieces; to shatter; to crumble; broken; fragmentary; scattered; garrulous
量	to measure; capacity; quantity; amount; to estimate; abbr. for 量詞|量词[liang4 ci2], classifier; measure word
先	beforehand; first; earlier; at first; originally; for the time being; for now; my late
驻	to halt; to stay; to be stationed
行	row; line; commercial firm; line of business; profession; to rankamong one's siblings; row; column; to walk; to go; to travel; a visit; temporary; makeshift; current; in circulation; to do; to perform; capable; competent; effective; all right; OK!; will do; behavior; conduct; Taiwan pr. [xing4] for the behavior-conduct sense
盒	small box; case
杨	surname Yang; poplar
柴	surname Chai; firewood; lean; thin
阱	pitfall; trap
崭	variant of 嶄|崭[zhan3]; towering; prominent; very; extremely; marvelous; excellent
育	to have children; to raise or bring up; to educate
辖	linchpin; to govern; to have jurisdiction over
论	abbr. for 論語|论语[Lun2 yu3], The Analects; opinion; view; theory; doctrine; to discuss; to talk about; to regard; to consider; per; by the
修	surname Xiu; to decorate; to embellish; to repair; to build; to write; to cultivate; to study; to take
猎	hunting
慎	careful; cautious
阔	rich; wide; broad
垂	to hang; droop; dangle; bend down; hand down; bequeath; nearly; almost; to approach; gradually; to drop
殴	surname Ou; to beat up; to hit sb
藐	to despise; small; contemptuous; high and distant; mysterious; grand; magnificent
弹	crossball; bullet; shot; shell; ball; to pluck; to play; to spring or leap; to shoot; to fluff or tease; to flick; to flip; to accuse; to impeach; elastic
磅	scale; to weigh; pound; point; used in 磅礴[pang2 bo2]; Taiwan pr. [pang1]
艺	skill; art
或	maybe; perhaps; might; possibly; or
拔	to pull up; to pull out; to draw out by suction; to select; to pick; to stand out; to surpass; to seize
吝	stingy
碧	green jade; bluish green; blue; jade
养	to raise; to bring up; to keep; to support; to give birth
慨	to sigh; indignant; generous; to sigh
忆	to recollect; to remember; memory
维	abbr. for Uighur 維吾爾|维吾尔[Wei2 wu2 er3]; surname Wei; to preserve; to maintain; to hold together; dimension; vitamin
另	other; another; separate; separately
兰	surname Lan; abbr. for Lanzhou 蘭州|兰州[Lan2 zhou1], Gansu; orchid; fragrant thoroughwort; lily magnolia
谨	cautious; careful; solemnly; sincerely
此	this; these
同	like; same; similar; together; alike; with; see 衚衕|胡同[hu2 tong4]
怯	timid; cowardly; rustic; Taiwan pr. [que4]
蛇	snake; serpent
痴	imbecile; sentimental; stupid; foolish; silly; foolish; stupid; lost in thought; in a daze
缓	slow; unhurried; sluggish; gradual; not tense; relaxed; to postpone; to defer; to stall; to stave off; to revive; to recuperate; slowly; unhurriedly; little by little
鹿	deer
仪	apparatus; rites; appearance; present; ceremony
森	Mori; densely wooded; multitudinous; gloomy; forbidding; dense; thick; ghastly; eerie
向	surname Xiang; towards; to face; to turn towards; direction; to support; to side with; shortly before; formerly; always; all along; suitable for ...; oriented to ...; to tend toward; to guide; variant of 向[xiang4]; direction; orientation; to face; to turn toward; to; towards; shortly before; formerly
盐	salt
给	to; for; for the benefit of; to give; to allow; to do sth; ; ; ; to supply; to provide
择	to select; to choose; to pick over; to pick out; to differentiate; to eliminate; also pr. [zhai2]
龙	surname Long; dragon; imperial
撩	to lift up; to raise; to pull up; to sprinkle; to tease; to provoke; to stir up
石	surname Shi; abbr. for Shijiazhuang 石家莊|石家庄[Shi2 jia1 zhuang1]; dry measure for grain equal to ten dou 斗[dou3]; one hundred liters; ancient pr. [shi2]; rock; stone; stone inscription; one of the eight categories of ancient musical instruments 八音[ba1 yin1]
喇	sound of wind, rain etc; 
嘴	mouth; beak; nozzle; spout
缘	cause; reason; karma; fate; predestined affinity; margin; hem; edge; along
惋	to sigh in regret or pity; Taiwan pr. [wan4]
堕	to fall; to sink; to degenerate
烤	to roast; to bake; to broil
俯	to look down; to stoop
面	face; side; surface; aspect; top; classifier for objects with flat surfaces such as drums, mirrors, flags etc; multiple viewpoints; flour; noodles; soft; ineffectual; spineless
腹	abdomen; stomach; belly
孕	pregnant
蒂	stem
事	matter; thing; item; work; affair; everything
慌	to get panicky; to lose one's head; unbearably; terribly
怕	surname Pa; to be afraid; to fear; to dread; to be unable to endure; perhaps
溃	used in 潰膿|溃脓[hui4 nong2]; Taiwan pr. [kui4]; to break through a dam or dike; to break through; to be routed; to be overrun; to fall to pieces; to fester; to ulcerate
颇	surname Po; Taiwan pr. [Po3]; rather; quite; considerably; oblique; inclined; slanting; Taiwan pr. [po3]
太	highest; greatest; too; very; extremely; married woman; Mrs.; Madam; wife
喝	to drink; to shout
谐	harmonious; humorous; to reach agreement
粹	pure; unmixed; essence
创	variant of 創|创[chuang4]; a wound; to wound; to initiate; to create; to achieve
常	surname Chang; always; ever; often; frequently; common; general; constant; frequently; often
旅	trip; travel; to travel; brigade
印	surname Yin; abbr. for 印度[Yin4 du4]; to print; to mark; to engrave; a seal; a print; a stamp; a mark; a trace; image
秩	order; orderliness; ten years
巩	secure; solid
敷	to spread; to lay out; to apply; sufficient; enough
态	; appearance; shape; form; state; attitude; voice
夫	husband; man; manual worker; conscripted laborer; this, that; he, she, they; ; 
兢	to be fearful; apprehensive
挪	to shift; to move
垄	ridge between fields; crop row; mounded soil forming a ridge in a field; grave mound
斑	spot; colored patch; stripe; spotted; striped; variegated; full of stains or spots
醒	to wake up; to be awake; to become aware; to sober up; to come to
隆	surname Long; short for 吉隆坡[Ji2 long2 po1], Kuala Lumpur; sound of drums; grand; intense; prosperous; to swell; to bulge; rumble
歧	divergent; side road
操	to grasp; to hold; to operate; to manage; to control; to steer; to exercise; to drill; to play; to speak
奋	to exert oneself
坝	dam; dike; embankment
丰	luxuriant; buxom; variant of 風|风[feng1]; appearance; charm; surname Feng; abundant; plentiful; fertile; plump; great
追	to sculpt; to carve; musical instrument; to chase; to pursue; to look into; to investigate; to reminisce; to recall; to court; to binge-watch; retroactively; posthumously
右	right; right-hand side; right of center; west; the right side as the side of precedence
澡	bath
棉	generic term for cotton or kapok; cotton; padded or quilted with cotton
吃	to eat; to consume; to eat at; to eradicate; to destroy; to absorb; to suffer; sound of muffled laughter; sound of stammering
纽	to turn; to wrench; button; nu
蠛	minute flies
反	contrary; in reverse; inside out or upside down; to reverse; to return; to oppose; opposite; against; anti-; to rebel; to use analogy; instead; abbr. for 反切[fan3 qie4] phonetic system
聚	to assemble; to gather; poly-
洗	to wash; to bathe; to develop; to shuffle; to erase
足	excessive; foot; leg; sufficient; ample; as much as; fully; fully; no less than; as much as; extremely
溉	to irrigate
觉	a nap; a sleep; to feel; to find that; thinking; awake; aware
畴	arable fields; cultivated field; class; category
召	surname Shao; name of an ancient state that existed in what is now Shaanxi Province; to call together; to summon; to convene; temple or monastery
特	special; unique; distinguished; especially; unusual; very; abbr. for 特克斯[te4 ke4 si1], tex
柚	pomelo; shaddock; oriental grapefruit
凄	intense cold; frigid; dismal; grim; bleak; sad; mournful; also written 淒|凄[qi1]; sad; mournful; intense cold; frigid; dismal; grim; bleak; sad; mournful; cold and dismal
钩	to hook; to sew; to crochet; hook; check mark or tick; window catch
昆	used in place names, notably Kunlun Mountains 崑崙|昆仑[Kun1 lun2]; ; descendant; elder brother; a style of Chinese poetry
衬	against the skin; to line; lining; to contrast with; to assist financially
爱	to love; to be fond of; to like; affection; to be inclined; to tend to; to make love
饼	round flat cake; cookie; cake; pastry
喘	to gasp; to pant; asthma
标	mark; sign; label; to mark with a symbol, label, lettering etc; to bear; prize; award; bid; target; quota; the topmost branches of a tree; visible symptom; classifier for military units
底	; background; bottom; base; end; remnants; radix; base
暄	genial and warm
几	small table; almost; how much; how many; several; a few
芝	Zoysia pungens
纠	to gather together; to investigate; to entangle; to correct
晓	dawn; daybreak; to know; to let sb know; to make explicit
昌	surname Chang; prosperous; flourishing
早	early; morning; Good morning!; long ago; prematurely
抓	to grab; to catch; to arrest; to snatch; to scratch
鲈	common perch; bass
哮	pant; roar; bark; Taiwan pr. [xiao1]
肃	surname Su; respectful; solemn; to eliminate; to clean up
师	surname Shi; teacher; master; expert; model; army division; troops; to dispatch troops
宾	visitor; guest; object
蒙	drizzle; mist; to deceive; to cheat; to hoodwink; to make a wild guess; blind; dim-sighted; surname Meng; Mongol ethnic group; abbr. for Mongolia 蒙古國|蒙古国[Meng3 gu3 guo2]; Taiwan pr. [Meng2]; unconscious; dazed; stunned; to cover; ignorant; to suffer; to receive; to cheat; drizzle
拍	to pat; to clap; to slap; to swat; to take; to shoot; racket; beat
磕	to tap; to knock; to knock; knocking
闲	enclosure; unoccupied; leisure; idle; unoccupied; leisure
浸	to immerse; to soak; to steep; gradually
茎	stalk; stem
钙	calcium
魂	soul; spirit; immortal soul
忌	to be jealous of; fear; dread; scruple; to avoid or abstain from; to quit; to give up sth
卓	surname Zhuo; outstanding
流	to flow; to disseminate; to circulate or spread; to move or drift; to degenerate; to banish or send into exile; stream of water or sth resembling one; class, rate or grade
去	to go; to go to; last; just passed; to send; to remove; to get rid of; to reduce; to be apart from in space or time; to die; to play; to go in order to do sth; ; 
嘉	surname Jia; excellent; auspicious; to praise; to commend
玩	to play; to have fun; to trifle with; toy; sth used for amusement; curio or antique; to keep sth for entertainment; Taiwan pr. [wan4]
风	wind; news; style; custom; manner
僵	rigid; deadlock; stiff
撼	to shake; to vibrate
威	power; might; prestige
废	to abolish; to abandon; to abrogate; to discard; to depose; to oust; crippled; abandoned; waste; disabled
腕	wrist; arm
励	surname Li; to encourage; to urge
卷	to roll up; roll; classifier for small rolled things; scroll; book; volume; chapter; examination paper; classifier for books, paintings: volume, scroll; to roll up; to sweep up; to carry along; a roll; classifier for rolls, spools etc
栗	cold; chilly; to tremble with fear; surname Li; chestnut
耿	surname Geng; bright; brilliant; honest; upright; bright; devoted; having sth on one's mind; troubled
每	each; every; often
皆	all; each and every; in all cases
挑	to carry on a shoulder pole; to choose; to pick; to nitpick; to raise; to dig up; to poke; to prick; to incite; to stir up
狠	ruthless; fierce; ferocious; determined; resolute; to harden; resolutely; firmly; ferociously; ruthlessly
淆	confused and disorderly; mixed; Taiwan pr. [yao2]
愈	the more...; to recover; to heal; better; to heal
认	to recognize; to know; to admit
坟	grave; tomb; embankment; mound; ancient book
指	finger; to point at or to; to indicate or refer to; to depend on; to count on; to stand on end
川	abbr. for Sichuan Province 四川[Si4 chuan1] in southwest China; river; creek; plain; an area of level country
艰	difficult; hard; hardship
抒	to express; to give expression to; to relieve
仁	humane; kernel
丧	mourning; funeral; corpse; to lose sth abstract but important; to be bereaved of; to die; disappointed; discouraged
呆	foolish; stupid; expressionless; blank; to stay
傻	foolish
拢	to gather together; to collect; to approach; to draw near to; to add; to sum up; to comb
租	to hire; to rent; to charter; to rent out; to lease out; rent; land tax
住	to live; to dwell; to stay; to reside; to stop; 
神	God; god; deity; supernatural; magical; mysterious; spirit; mind; energy; lively; expressive; look; expression; awesome; amazing
百	surname Bai; hundred; numerous; all kinds of
脱	to shed; to take off; to escape; to get away from; Toktoghan, Mongol politician during the Yuan dynasty, prime minister until 1345, compiled three dynastic histories of Song 宋史, Liao 遼史|辽史 and Jin 金史; also written Tuoketuo 托克托
抑	to restrain; to restrict; to keep down; or
虹	rainbow
框	frame; casing; fig. framework; template; to circle; to frame; to restrict; Taiwan pr. [kuang1]; a frame; a circle; set pattern; convention; restriction
然	correct; right; so; thus; like this; -ly
唆	to suck; to incite
撕	to tear
儒	scholar; Confucian
否	to negate; to deny; not; clogged; evil
抹	to wipe; to smear; to wipe; to erase; classifier for wisps of cloud, light-beams etc; to plaster; to go around; to skirt
漏	to leak; to divulge; to leave out by mistake; waterclock or hourglass
熨	reconciled; smooth; an iron; to iron
嫩	young and tender; tender; lightly cooked; light; inexperienced; unskilled
悉	in all cases; know
棵	classifier for trees, cabbages, plants etc
诺	to consent; to promise; yes!
番	surname Pan; foreign; barbarian; classifier for processes or actions that take time and effort; a kind; a sort; ; time and time again
洽	accord; to make contact; to agree; to consult with; extensive
暗	dark; to turn dark; secret; hidden; confused; ignorant; secretly; inwardly; to close; to eclipse; dark
坠	to fall; to drop; to weigh down
枪	surname Qiang; gun; firearm; rifle; spear; thing with shape or function similar to a gun; to substitute for another person in a test; to knock; classifier for rifle shots; rifle; spear
味	taste; smell; feel; quality; sense; classifier for ingredients of a medicine prescription
型	mold; type; style; model
炮	to sauté; to fry; to dry by heating; to prepare herbal medicine by roasting or parching; cannon; firecracker
样	manner; pattern; way; appearance; shape; classifier: kind, type; all kinds
制	system; to control; to regulate; to manufacture; to make
贫	poor; inadequate; deficient; garrulous
盟	oath; pledge; union; to ally; league, a subdivision corresponding to prefecture in Inner Mongolia
频	frequency; frequently; repetitious; repeatedly; again and again; continuously; constantly
掰	to break off or break open sth with one's hands; to break off; bye-bye
谓	surname Wei; to speak; to say; to name; to designate; meaning; sense
牺	sacrifice
乎	in; at; from; because; than; 
恢	to restore; to recover; great; vast; extensive
兆	surname Zhao; omen; to foretell; million; mega-; trillion; tera-; billion
盾	shield; Vietnamese dong; currency unit of several countries
虾	used in 蝦蟆|虾蟆[ha2 ma5]; shrimp; prawn
禁	to endure; to prohibit; to forbid
凑	to gather together, pool or collect; to happen by chance; to move close to; to exploit an opportunity
脚	foot; leg; base; classifier for kicks
日	abbr. for 日本[Ri4 ben3], Japan; sun; day; date, day of the month; every day
胜	victory; success; to beat; to defeat; to surpass; victorious; superior to; to get the better of; better than; surpassing; superb; beautiful; wonderful; able to bear; equal to
慷	used in 慷慨|慷慨[kang1 kai3]
很	; quite; very; awfully
椅	chair
驱	old variant of 驅|驱[qu1]; to expel; to urge on; to drive; to run quickly
撞	to knock against; to bump into; to run into; to meet by accident
彻	thorough; penetrating; to pervade; to pass through
瓣	petal; segment; clove; piece; section; fragment; valve; lamella; classifier for pieces, segments etc
良	good; very; very much
冷	surname Leng; cold; coldly
贷	to lend on interest; to borrow; a loan; leniency; to make excuses; to pardon; to forgive
见	to see; to meet; to appear; to interview; opinion; view; to appear; also written 現|现[xian4]
考	to beat; to hit; to inspect; to test; to take an exam; to check; to verify; to test; to examine; to take an exam; to take an entrance exam for; deceased father
蜜	honey
哲	wise; a sage
玻	glass
虽	although; even though
版	a register; block of printing; edition; version; page
嗽	to cough
拜	to pay respect; worship; visit; salute; bye-bye; also pr. [bai1 bai1] etc; to part ways; to have nothing further to do; to pay one's respects by bowing with hands in front of one's chest clasping joss sticks, or with palms pressed together; religious ceremony in which offerings are made to a deity
巴	Ba state during Zhou dynasty; abbr. for east Sichuan or Chongqing; surname Ba; abbr. for Palestine or Palestinian; abbr. for Pakistan; to long for; to wish; to cling to; to stick to; sth that sticks; close to; next to; spread open; informal abbr. for bus 巴士[ba1 shi4]; bar; nominalizing suffix on certain nouns, such as 尾巴[wei3 ba5], tail; very; extremely
耗	to waste; to spend; to consume; to squander; news; to delay; to dilly-dally
拥	to hold in one's arms; to embrace; to surround; to gather around; to throng; to swarm; to support; to have; to possess; Taiwan pr. [yong3]
趋	to hasten; to hurry; to walk fast; to approach; to tend towards; to converge
渠	surname Qu; how can it be that?; big; stream or canal; drain; ditch; him; outer rim of a carriage wheel
厨	kitchen
一	one; single; a; as soon as; entire; whole; all; throughout; "one" radical in Chinese characters; also pr. [yao1] for greater clarity when spelling out numbers digit by digit; one by one; one after another
眯	to blind; Taiwan pr. [mi3]; to narrow one's eyes; to squint; to take a nap
笼	enclosing frame made of bamboo, wire etc; cage; basket; steamer basket; to envelop; to cover; large box; Taiwan pr. [long2]
耻	shame; humiliation; disgrace
敢	to dare; daring; may I venture
隐	secret; hidden; concealed; crypto-; to lean upon; faint; indistinct
秃	bald; barren; bare; denuded; blunt; unsatisfactory; lacking something
斟	to pour; to deliberate
绳	rope
肤	skin
板	board; plank; plate; shutter; table tennis bat; clappers; accented beat in Chinese music; hard; stiff; to stop smiling or look serious; solemn; see 老闆|老板, boss; to catch sight of in a doorway
配	to join; to fit; to mate; to mix; to match; to deserve; to make up; to allocate
绩	to spin; merit; accomplishment; Taiwan pr. [ji1]
蒸	to evaporate; to steam; torch made from hemp stalks or bamboo; finely chopped firewood
陪	to accompany; to keep sb company; to assist
舅	maternal uncle; mother's brother; maternal uncle
词	word; statement; speech; lyrics; a form of lyric poetry, flourishing in the Song dynasty 宋朝|宋朝[Song4 chao2]
氛	miasma; vapor
抢	to knock against; opposite in direction; contrary; to fight over; to rush; to scramble; to grab; to rob; to snatch
馋	gluttonous; greedy; to have a craving
症	disease; illness; abdominal tumor; bowel obstruction; sticking point
鞠	surname Ju; to incline; to bow; leather ball used in ancient times; to bring up; to rear; Taiwan pr. [ju2]
泰	Mt Tai 泰山[Tai4 Shan1] in Shandong; abbr. for Thailand; safe; peaceful; most; grand
违	to disobey; to violate; to separate; to go against
奢	extravagant
水	surname Shui; water; river; liquid; beverage; additional charges or income; classifier for number of washes
街	street
纯	pure; simple; unmixed; genuine
峭	high and steep; precipitous; severe or stern
遣	to dispatch; to send; to drive away; to dispel
贯	to pierce through; to pass through; to be stringed together; string of 1000 cash
朗	clear; bright
攀	to climb; to implicate; to claim connections of higher status
朽	rotten
没	have not; not; drowned; to end; to die; to inundate
憾	regret
粗	wide; thick; coarse; gruff; rough; crude; careless; rude; remote; distant
乏	short of; tired
机	surname Ji; machine; mechanism; aircraft; an opportunity; crucial point; pivot; quick-witted; flexible; organic
层	to pile on top of one another; layer; stratum; floor; story; sheaf; classifier for layers; layer upon layer
生	to be born; to give birth; life; to grow; raw; uncooked; student
长	length; long; forever; always; constantly; chief; head; elder; to grow; to develop; to increase; to enhance
刮	to scrape; to blow; to shave; to plunder; to extort; to blow
更	to change or replace; to experience; one of the five two-hour periods into which the night was formerly divided; watch; more; even more; further; still; still more
她	she
决	to decide; to determine; to execute; to breach or burst; definitely; certainly
绦	see 絛綸|绦纶[di2 lun2]; braid; cord; sash
湿	moist; wet
妞	girl; little girl
询	to ask about; to inquire about
傅	surname Fu; instructor; to instruct; to attach; to apply
盗	to steal; to rob; to plunder; thief; bandit; robber
铁	surname Tie; iron; arms; weapons; hard; strong; violent; unshakeable; determined; close; tight
划	to row; to paddle; profitable; worth; it pays; to cut; to slash; to scratch; to strike; to delimit; to transfer; to assign; to plan; to draw; stroke of a Chinese character
柏	surname Bai; Taiwan pr. [Bo2]; cedar; cypress; Taiwan pr. [bo2]; ; variant of 柏[bai3]
象	elephant; shape; form; appearance; to imitate
凶	terrible; fearful; vicious; fierce; ominous; inauspicious; famine
晕	confused; dizzy; giddy; to faint; to swoon; to lose consciousness; to pass out; dizzy; halo; ring around moon or sun
光	light; ray; bright; shiny; only; merely; used up; finished; to leaveuncovered; bright; shiny; smooth; naked; bald; penniless
岸	bank; shore; beach; coast
自	self; oneself; from; since; naturally; as a matter of course
气	gas; air; smell; weather; to make angry; to annoy; to get angry; vital energy; qi
畜	livestock; domesticated animal; domestic animal; to raise
其	his; her; its; their; that; such; it
幸	trusted; intimate; to visit; surname Xing; fortunate; lucky
冒	surname Mao; to emit; to give off; to send out; to brave; to face; reckless; to falsely adopt; to feign; to cover
未	not yet; did not; have not; not; 8th earthly branch: 1-3 p.m., 6th solar month, year of the Sheep; ancient Chinese compass point: 210°
府	seat of government; government repository; official residence; mansion; presidential palace; Your home; prefecture
贼	thief; traitor; wily; deceitful; evil; extremely
恐	afraid; frightened; to fear
华	abbr. for China; Mt Hua 華山|华山 in Shaanxi; surname Hua; flower; magnificent; splendid; flowery
挺	straight; erect; to stick out; tostraighten up; to support; to withstand; outstanding; quite; very; classifier for machine guns
贱	inexpensive; lowly; despicable; my
螂	dragonfly; mantis
桶	bucket; can; barrel
歇	to rest; to take a break; to stop; to halt; to sleep; a moment; a short while
缝	to sew; to stitch; seam; crack; narrow slit
缔	closely joined; connection; knot
称	to fit; balanced; suitable; to weigh; to state; to name; name; appellation; to praise; steelyard
厅	hall; living room; office; provincial government department
唉	interjection or grunt of agreement or recognition; to sigh; alas; oh dear; sighing voice; crying sound
族	race; nationality; ethnicity; clan; by extension, social group
选	to choose; to pick; to select; to elect
软	soft; flexible
亏	deficiency; deficit; luckily; it's lucky that...; fancy that...
莎	katydid; phonetic "sha" used in transliteration; used in 莎草[suo1cao3]
愧	ashamed
嚼	to chew; also pr. [jue2]; used in 倒嚼[dao3 jiao4]
轻	light; easy; gentle; soft; reckless; unimportant; frivolous; small in number; unstressed; neutral; to disparage; lightly; softly
密	surname Mi; name of an ancient state; secret; confidential; close; thick; dense; thick; dense; close
艳	colorful; splendid; gaudy; amorous; romantic; to envy; variant of 艷|艳[yan4]
陵	mound; tomb; hill; mountain
侠	knight-errant; brave and chivalrous; hero; heroic
赶	to overtake; to catch up with; to hurry; to rush; to try to catch; to driveforward; to driveaway; to avail oneself of; until; by
攘	to push up one's sleeves; to reject; to resist; to seize; to steal; to perturb; Taiwan pr. [rang2]; disorderly; confused; chaotic
骏	spirited horse
聘	to engage; to hire; to betroth; betrothal gift; to get married
棒	stick; club; cudgel; smart; capable; strong; wonderful; classifier for legs of a relay race
县	county
喵	meow; cat's mewing
脑	brain; mind; head; essence
详	detailed; comprehensive
罕	rare
曾	surname Zeng; once; already; ever; former; previously; ; great-
梅	surname Mei; plum; plum flower; Japanese apricot; old variant of 梅[mei2]
隶	a person in servitude; low-ranking subordinate; to be subordinate to; clerical script
蛙	frog
束	surname Shu; to bind; bunch; bundle; classifier for bunches, bundles, beams of light etc; to control
雨	rain; to rain; to fall; to precipitate; to wet
漂	to float; to drift; to bleach; elegant; polished
戴	surname Dai; to put on or wear; to respect; to bear; to support
露	surname Lu; to show; to reveal; to betray; to expose; dew; syrup; nectar; outdoors; to show; to reveal; to betray; to expose
全	surname Quan; all; whole; entire; every; complete
粤	Cantonese; short name for Guangdong 廣東|广东[Guang3 dong1]
锈	to rust
堵	to block up; to stop up; choked up with anxiety or stress; wall; 
裳	lower garment; skirts; petticoats; garments; used in 衣裳[yi1 shang5]
桔	Platycodon grandiflorus; water bucket
桌	table; desk; classifier for tables of guests at a banquet etc
烦	to feel vexed; to bother; to trouble; superfluous and confusing; edgy
粥	used in 葷粥|荤粥[Xun1 yu4]; congee; gruel; porridge
馅	stuffing; forcemeat; filling
嫁	to marry; to marry off a daughter; to shift
房	surname Fang; house; room; branch of an extended family; classifier for family members
沉	to submerge; to immerse; to sink; to keep down; to lower; to drop; deep; profound; heavy; deeply; heavily
毅	firm and resolute; staunch
颜	surname Yan; color; face; countenance
旷	to neglect; to skip; to waste; vast; loose-fitting
咚	boom; knock; Dongdong, cheerleading mascot of 2008 Beijing Olympics; thud; thumping; thudding; pounding
永	forever; always; perpetual
溜	to slip away; to escape in stealth; to skate; used in 冰溜[bing1 liu4]
剧	theatrical work; dramatic; acute; severe
悟	to comprehend; to apprehend; to become aware
鑄	no definition found
胡	surname Hu; non-Han people, esp. from central Asia; reckless; outrageous; what?; why?; to complete a winning hand at mahjong; see 衚衕|胡同[hu2 tong4]; beard; mustache; whiskers
蜻	see 蜻蜓[qing1 ting2]
诚	sincere; authentic; really; truly
忽	surname Hu; to neglect; to overlook; to ignore; suddenly; fleeting; in a flash; distracted manner; vacantly; frustratedly
尚	surname Shang; still; yet; to value; to esteem
义	surname Yi; abbr. for 義大利|义大利[Yi4 da4 li4], Italy; justice; righteousness; meaning; foster; adopted; artificial; relationship; friendship
巡	to patrol; to make one's rounds; classifier for rounds of drinks
莫	surname Mo; do not; there is none who
物	thing; the outside world as distinct from oneself; people other than oneself
庸	ordinary; to use
瓷	chinaware; porcelain; china
剔	to scrape the meat from bones; to pick; to weed out
辉	splendor; to shine upon
旦	dawn; daybreak; dan, female role in Chinese opera
旺	prosperous; flourishing; blooming; roaring
扑	to throw oneself at; to pounce on; to devote one's energies; to flap; to flutter; to dab; to pat; to bend over
胞	placenta; womb; born of the same parents
炊	to cook food
猪	hog; pig; swine
诵	to read aloud; to recite
涛	big wave; Taiwan pr. [tao2]
立	surname Li; to stand; to set up; to establish; to lay down; to draw up; at once; immediately
嘈	bustling; tumultuous; noisy
拖	to drag; to tow; to trail; to hang down; to mop; to delay; to drag on
二	two; 2; stupid
谎	lies; to lie
糊	muddled; paste; scorched; paste; cream; viscous; gooey; sticky; indistinct; thick congee; porridge; congee; to feed oneself
末	tip; end; final stage; latter part; inessential detail; powder; dust; opera role of old man
涌	; to bubble up; to rush forth
怪	bewildering; odd; strange; uncanny; devil; monster; to wonder at; to blame; quite; rather
绕	to wind; to coil; to rotate around; to spiral; to move around; to go round; to by-pass; to make a detour; to confuse; to perplex; twisting and turning; involved and tricky; to spiral; to move around; to go round; to by-pass; to make a detour
鸟	penis; bird; "bird" radical in Chinese characters; to pay attention to; damned; goddamn
蔬	vegetables
贡	surname Gong; to offer tribute; tribute; gifts
腥	fishy
兔	rabbit
教	surname Jiao; to teach; religion; teaching; to make; to cause; to tell
虚	emptiness; void; abstract theory or guiding principles; empty or unoccupied; diffident or timid; false; humble or modest; weak; virtual; in vain
宫	surname Gong; palace; temple; castration; first note in pentatonic scale
哀	Ai, sixth of legendary Flame Emperors 炎帝[Yan2 di4] descended from Shennong 神農|神农[Shen2 nong2] Farmer God, also known as Li 釐|厘[Li2]; sorrow; grief; pity; to grieve for; to pity; to lament; to condole
祷	prayer; pray; supplication
剪	surname Jian; scissors; shears; clippers; to cut with scissors; to trim; to wipe out or exterminate
完	to finish; to be over; whole; complete; entire
峡	gorge
总	general; overall; to sum up; in every case; always; invariably; anyway; after all; eventually; sooner or later; surely; abbr. for 總經理|总经理[zong3 jing1 li3] or 總編|总编[zong3 bian1] etc
摊	to spread out; vendor's stand
证	to admonish; certificate; proof; to prove; to demonstrate; to confirm
吓	to scare; to intimidate; to threaten; tut-tut; ; to frighten; to scare
简	simple; uncomplicated; letter; to choose; to select; bamboo strips used for writing
挥	to wave; to brandish; to command; to conduct; to scatter; to disperse
砍	to chop; to cut down; to throw sth at sb
粮	grain; food; provisions; agricultural tax paid in grain
谬	to deceive; to confuse; to cheat; absurd; erroneous
削	to peel with a knife; to pare; to cut; to pare; to reduce; to remove; Taiwan pr. [xue4]
淀	shallow lake; to form sediment; to precipitate
酷	ruthless; strong; cool; hip
裔	descendants; frontier
焦	surname Jiao; burnt; scorched; charred; worried; anxious; coke; joule
辣	hot; pungent; to sting; to burn
俘	to take prisoner; prisoner of war
残	to destroy; to spoil; to ruin; to injure; cruel; oppressive; savage; brutal; incomplete; disabled; to remain; to survive; remnant; surplus
侦	to scout; to spy; to detect
答	bound form having the same meaning as the free word 答[da2], used in 答應|答应[da1 ying5], 答理[da1 li5] etc; to answer; to reply; to respond
境	border; place; condition; boundary; circumstances; territory
臣	surname Chen; state official or subject in dynastic China; I, your servant; Kangxi radical 131
萌	to sprout; to bud; cute; adorable
储	surname Chu; Taiwan pr. [Chu2]; to store up; to keep in reserve; heir to the throne; Taiwan pr. [chu2]
跪	to kneel
整	whole; complete; entire;whole;exactly; in good order; tidy; neat; to put in order; to straighten; to repair; to mend; to renovate; to fix sb; to give sb a hard time; to mess with sb; to tinker with; to do sth to; whole; full
躲	to hide; to dodge; to avoid
仙	immortal
览	to look at; to view; to read
蓝	surname Lan; blue; indigo plant
辐	spoke of a wheel
淡	insipid; diluted; weak; mild; light in color; tasteless; indifferent; faint; dim; dull; insipid; unenthusiastic; indifferent
缚	to bind; to tie; Taiwan pr. [fu2]
壤	soil; earth; the earth
圆	circle; round; circular; spherical; full; unit of Chinese currency; tactful; to make consistent and whole
理	texture; grain; inner essence; intrinsic order; reason; logic; truth; science; natural science; to manage; to pay attention to; to run; to handle; to put in order; to tidy up
悼	to mourn; to lament
郁	surname Yu; strongly fragrant; surname Yu; lush; luxuriant; melancholy; depressed
锅	pot; pan; wok; cauldron; pot-shaped thing
与	and; to give; together with; to take part in
幢	banner; classifier for buildings; carriage curtain; flickering; dancing
办	to do; to manage; to handle; to go about; to run; to set up; to deal with
唱	to sing; to call loudly; to chant
舱	cabin; the hold of a ship or airplane
哇	Wow!; sound of a child's crying; sound of vomiting; replaces 啊[a5] when following the vowel "u" or "ao"; sound of crying
讽	to satirize; to mock; to recite; Taiwan pr. [feng4]
曹	surname Cao; Zhou Dynasty vassal state; class or grade; generation; plaintiff and defendant; government department
锐	acute
燃	to burn; to ignite; to light; fig. to spark off; to start; to raise
多	many; much; too many; in excess; ... odd; how; multi-; poly-; many; much; a lot; lots and lots; more; even more
容	surname Rong; to hold; to contain; to allow; to tolerate; appearance; look; countenance
