爱情	àiqíng	/romance; love (romantic)/CL:份[fen4]/
安排	ānpái	/to arrange/to plan/to set up/arrangements/plans/
安全	ānquán	/safe; secure/safety; security/
按时	ànshí	/on time/before deadline/on schedule/
按照	ànzhào	/according to/in accordance with/in the light of/on the basis of/
百分之	bǎifēnzhī	/percent/
棒	bàng	/stick/club/cudgel/smart/capable/strong/wonderful/classifier for legs of a relay race/
包子	bāozi	/bao (steamed stuffed bun)/CL:個|个[ge4]/
保护	bǎohù	/to protect/to defend/to safeguard/protection/CL:種|种[zhong3]/
保证	bǎozhèng	/guarantee/to guarantee/to ensure/to safeguard/to pledge/CL:個|个[ge4]/
抱	bào	/to hold/to carry (in one's arms)/to hug/to embrace/to surround/to cherish/(coll.) (of clothes) to fit nicely/
抱歉	bàoqiàn	/to be sorry/to feel apologetic/sorry!/
报名	bàomíng	/to sign up/to enter one's name/to apply/to register/to enroll/to enlist/
倍	bèi	/(two, three etc) -fold/times (multiplier)/double/to increase or multiply/
本来	běnlái	/original/originally/at first/it goes without saying/of course/
笨	bèn	/stupid/foolish/silly/slow-witted/clumsy/
比如	bǐrú	/for example/for instance/such as/
毕业	bìyè	/graduation/to graduate/to finish school/
遍	biàn	/everywhere/all over/classifier for actions: one time/
标准	biāozhǔn	/standard; norm; criterion/(adjective) standard/good; correct; conforming to a standard/
表格	biǎogé	/form/table/CL:張|张[zhang1],份[fen4]/
表示	biǎoshì	/(of sb) to express; to state; to show/(of sth) to indicate; to signify; to show/expression; manifestation/
表演	biǎoyǎn	/play/show/performance/exhibition/to perform/to act/to demonstrate/CL:場|场[chang3]/
表扬	biǎoyáng	/to praise/to commend/
饼干	bǐnggān	/biscuit; cracker; cookie/CL:片[pian4],塊|块[kuai4]/
并且	bìngqiě	/and; besides; moreover; furthermore; in addition/
博士	bóshì	/doctor/court academician (in feudal China)/Ph.D./
不过	búguò	/only/merely/no more than/but/however/anyway (to get back to a previous topic)/cannot be more (after adjectival)/
不得不	bùdébù	/have no choice or option but to/cannot but/have to/can't help it/can't avoid/
不管	bùguǎn	/not to be concerned/regardless of/no matter/
不仅	bùjǐn	/not just; not limited to/(as a correlative conjunction) not only (..., but also ...)/
部分	bùfen	/part/share/section/piece/CL:個|个[ge4]/
擦	cā	/to rub; to scratch/to wipe; to polish/to apply (lipstick, lotion etc)/to brush (past)/to shred (a vegetable etc)/
猜	cāi	/to guess/
材料	cáiliào	/(raw) material/data/(fig.) person who has the potential to do the job/
参观	cānguān	/to look around/to tour/to visit/
餐厅	cāntīng	/dining hall/dining room/restaurant/CL:間|间[jian1],家[jia1]/
差不多	chàbuduō	/almost/nearly/more or less/about the same/good enough/not bad/
尝	cháng	/old variant of 嘗|尝[chang2]/
长城	chángchéng	/the Great Wall/
长江	chángjiāng	/Yangtze River, or Chang Jiang/
场	chǎng	/variant of 場|场[chang3]/
超过	chāoguò	/to surpass/to exceed/to outstrip/
厕所	cèsuǒ	/toilet; lavatory/CL:間|间[jian1],處|处[chu4]/
成功	chénggōng	/to succeed/success/successful; fruitful/
成为	chéngwéi	/to become; to turn into/
诚实	chéngshí	/honest/
乘坐	chéngzuò	/to ride (in a vehicle)/
吃惊	chījīng	/to be startled/to be shocked/to be amazed/
重新	chóngxīn	/again; once more; re-/
抽烟	chōuyān	/to smoke (a cigarette, tobacco)/
出差	chūchāi	/to go on an official or business trip/
出发	chūfā	/to set off/to start (on a journey)/
出生	chūshēng	/to be born/
出现	chūxiàn	/to appear/to arise/to emerge/to show up/
厨房	chúfáng	/kitchen/CL:間|间[jian1]/
传真	chuánzhēn	/fax/facsimile/
窗户	chuānghu	/window/CL:個|个[ge4],扇[shan4]/
词语	cíyǔ	/word (general term including monosyllables through to short phrases)/term (e.g. technical term)/expression/
从来	cónglái	/always/at all times/never (if used in negative sentence)/
粗心	cūxīn	/careless/thoughtless/
存	cún	/to exist/to deposit/to store/to keep/to survive/
错误	cuòwù	/mistaken; false; wrong/error; mistake/CL:個|个[ge4]/
答案	dá’àn	/answer/solution/CL:個|个[ge4]/
打招呼	dǎzhāohu	/to greet sb by word or action/to give prior notice/
打扮	dǎban	/to decorate/to dress/to make up/to adorn/manner of dressing/style of dress/
打扰	dǎrǎo	/to disturb/to bother/to trouble/
打印	dǎyìn	/to affix a seal/to stamp/to print out (with a printer)/
打折	dǎzhé	/to give a discount/
打针	dǎzhēn	/to give or have an injection/
大概	dàgài	/roughly/probably/rough/approximate/about/general idea/
大使馆	dàshǐguǎn	/embassy/CL:座[zuo4],個|个[ge4]/
大约	dàyuē	/approximately/probably/
戴	dài	/to put on or wear (glasses, hat, gloves etc)/to respect/to bear/to support/
大夫	dàifu	/doctor/physician/
当	dāng	/at or in the very same.../suitable/adequate/fitting/proper/to replace/to regard as/to think/to pawn/(coll.) to fail (a student)/
当时	dāngshí	/at once/right away/
刀	dāo	/knife/blade/single-edged sword/cutlass/CL:把[ba3]/(slang) dollar (loanword)/classifier for sets of one hundred sheets (of paper)/classifier for knife cuts or stabs/
导游	dǎoyóu	/tour guide/guidebook/to conduct a tour/
倒	dào	/to invert; to place upside down or frontside back/to pour out/to tip out; to dump/inverted; upside down; reversed/to go backward/contrary to what one might expect; but; yet/
到处	dàochù	/everywhere/
到底	dàodǐ	/finally/in the end/when all is said and done/after all/to the end/to the last/
道歉	dàoqiàn	/to apologize/
得意	déyì	/proud of oneself/pleased with oneself/complacent/
地点	dìdiǎn	/place/site/location/venue/CL:個|个[ge4]/
得（助动词）	děi	have to
登机牌	dēngjīpái	/boarding pass/
等 （动）	děng	wait (verb)
低	dī	/low/beneath/to lower (one's head)/to let droop/to hang down/to incline/
底	dǐ	/background/bottom/base/end (of the month, year etc)/remnants/(math.) radix/base/
地球	dìqiú	/the earth/CL:個|个[ge4]/
地址	dìzhǐ	/address/CL:個|个[ge4]/
掉	diào	/to fall/to drop/to lag behind/to lose/to go missing/to reduce/fall (in prices)/to lose (value, weight etc)/to wag/to swing/to turn/to change/to exchange/to swap/to show off/to shed (hair)/(used after certain verbs to express completion, fulfillment, removal etc)/
调查	diàochá	/investigation/inquiry/to investigate/to survey/survey/(opinion) poll/CL:項|项[xiang4],個|个[ge4]/
丢	diū	/to lose/to put aside/to throw/
动作	dòngzuò	/movement; motion; action (CL:個|个[ge4])/to act; to move/
堵车	dǔchē	/traffic jam/(of traffic) to get congested/
肚子	dùzi	/belly/abdomen/stomach/CL:個|个[ge4]/
短信	duǎnxìn	/text message/SMS/
对于	duìyú	/regarding; as far as (sth) is concerned; with regard to/
对话	duìhuà	/to talk (with sb)/dialogue; conversation/
对面	duìmiàn	/(sitting) opposite/across (the street)/directly in front/to be face to face/
而	ér	/and/as well as/and so/but (not)/yet (not)/(indicates causal relation)/(indicates change of state)/(indicates contrast)/
儿童	értóng	/child/CL:個|个[ge4]/
发生	fāshēng	/to happen; to occur; to take place; to break out/
发展	fāzhǎn	/development/growth/to develop/to grow/to expand/
法律	fǎlǜ	/law/CL:條|条[tiao2], 套[tao4], 個|个[ge4]/
翻译	fānyì	/to translate/to interpret/translator/interpreter/translation/interpretation/CL:個|个[ge4],位[wei4],名[ming2]/
烦恼	fánnǎo	/to be worried/to be distressed/worries/
反对	fǎnduì	/to oppose; to be against; to object to/
方法	fāngfǎ	/method; way; means/CL:個|个[ge4]/
方面	fāngmiàn	/respect/aspect/field/side/CL:個|个[ge4]/
方向	fāngxiàng	/direction; orientation/CL:個|个[ge4]/
房东	fángdōng	/landlord/
放弃	fàngqì	/to renounce; to abandon; to give up/
放暑假	fàngshǔjià	/to be on summer vacation/
放松	fàngsōng	/to relax; to slacken; to loosen/
份	fèn	/classifier for gifts, newspaper, magazine, papers, reports, contracts etc/variant of 分[fen4]/
丰富	fēngfù	/to enrich/rich/plentiful/abundant/
否则	fǒuzé	/otherwise; if not; or (else)/
符合	fúhé	/in keeping with/in accordance with/tallying with/in line with/to agree with/to accord with/to conform to/to correspond with/to manage/to handle/
富	fù	/rich/abundant/wealthy/
付款	fùkuǎn	/to pay a sum of money/payment/
父亲	fùqīn	/father/also pr. [fu4 qin5]/CL:個|个[ge4]/
复印	fùyìn	/to photocopy/to duplicate a document/
复杂	fùzá	/complicated; complex/
负责	fùzé	/to be responsible for; to be in charge of; to bear responsibility for/conscientious/
改变	gǎibiàn	/to change/to alter/to transform/
干杯	gānbēi	/to drink a toast/Cheers! (proposing a toast)/Here's to you!/Bottoms up!/lit. dry cup/
赶	gǎn	/to overtake; to catch up with/to hurry; to rush/to try to catch (the bus etc)/to drive (cattle etc) forward; to drive (sb) away/to avail oneself of (an opportunity)/until; by (a certain time)/
敢	gǎn	/to dare/daring/(polite) may I venture/
感动	gǎndòng	/to move (sb)/to touch (sb emotionally)/moving/
感觉	gǎnjué	/feeling; impression; sensation/to feel; to perceive/
感情	gǎnqíng	/emotion; sentiment/affection; feelings between two persons/CL:個|个[ge4],種|种[zhong3]/
感谢	gǎnxiè	/(express) thanks/gratitude/grateful/thankful/thanks/
干	gān	/tree trunk/main part of sth/to manage/to work/to do/capable/cadre/to kill (slang)/to fuck (vulgar)/(coll.) pissed off/annoyed/
刚	gāng	/hard/firm/strong/just/barely/exactly/
高速公路	gāosùgōnglù	/expressway; highway; freeway/
胳膊	gēbo	/arm/CL:隻|只[zhi1],條|条[tiao2],雙|双[shuang1]/
各	gè	/each/every/
公里	gōnglǐ	/kilometer/
工资	gōngzī	/wages; pay/CL:個|个[ge4],份[fen4]/
功夫	gōngfu	/skill/art/kung fu/labor/effort/
共同	gòngtóng	/common/joint/jointly/together/collaborative/
够	gòu	/enough (sufficient)/enough (too much)/(coll.) (before adj.) really/(coll.) to reach by stretching out/
购物	gòuwù	/shopping/
估计	gūjì	/to estimate; to assess; to calculate/(coll.) to reckon; to think (that ...)/
鼓励	gǔlì	/to encourage/
顾客	gùkè	/customer; client/CL:位[wei4]/
故意	gùyì	/deliberately; on purpose/
挂	guà	/to hang; to suspend (from a hook etc)/to hang up (the phone)/(of a line) to be dead/to be worried; to be concerned/(dialect) to make a phone call/to register (at a hospital); to make an appointment (with a doctor)/(slang) to kill; to die; to be finished; to fail (an exam)/classifier for sets or clusters of objects/
关键	guānjiàn	/crucial point/crux/CL:個|个[ge4]/key/crucial/pivotal/
观众	guānzhòng	/spectators; audience; visitors (to an exhibition etc)/
管理	guǎnlǐ	/to supervise/to manage/to administer/management/administration/CL:個|个[ge4]/
光	guāng	/light; ray (CL:道[dao4])/bright; shiny/only; merely/used up; finished/to leave (a part of the body) uncovered/
广播	guǎngbō	/broadcast/CL:個|个[ge4]/broadcasting/to broadcast/(formal) to propagate/to publicize/
广告	guǎnggào	/to advertise/a commercial/advertisement/CL:項|项[xiang4]/
逛	guàng	/to stroll/to visit/
规定	guīdìng	/to stipulate; to specify; to prescribe; to fix (a price); to set (a quota)/regulations; rules; provisions; stipulations/
国际	guójì	/international/
国籍	guójí	/nationality/
果汁	guǒzhī	/fruit juice/
过程	guòchéng	/course of events/process/CL:個|个[ge4]/
海洋	hǎiyáng	/ocean/CL:個|个[ge4]/
害羞	hàixiū	/shy/embarrassed/bashful/
寒假	hánjià	/winter vacation/
汗	hàn	/perspiration/sweat/CL:滴[di1],頭|头[tou2],身[shen1]/to be speechless (out of helplessness, embarrassment etc) (Internet slang used as an interjection)/
航班	hángbān	/(scheduled) flight; (scheduled) sailing/
好处	hǎochù	/benefit; advantage; merit/gain; profit/also pr. [hao3 chu4]/
好像	hǎoxiàng	/as if/to seem like/
号码	hàomǎ	/number/CL:堆[dui1],個|个[ge4]/
合格	hégé	/to meet the standard required/qualified/eligible (voter etc)/
合适	héshì	/suitable; fitting; appropriate/
盒子	hézi	/box/case/
厚	hòu	/thick/deep or profound/kind/generous/rich or strong in flavor/to favor/to stress/
后悔	hòuhuǐ	/to regret; to feel remorse/
护士	hùshi	/nurse/CL:個|个[ge4]/
互联网	hùliánwǎng	/Internet/
互相	hùxiāng	/each other/mutually/mutual/
怀疑	huáiyí	/to doubt (sth); to be skeptical of/to have one's doubts; to harbor suspicions; to suspect that/
回忆	huíyì	/to recall/memories/CL:個|个[ge4]/
活动	huódòng	/to exercise/to move about/to operate/to use connections (personal influence)/loose/shaky/active/movable/activity/campaign/maneuver/behavior/CL:項|项[xiang4],個|个[ge4]/
活泼	huópō	/lively/vivacious/brisk/active/(chemistry) reactive/
火	huǒ	/fire/urgent/ammunition/fiery or flaming/internal heat (Chinese medicine)/hot (popular)/classifier for military units (old)/Kangxi radical 86/
获得	huòdé	/to obtain; to receive; to get/
基础	jīchǔ	/base; foundation; basis/basic; fundamental/
激动	jīdòng	/to move emotionally/to stir up (emotions)/to excite/
积极	jījí	/active/energetic/vigorous/positive (outlook)/proactive/
积累	jīlěi	/to accumulate/accumulation/cumulative/cumulatively/
及时	jíshí	/timely; at the right time/promptly; without delay/
即使	jíshǐ	/even if; even though/
寄	jì	/to send/to mail/to entrust/to depend on/to attach oneself to/to live (in a house)/to lodge/foster (son etc)/
记者	jìzhě	/reporter; journalist/CL:個|个[ge4]/
计划	jìhuà	/plan/project/program/to plan/to map out/CL:個|个[ge4],項|项[xiang4]/
既然	jìrán	/since; as; this being the case/
技术	jìshù	/technology; technique; skill/CL:門|门[men2],種|种[zhong3],項|项[xiang4]/
继续	jìxù	/to continue; to proceed with; to go on with/
家具	jiājù	/furniture/CL:件[jian4],套[tao4]/
加班	jiābān	/to work overtime/
加油站	jiāyóuzhàn	/gas station/
假	jiǎ	/variant of 假[jia3]/to borrow/
价格	jiàgé	/price/CL:個|个[ge4]/
坚持	jiānchí	/to persevere with/to persist in/to insist on/
减肥	jiǎnféi	/to lose weight/
减少	jiǎnshǎo	/to lessen; to decrease; to reduce; to lower/
建议	jiànyì	/to propose; to suggest; to recommend/proposal; suggestion; recommendation/CL:個|个[ge4],點|点[dian3]/
将来	jiānglái	/in the future/future/the future/CL:個|个[ge4]/
奖金	jiǎngjīn	/premium/award money/bonus/
降低	jiàngdī	/to reduce; to lower; to bring down/
降落	jiàngluò	/to descend/to land/
交	jiāo	/to hand over; to deliver; to pay (money); to turn over/to make friends/(of lines) to intersect/variant of 跤[jiao1]/
交流	jiāoliú	/to exchange/exchange/communication/interaction/to have social contact (with sb)/
交通	jiāotōng	/to be connected/traffic/transportation/communications/liaison/
郊区	jiāoqū	/suburban district; outskirts; suburbs/
骄傲	jiāo’ào	/pride/arrogance/conceited/proud of sth/
饺子	jiǎozi	/dumpling/pot-sticker/CL:個|个[ge4],隻|只[zhi1]/
教授	jiàoshòu	/professor/to instruct/to lecture on/CL:個|个[ge4],位[wei4]/
教育	jiàoyù	/to educate/to teach/education/
接受	jiēshòu	/to accept (a suggestion, punishment, bribe etc); to acquiesce/
接着	jiēzhe	/to catch and hold on/to continue/to go on to do sth/to follow/to carry on/then/after that/subsequently/to proceed/to ensue/in turn/in one's turn/
结果	jiéguǒ	/outcome/result/conclusion/in the end/as a result/to kill/to dispatch/
节	jié	/joint; node/(bound form) section; segment/solar term (one of the 24 divisions of the year in the traditional Chinese calendar)/seasonal festival/(bound form) to economize; to save/(bound form) moral integrity; chastity/classifier for segments: lessons, train wagons, biblical verses etc/knot (nautical miles per hour)/
节约	jiéyuē	/to economize/to conserve (resources)/economy/frugal/
解释	jiěshì	/explanation/to explain/to interpret/to resolve/CL:個|个[ge4]/
尽管	jǐnguǎn	/despite/although/even though/in spite of/unhesitatingly/do not hesitate (to ask, complain etc)/(go ahead and do it) without hesitating/
紧张	jǐnzhāng	/nervous/keyed up/intense/tense/strained/in short supply/scarce/CL:陣|阵[zhen4]/
进行	jìnxíng	/to advance/to conduct/underway/in progress/to do/to carry out/to carry on/to execute/
禁止	jìnzhǐ	/to prohibit/to forbid/to ban/
精彩	jīngcǎi	/wonderful/marvelous/brilliant/
经济	jīngjì	/economy/economic/
经历	jīnglì	/experience/CL:個|个[ge4],次[ci4]/to experience/to go through/
经验	jīngyàn	/experience/to experience/
京剧	jīngjù	/Beijing opera/CL:場|场[chang3],齣|出[chu1]/
警察	jǐngchá	/police; police officer/
景色	jǐngsè	/scenery/scene/landscape/view/
竟然	jìngrán	/unexpectedly/to one's surprise/in spite of everything/in that crazy way/actually/to go as far as to/
竞争	jìngzhēng	/to compete/competition/
镜子	jìngzi	/mirror/CL:面[mian4],個|个[ge4]/
究竟	jiūjìng	/to go to the bottom of a matter/after all/when all is said and done/(in an interrogative sentence) finally/outcome/result/
举	jǔ	/to lift/to hold up/to cite/to enumerate/to act/to raise/to choose/to elect/act/move/deed/
举办	jǔbàn	/to conduct/to hold/
举行	jǔxíng	/to hold (a meeting, ceremony etc)/
拒绝	jùjué	/to refuse; to decline; to reject/
距离	jùlí	/distance/CL:個|个[ge4]/to be apart from/
聚会	jùhuì	/party/gathering/to meet/to get together/
开玩笑	kāiwánxiào	/to play a joke; to make fun of; to joke/
开心	kāixīn	/to feel happy/to rejoice/to have a great time/to make fun of sb/
看法	kànfǎ	/way of looking at a thing/view/opinion/CL:個|个[ge4]/
考虑	kǎolǜ	/to think over/to consider/consideration/
烤鸭	kǎoyā	/roast duck/
棵	kē	/classifier for trees, cabbages, plants etc/
科学	kēxué	/science/scientific knowledge/scientific/rational/CL:門|门[men2],個|个[ge4],種|种[zhong3]/
咳嗽	késou	/to cough/CL:陣|阵[zhen4]/
可怜	kělián	/pitiful/pathetic/to have pity on/
可是	kěshì	/but; however/(used for emphasis) indeed/
可惜	kěxī	/it is a pity/what a pity/unfortunately/
客厅	kètīng	/drawing room (room for arriving guests)/living room/CL:間|间[jian1]/
肯定	kěndìng	/to be certain; to be positive/assuredly; definitely/to give recognition; to affirm/affirmative (answer)/
空	kōng	/to empty/vacant/unoccupied/space/leisure/free time/
空气	kōngqì	/air/atmosphere/
恐怕	kǒngpà	/fear/to dread/I'm afraid that.../perhaps/maybe/
苦	kǔ	/bitter/hardship/pain/to suffer/to bring suffering to/painstakingly/
矿泉水	kuàngquánshuǐ	/mineral water/CL:瓶[ping2],杯[bei1]/
困	kùn	/sleepy/tired/
困难	kùnnan	/difficult/challenging/straitened circumstances/difficult situation/
拉	lā	/to pull/to play (a bowed instrument)/to drag/to draw/to chat/(coll.) to empty one's bowels/
垃圾桶	lājītǒng	/rubbish bin/trash can/garbage can/Taiwan pr. [le4 se4 tong3]/
辣	là	/hot (spicy)/pungent/(of chili pepper, raw onions etc) to sting/to burn/
来自	láizì	/to come from (a place)/From: (in email header)/
来不及	láibují	/there's not enough time (to do sth)/it's too late (to do sth)/
来得及	láidejí	/to have enough time; can do it in time; can still make it/
懒	lǎn	/lazy/
浪费	làngfèi	/to waste/to squander/
浪漫	làngmàn	/romantic/
老虎	lǎohǔ	/tiger/CL:隻|只[zhi1]/
冷静	lěngjìng	/calm; cool-headed; dispassionate/(of a place) deserted; quiet/
理发	lǐfà	/to get a haircut; to have one's hair done/to cut (sb's) hair; to give (sb) a haircut/
理解	lǐjiě	/to comprehend; to understand/
理想	lǐxiǎng	/an ideal/a dream/ideal/perfect/
礼貌	lǐmào	/courtesy; politeness; manners/courteous; polite/
礼拜天	lǐbàitiān	/Sunday/
厉害	lìhai	/(used to describe sb or sth that makes a very strong impression, whether favorable or unfavorable) terrible; intense; severe; devastating; amazing; awesome; outstanding/(of a person) stern; strict; harsh; shrewd; tough/(of an animal) fierce/(of a resemblance) striking/(of liquor or chili pepper) strong/(of bacteria) virulent/
力气	lìqi	/strength/CL:把[ba3]/
例如	lìrú	/for example; for instance; such as/
俩	liǎ	/used in 伎倆|伎俩[ji4 liang3]/
连	lián	/to link/to join/to connect/continuously/in succession/including/(used with 也[ye3], 都[dou1] etc) even/company (military)/
联系	liánxì	/connection/contact/relation/to get in touch with/to integrate/to link/to touch/
凉快	liángkuai	/nice and cold/pleasantly cool/
零钱	língqián	/change (of money)/small change/pocket money/
另外	lìngwài	/additional/in addition/besides/separate/other/moreover/furthermore/
留	liú	/old variant of 留[liu2]/
流利	liúlì	/fluent/
流行	liúxíng	/(of a contagious disease etc) to spread/to propagate/(of a style of clothing, song etc) popular/fashionable/
乱	luàn	/in confusion or disorder/in a confused state of mind/disorder/upheaval/riot/illicit sexual relations/to throw into disorder/to mix up/indiscriminate/random/arbitrary/
旅行	lǚxíng	/to travel/journey; trip/CL:趟[tang4],次[ci4]/
律师	lǜshī	/lawyer/
麻烦	máfan	/trouble; inconvenience/inconvenient; troublesome; annoying/to bother sb; to put sb to trouble/
马虎	mǎhu	/careless/sloppy/negligent/skimpy/
满	mǎn	/to fill/full/filled/packed/fully/completely/quite/to reach the limit/to satisfy/satisfied/contented/
毛	máo	/hair/feather/down/wool/mildew/mold/coarse or semifinished/young/raw/careless/unthinking/nervous/scared/(of currency) to devalue or depreciate/classifier for Chinese fractional monetary unit ( = 角[jiao3] , = one-tenth of a yuan or 10 fen 分[fen1])/
毛巾	máojīn	/towel/CL:條|条[tiao2]/
美丽	měilì	/beautiful/
梦	mèng	/dream (CL:場|场[chang2],個|个[ge4])/(bound form) to dream/
迷路	mílù	/to lose the way/lost/labyrinth/labyrinthus vestibularis (of the inner ear)/
密码	mìmǎ	/cipher; secret code/password; PIN/
免费	miǎnfèi	/free (of charge)/
秒	miǎo	/second (unit of time)/arc second (angular measurement unit)/(coll.) instantly/
民族	mínzú	/nationality; ethnic group/CL:個|个[ge4]/
母亲	mǔqīn	/mother/also pr. [mu3 qin5]/CL:個|个[ge4]/
目的	mùdì	/purpose; aim; goal; target; objective/CL:個|个[ge4]/
耐心	nàixīn	/to be patient/patience/
难道	nándào	/don't tell me .../could it be that...?/
难受	nánshòu	/to feel unwell/to suffer pain/to be difficult to bear/
内	nèi	/inside/inner/internal/within/interior/
内容	nèiróng	/content/substance/details/CL:個|个[ge4],項|项[xiang4]/
能力	nénglì	/capability/ability/CL:個|个[ge4]/
年龄	niánlíng	/(a person's) age/CL:把[ba3],個|个[ge4]/
弄	nòng	/variant of 弄[long4]/
暖和	nuǎnhuo	/warm/nice and warm/
偶尔	ǒu’ěr	/occasionally/once in a while/sometimes/
排队	páiduì	/to line up/
排列	páiliè	/to arrange in order/(math.) permutation/
判断	pànduàn	/to judge/to determine/judgment/
陪	péi	/to accompany/to keep sb company/to assist/old variant of 賠|赔[pei2]/
批评	pīpíng	/to criticize; criticism/CL:次[ci4],番[fan1]/
皮肤	pífū	/skin/CL:層|层[ceng2],塊|块[kuai4]/
脾气	píqi	/character; temperament; disposition/bad temper/CL:股[gu3]/
篇	piān	/sheet/piece of writing/bound set of bamboo slips used for record keeping (old)/classifier for written items: chapter, article/
骗	piàn	/to cheat/to swindle/to deceive/to get on (a horse etc) by swinging one leg over/
乒乓球	pīngpāngqiú	/table tennis/ping-pong/table tennis ball/CL:個|个[ge4]/
平时	píngshí	/ordinarily/in normal times/in peacetime/
破	pò	/broken/damaged/worn out/lousy/rotten/to break, split or cleave/to get rid of/to destroy/to break with/to defeat/to capture (a city etc)/to expose the truth of/
葡萄	pútao	/grape/
普遍	pǔbiàn	/universal/general/widespread/common/
普通话	pǔtōnghuà	/Mandarin (common language)/Putonghua (common speech of the Chinese language)/ordinary speech/
其次	qícì	/next/secondly/
其中	qízhōng	/among/in/included among these/
气候	qìhòu	/(meteorology) climate/(fig.) climate; prevailing conditions (in human affairs)/CL:種|种[zhong3]/
千万	qiānwàn	/ten million/countless/many/one must by all means/
签证	qiānzhèng	/visa/to issue a visa/
敲	qiāo	/to hit/to strike/to tap/to rap/to knock/to rip sb off/to overcharge/
桥	qiáo	/bridge/CL:座[zuo4]/
巧克力	qiǎokèlì	/chocolate (loanword)/CL:塊|块[kuai4]/
亲戚	qīnqi	/a relative (i.e. family relation)/CL:門|门[men2],個|个[ge4],位[wei4]/
轻	qīng	/light/easy/gentle/soft/reckless/unimportant/frivolous/small in number/unstressed/neutral/to disparage/
轻松	qīngsōng	/light/gentle/relaxed/effortless/uncomplicated/to relax/to take things less seriously/
情况	qíngkuàng	/circumstances; state of affairs; situation/CL:個|个[ge4],種|种[zhong3]/
穷	qióng	/poor/destitute/to use up/to exhaust/thoroughly/extremely/(coll.) persistently and pointlessly/
区别	qūbié	/difference/to distinguish/to discriminate/to make a distinction/CL:個|个[ge4]/
取	qǔ	/to take/to get/to choose/to fetch/
全部	quánbù	/whole; all/
缺点	quēdiǎn	/weak point/fault/shortcoming/disadvantage/CL:個|个[ge4]/
缺少	quēshǎo	/lack/shortage of/shortfall/to be short (of)/to lack/
却	què	/but/yet/however/while/to go back/to decline/to retreat/nevertheless/even though/
确实	quèshí	/indeed/really/reliable/real/true/
然而	rán’ér	/however; but; yet/
热闹	rènao	/bustling with noise and excitement/lively/
任何	rènhé	/any; whatever; whichever/
任务	rènwu	/mission; assignment; task; duty; role/CL:項|项[xiang4],個|个[ge4]/
扔	rēng	/to throw/to throw away/
仍然	réngrán	/still; as before; yet/
日记	rìjì	/diary/CL:則|则[ze2],本[ben3],篇[pian1]/
入口	rùkǒu	/entrance/to import/
散步	sànbù	/to take a walk; to go for a walk/
森林	sēnlín	/forest/CL:片[pian4]/
沙发	shāfā	/sofa (loanword)/CL:條|条[tiao2],張|张[zhang1]/(Internet slang) the first reply or replier to a forum post/
商量	shāngliang	/to consult/to talk over/to discuss/
伤心	shāngxīn	/to grieve/to be broken-hearted/to feel deeply hurt/
稍微	shāowēi	/a little bit/
勺子	sháozi	/scoop/ladle/CL:把[ba3]/
社会	shèhuì	/society/CL:個|个[ge4]/
深	shēn	/deep (lit. and fig.)/
申请	shēnqǐng	/to apply for sth/application form (CL:份[fen4])/
甚至	shènzhì	/even; so much so that/
生活	shēnghuó	/to live/life/livelihood/
生命	shēngmìng	/life (as the characteristic of living beings)/living being; creature (CL:個|个[ge4],條|条[tiao2])/
生意	shēngyi	/business/CL:筆|笔[bi3]/
省	shěng	/(bound form) to scrutinize/(bound form) to reflect (on one's conduct)/(bound form) to come to realize/(bound form) to pay a visit (to one's parents or elders)/
剩	shèng	/to remain/to be left/to have as remainder/
失败	shībài	/to be defeated/to lose/to fail (e.g. experiments)/failure/defeat/CL:次[ci4]/
失望	shīwàng	/disappointed/to lose hope/to despair/
师傅	shīfu	/master/qualified worker/respectful form of address for older men/CL:個|个[ge4],位[wei4],名[ming2]/
十分	shífēn	/very/completely/utterly/extremely/absolutely/hundred percent/to divide into ten equal parts/
实际	shíjì	/reality/practice/practical/realistic/real/actual/
实在	shízài	/really/actually/indeed/true/real/honest/dependable/(philosophy) reality/
使	shǐ	/to make/to cause/to enable/to use/to employ/to send/to instruct sb to do sth/envoy/messenger/
使用	shǐyòng	/to use/to employ/to apply/to make use of/
是否	shìfǒu	/whether (or not)/if/is or isn't/
适合	shìhé	/to fit; to suit/
适应	shìyìng	/to adapt/to fit/to suit/
世纪	shìjì	/century/CL:個|个[ge4]/
收	shōu	/to receive/to accept/to collect/to put away/to restrain/to stop/in care of (used on address line after name)/
收入	shōurù	/to take in/income/revenue/CL:筆|笔[bi3],個|个[ge4]/
收拾	shōushi	/to put in order/to tidy up/to pack/to repair/(coll.) to sort sb out/to fix sb/
首都	shǒudū	/capital (city)/CL:個|个[ge4]/
首先	shǒuxiān	/first (of all)/in the first place/
受不了	shòubuliǎo	/unbearable/unable to endure/can't stand/
受到	shòudào	/to receive (praise, an education, punishment etc)/to be ...ed (praised, educated, punished etc)/
售货员	shòuhuòyuán	/salesperson/CL:個|个[ge4]/
输	shū	/to lose; to be beaten/(bound form) to transport/(literary) to donate; to contribute/(coll.) to enter (a password)/
熟悉	shúxī	/to be familiar with; to know well/
数量	shùliàng	/amount; quantity (CL:個|个[ge4])/quantitative/(math.) scalar quantity/
数字	shùzì	/numeral/digit/number/figure/amount/digital (electronics etc)/CL:個|个[ge4]/
帅	shuài	/(bound form) commander-in-chief/(bound form) to lead; to command/handsome; graceful; dashing; elegant/(coll.) cool!; sweet!/(Chinese chess) general (on the red side, equivalent to a king in Western chess)/
顺便	shùnbiàn	/conveniently/in passing/without much extra effort/
顺利	shùnlì	/smoothly; without a hitch/
顺序	shùnxù	/sequence/order/
说明	shuōmíng	/to explain/to illustrate/to indicate/to show/to prove/explanation/directions/caption/CL:個|个[ge4]/
硕士	shuòshì	/master's degree/person who has a master's degree/learned person/
死	sǐ	/to die/impassable/uncrossable/inflexible/rigid/extremely/damned/
速度	sùdù	/speed/rate/velocity/(music) tempo/CL:個|个[ge4]/
塑料袋	sùliàodài	/plastic bag/
酸	suān	/sour/tart/sick at heart/grieved/sore/aching/pedantic/impractical/to make sarcastic remarks about sb/an acid/
随便	suíbiàn	/as one wishes/as one pleases/at random/negligent/casual/wanton/
随着	suízhe	/along with/in the wake of/following/
孙子	sūnzi	/grandson/son's son/
所有	suǒyǒu	/all/to have; to possess; to own/
台	tái	/typhoon/
抬	tái	/to lift/to raise/(of two or more persons) to carry/
态度	tàidu	/manner/bearing/attitude/approach/CL:個|个[ge4]/
谈	tán	/to speak/to talk/to converse/to chat/to discuss/
弹钢琴	tángāngqín	to play the piano
汤	tāng	/soup/hot or boiling water/decoction of medicinal herbs/water in which sth has been boiled/
糖	táng	/old variant of 糖[tang2]/
躺	tǎng	/to recline/to lie down/
趟	tàng	/classifier for times, round trips or rows/a time/a trip/
讨论	tǎolùn	/to discuss; to talk over/
讨厌	tǎoyàn	/to dislike/to loathe/disagreeable/troublesome/annoying/
特点	tèdiǎn	/characteristic (feature)/trait/feature/CL:個|个[ge4]/
提	tí	/to carry (hanging down from the hand)/to lift/to put forward/to mention/to raise (an issue)/upwards character stroke/lifting brush stroke (in painting)/scoop for measuring liquid/
提供	tígōng	/to offer/to supply/to provide/to furnish/
提前	tíqián	/to shift to an earlier date/to do sth ahead of time/in advance/
提醒	tíxǐng	/to remind/to call attention to/to warn of/
填空	tiánkòng	/to fill a job vacancy/to fill in a blank (e.g. on questionnaire or exam paper)/
条件	tiáojiàn	/condition; circumstance; term; factor/requirement; prerequisite; qualification/situation; state; condition/CL:個|个[ge4]/
停	tíng	/to stop/to halt/to park (a car)/
挺	tǐng	/straight/erect/to stick out (a part of the body)/to (physically) straighten up/to support/to withstand/outstanding/(coll.) quite/very/classifier for machine guns/
通过	tōngguò	/to pass through; to get through/to adopt (a resolution); to pass (legislation)/to pass (a test)/by means of; through; via/
通知	tōngzhī	/to notify/to inform/notice/notification/CL:個|个[ge4]/
同时	tóngshí	/at the same time; simultaneously/
同情	tóngqíng	/to sympathize with/sympathy/
推	tuī	/to push/to cut/to refuse/to reject/to decline/to shirk (responsibility)/to put off/to delay/to push forward/to nominate/to elect/massage/
推迟	tuīchí	/to postpone/to put off/to defer/
脱	tuō	/to shed/to take off/to escape/to get away from/
袜子	wàzi	/socks/stockings/CL:隻|只[zhi1],對|对[dui4],雙|双[shuang1]/
完全	wánquán	/complete; whole/totally; entirely/
往往	wǎngwǎng	/usually/in many cases/more often than not/
网球	wǎngqiú	/tennis/tennis ball/CL:個|个[ge4]/
网站	wǎngzhàn	/website/
危险	wēixiǎn	/danger/dangerous/
味道	wèidào	/flavor; taste/(fig.) feeling (of ...); sense (of ...); hint (of ...)/(fig.) interest; delight/(dialect) smell; odor/
卫生间	wèishēngjiān	/bathroom/toilet/WC/CL:間|间[jian1]/
温度	wēndù	/temperature/CL:個|个[ge4]/
文章	wénzhāng	/article/essay/literary works/writings/hidden meaning/CL:篇[pian1],段[duan4],頁|页[ye4]/
污染	wūrǎn	/to pollute; to contaminate (lit. and fig.)/
无	wú	/not to have/no/none/not/to lack/un-/-less/
无聊	wúliáo	/bored/boring/senseless/
无论	wúlùn	/no matter what or how/regardless of whether.../
误会	wùhuì	/to misunderstand/to mistake/misunderstanding/CL:個|个[ge4]/
西红柿	xīhóngshì	/tomato/CL:隻|只[zhi1]/
吸引	xīyǐn	/to attract; to appeal to; to fascinate/
咸	xián	/salted/salty/stingy/miserly/
现金	xiànjīn	/cash/
羡慕	xiànmù	/to envy/to admire/
香	xiāng	/fragrant/sweet smelling/aromatic/savory or appetizing/(to eat) with relish/(of sleep) sound/perfume or spice/joss or incense stick/CL:根[gen1]/
相反	xiāngfǎn	/opposite/contrary/
相同	xiāngtóng	/identical/same/
详细	xiángxì	/detailed/in detail/minute/
响	xiǎng	/echo/sound/noise/to make a sound/to sound/to ring/loud/classifier for noises/
橡皮	xiàngpí	/rubber/an eraser/CL:塊|块[kuai4]/
消息	xiāoxi	/news/information/CL:條|条[tiao2]/
小吃	xiǎochī	/snack/refreshments/CL:家[jia1]/
小伙子	xiǎohuǒzi	/young man/young guy/lad/youngster/CL:個|个[ge4]/
小说	xiǎoshuō	/novel/fiction/CL:本[ben3],部[bu4]/
笑话	xiàohua	/joke; jest (CL:個|个[ge4])/to laugh at; to mock/ridiculous; absurd/
效果	xiàoguǒ	/result/effect/efficacy/(theater) sound or visual effects/
辛苦	xīnkǔ	/exhausting/hard/tough/arduous/to work hard/to go to a lot of trouble/hardship(s)/
心情	xīnqíng	/mood; frame of mind/CL:個|个[ge4]/
信封	xìnfēng	/envelope/CL:個|个[ge4]/
信息	xìnxī	/information/news/message/
信心	xìnxīn	/confidence/faith (in sb or sth)/CL:個|个[ge4]/
兴奋	xīngfèn	/excited/excitement/(physiology) excitation/
行	xíng	/to walk/to go/to travel/a visit/temporary/makeshift/current/in circulation/to do/to perform/capable/competent/effective/all right/OK!/will do/behavior/conduct/Taiwan pr. [xing4] for the behavior-conduct sense/
醒	xǐng	/to wake up/to be awake/to become aware/to sober up/to come to/
性别	xìngbié	/gender/sex/
性格	xìnggé	/nature/disposition/temperament/character/CL:個|个[ge4]/
幸福	xìngfú	/happiness/happy/blessed/
修理	xiūlǐ	/to repair/to fix/to prune/to trim/(coll.) to sort sb out/to fix sb/
许多	xǔduō	/many/a lot of/much/
学期	xuéqī	/term/semester/CL:個|个[ge4]/
压力	yālì	/pressure/
牙膏	yágāo	/toothpaste/CL:管[guan3]/
亚洲	yàzhōu	/Asia (abbr. for 亞細亞洲|亚细亚洲[Ya4 xi4 ya4 Zhou1])/
呀	ya	/(particle equivalent to 啊 after a vowel, expressing surprise or doubt)/
盐	yán	/salt/CL:粒[li4]/
严格	yángé	/strict/stringent/tight/rigorous/
严重	yánzhòng	/grave/serious/severe/critical/
研究	yánjiū	/research/a study/CL:項|项[xiang4]/to research/to look into/
演出	yǎnchū	/to act (in a play)/to perform/to put on (a performance)/performance/concert/show/CL:場|场[chang3],次[ci4]/
演员	yǎnyuán	/actor; actress; performer/
眼镜	yǎnjìng	/spectacles/eyeglasses/CL:副[fu4]/
阳光	yángguāng	/sunshine/(of personality) upbeat; energetic/transparent (open to public scrutiny)/
养成	yǎngchéng	/to cultivate/to raise/to form (a habit)/to acquire/
样子	yàngzi	/appearance/manner/pattern/model/
邀请	yāoqǐng	/to invite/invitation/CL:個|个[ge4]/
要是	yàoshi	/(coll.) if/
钥匙	yàoshi	/key/CL:把[ba3]/
也许	yěxǔ	/perhaps/maybe/
页	yè	/page/leaf/
叶子	yèzi	/leaf (CL:片[pian4])/(slang) marijuana/
一切	yíqiè	/everything/every/all/
以	yǐ	/to use/by means of/according to/in order to/because of/at (a certain date or place)/
以为	yǐwéi	/to think (i.e. to take it to be true that ...) (Usually there is an implication that the notion is mistaken – except when expressing one's own current opinion.)/
意见	yìjiàn	/idea/opinion/suggestion/objection/complaint/CL:點|点[dian3],條|条[tiao2]/
艺术	yìshù	/art/
因此	yīncǐ	/thus; consequently; as a result/
引起	yǐnqǐ	/to give rise to; to lead to; to cause; to arouse/
印象	yìnxiàng	/impression (sth that stays in one's mind)/a memory/
应聘	yìngpìn	/to accept a job offer/to apply for an advertised position/
赢	yíng	/to beat/to win/to profit/
勇敢	yǒnggǎn	/brave; courageous/
永远	yǒngyuǎn	/forever/eternal/
优点	yōudiǎn	/merit/benefit/strong point/advantage/CL:個|个[ge4],項|项[xiang4]/
优秀	yōuxiù	/outstanding; excellent/
幽默	yōumò	/(loanword) humor/humorous/
由	yóu	/to follow/from/because of; due to/by; via; through/(before a noun and a verb) it is for ... to .../
由于	yóuyú	/due to/as a result of/thanks to/owing to/since/because/
邮局	yóujú	/post office/CL:家[jia1],個|个[ge4]/
尤其	yóuqí	/especially; particularly/
有趣	yǒuqù	/interesting/fascinating/amusing/
友好	yǒuhǎo	/friendly; amicable/close friend/
友谊	yǒuyì	/companionship/fellowship/friendship/
愉快	yúkuài	/cheerful/cheerily/delightful/pleasant/pleasantly/pleasing/happy/delighted/
于是	yúshì	/thereupon; as a result; consequently; thus; hence/
与	yǔ	/to take part in/
语法	yǔfǎ	/grammar/
语言	yǔyán	/language/CL:門|门[men2],種|种[zhong3]/
羽毛球	yǔmáoqiú	/badminton/shuttlecock/
预习	yùxí	/to prepare a lesson/
原来	yuánlái	/original; former/originally; formerly; at first/so, actually, as it turns out/
原谅	yuánliàng	/to excuse/to forgive/to pardon/
原因	yuányīn	/cause/origin/root cause/reason/CL:個|个[ge4]/
约会	yuēhuì	/appointment/engagement/date/CL:次[ci4],個|个[ge4]/to arrange to meet/
阅读	yuèdú	/to read/reading/
云	yún	/cloud/CL:朵[duo3]/
允许	yǔnxǔ	/to permit/to allow/
杂志	zázhì	/magazine/CL:本[ben3],份[fen4],期[qi1]/
咱们	zánmen	/we or us (including both the speaker and the person(s) spoken to)/(dialect) I or me/(dialect) (in a coaxing or familiar way) you/also pr. [za2 men5]/
暂时	zànshí	/temporary; provisional; for the time being/
脏	zāng	/dirty/filthy/to get (sth) dirty/
责任	zérèn	/responsibility/blame/duty/CL:個|个[ge4]/
增加	zēngjiā	/to raise; to increase/
占线	zhànxiàn	/busy (telephone line)/
招聘	zhāopìn	/to invite applications for a job/to recruit/
照	zhào	/according to/in accordance with/to shine/to illuminate/to reflect/to look at (one's reflection)/to take (a photo)/photo/as requested/as before/
真正	zhēnzhèng	/genuine; real; true/really; indeed/
整理	zhěnglǐ	/to arrange/to tidy up/to sort out/to straighten out/to list systematically/to collate (data, files)/to pack (luggage)/
正常	zhèngcháng	/regular/normal/ordinary/
正好	zhènghǎo	/just (in time)/just right/just enough/to happen to/to chance to/by chance/it just so happens that/
正确	zhèngquè	/correct; sound; right; proper/
正式	zhèngshì	/formal; official/
证明	zhèngmíng	/proof/certificate/identification/testimonial/CL:個|个[ge4]/to prove/to testify/to confirm the truth of/
之	zhī	/(possessive particle, literary equivalent of 的[de5])/him/her/it/
支持	zhīchí	/to be in favor of/to support/to back/support/backing/to stand by/CL:個|个[ge4]/
知识	zhīshi	/knowledge/CL:門|门[men2]/intellectual/
值得	zhídé	/to be worth/to deserve/
直接	zhíjiē	/direct (opposite: indirect 間接|间接[jian4 jie1])/immediate/straightforward/
植物	zhíwù	/plant/vegetation/CL:種|种[zhong3]/
职业	zhíyè	/occupation; profession; vocation/professional/
指	zhǐ	/finger/to point at or to/to indicate or refer to/to depend on/to count on/(of hair) to stand on end/
只好	zhǐhǎo	/to have no other option but to ...; to have to; to be forced to/
只要	zhǐyào	/if only/so long as/
质量	zhìliàng	/quality/(physics) mass/
至少	zhìshǎo	/at least/(to say the) least/
重	zhòng	/heavy/serious/to attach importance to/
重点	zhòngdiǎn	/important point; main point; focus/key (project etc)/to focus on; to put the emphasis on/
重视	zhòngshì	/to attach importance to sth; to value/
周围	zhōuwéi	/environs; surroundings; periphery/
主意	zhǔyi	/plan/idea/decision/CL:個|个[ge4]/Beijing pr. [zhu2 yi5]/
祝贺	zhùhè	/to congratulate/congratulations/CL:個|个[ge4]/
著名	zhùmíng	/famous/noted/well-known/celebrated/
专门	zhuānmén	/specialist/specialized/customized/
专业	zhuānyè	/specialty/specialized field/main field of study (at university)/major/CL:門|门[men2],個|个[ge4]/professional/
转	zhuàn	/to revolve/to turn/to circle about/to walk about/classifier for revolutions (per minute etc): revs, rpm/classifier for repeated actions/
赚	zhuàn	/to cheat/to swindle/
准确	zhǔnquè	/accurate; exact; precise/
准时	zhǔnshí	/on time/punctual/on schedule/
仔细	zǐxì	/careful; attentive; cautious/to be careful; to look out/
自然	zìrán	/nature/natural/naturally/
自信	zìxìn	/to have confidence in oneself/self-confidence/
总结	zǒngjié	/to sum up/to conclude/summary/résumé/CL:個|个[ge4]/
租	zū	/to hire/to rent/to charter/to rent out/to lease out/rent/land tax/
最好	zuìhǎo	/best/had better ...; it would be best to .../
尊重	zūnzhòng	/to esteem/to respect/to honor/to value/eminent/serious/proper/
左右	zuǒyòu	/left and right/nearby/approximately/attendant/to control/to influence/
座	zuò	/seat/base/stand/(archaic) suffix used in a respectful form of address, e.g. 师座|师座[shi1 zuo4]/CL:個|个[ge4]/classifier for buildings, mountains and similar immovable objects/
作家	zuòjiā	/author/CL:個|个[ge4],位[wei4]/
座位	zuòwèi	/seat/CL:個|个[ge4]/
作用	zuòyòng	/to act on; to affect/action; function; activity/impact; result; effect/purpose; intent/(suffix) -ation, -tion etc, as in 抑制作用[yi4 zhi4 zuo4 yong4], inhibition/
作者	zuòzhě	/author; writer/
