唉	āi	/alas/oh dear/
爱心	àixīn	/compassion/kindness/care for others/love/CL:片[pian4]/charity (bazaar, golf day etc)/heart (the symbol ♥)/
熬夜	áoyè	/to stay up late or all night/
安慰	ānwèi	/to comfort/to console/CL:個|个[ge4]/
岸	àn	/bank; shore; beach; coast/CL:個|个[ge4]/
包含	bāohán	/to contain/to embody/to include/
宝贵	bǎoguì	/valuable/precious/to value/to treasure/to set store by/
保存	bǎocún	/to conserve/to preserve/to keep/to save (a file etc) (computing)/
保留	bǎoliú	/to keep/to retain/to have reservations (about sth)/to hold back (from saying sth)/to put aside for later/
报到	bàodào	/to report for duty/to check in/to register/
报告	bàogào	/to inform/to report/to make known/report/speech/talk/lecture/CL:篇[pian1],份[fen4],個|个[ge4],通[tong4]/
悲观	bēiguān	/pessimistic/
背景	bèijǐng	/background; backdrop; context/(fig.) powerful backer/CL:種|种[zhong3]/
被子	bèizi	/quilt/CL:床[chuang2]/
本科	běnkē	/undergraduate course/undergraduate (attributive)/
本领	běnlǐng	/skill/ability/capability/CL:項|项[xiang4],個|个[ge4]/
比例	bǐlì	/proportion/scale/
必然	bìrán	/inevitable/certain/necessity/
必要	bìyào	/necessary/essential/indispensable/required/
鞭炮	biānpào	/firecrackers/string of small firecrackers/CL:枚[mei2]/
辩论	biànlùn	/debate/argument/to argue over/CL:場|场[chang3],次[ci4]/
标志	biāozhì	/sign; mark; symbol; logo/to symbolize; to indicate; to mark/
表达	biǎodá	/to express; to convey/
表面	biǎomiàn	/surface/face/outside/appearance/
表情	biǎoqíng	/(facial) expression/to express one's feelings/
表现	biǎoxiàn	/to show/to show off/to display/to manifest/expression/manifestation/show/display/performance (at work etc)/behavior/
冰激凌	bīngjīlíng	/ice cream/
玻璃	bōli	/glass/CL:張|张[zhang1],塊|块[kuai4]/(slang) male homosexual/
博物馆	bówùguǎn	/museum/
不断	búduàn	/unceasing/uninterrupted/continuous/constant/
不见得	bújiàndé	/not necessarily/not likely/
不耐烦	búnàifán	/impatient/to lose patience/
补充	bǔchōng	/to replenish/to supplement/to complement/additional/supplementary/CL:個|个[ge4]/
不然	bùrán	/not so/no/or else/otherwise/if not/How about ...?/
不足	bùzú	/insufficient/lacking/deficiency/not enough/inadequate/not worth/cannot/should not/
部门	bùmén	/department/branch/section/division/CL:個|个[ge4]/
财产	cáichǎn	/property/assets/estate/CL:筆|笔[bi3]/
踩	cǎi	/to step on/to tread/to stamp/to press a pedal/to pedal (a bike)/(online) to downvote/
采取	cǎiqǔ	/to adopt or carry out (measures, policies, course of action)/to take/
参考	cānkǎo	/consultation/reference/to consult/to refer/
操场	cāochǎng	/playground/sports field/drill ground/CL:個|个[ge4]/
插	chā	/old variant of 插[cha1]/
叉子	chāzi	/fork/CL:把[ba3]/
拆	chāi	/to tear open/to tear down/to tear apart/to open/
产生	chǎnshēng	/to arise; to come into being; to come about/to give rise to; to bring into being; to bring about; to produce; to engender; to generate/
常识	chángshí	/common sense/general knowledge/CL:門|门[men2]/
潮湿	cháoshī	/damp/moist/
吵	chǎo	/to quarrel/to make a noise/noisy/to disturb by making a noise/
车库	chēkù	/garage/
彻底	chèdǐ	/thorough/thoroughly/complete/
趁	chèn	/old variant of 趁[chen4]/
称	chēng	/variant of 秤[cheng4]/steelyard/
称赞	chēngzàn	/to praise/to acclaim/to commend/to compliment/
承担	chéngdān	/to undertake/to assume (responsibility etc)/
承受	chéngshòu	/to bear/to support/to inherit/
程序	chéngxù	/procedures/sequence/order/computer program/
成立	chénglì	/to establish/to set up/to be tenable/to hold water/
成人	chéngrén	/to reach adulthood/an adult/
成语	chéngyǔ	/Chinese set expression, typically of 4 characters, often alluding to a story or historical quotation; idiom; proverb; saying; adage/CL:條|条[tiao2],本[ben3],句[ju4]/
诚恳	chéngkěn	/sincere/honest/cordial/
持续	chíxù	/to continue/to persist/to last/sustainable/preservation/
尺子	chǐzi	/ruler (measuring instrument)/CL:把[ba3]/
冲	chōng	/powerful/vigorous/pungent/towards/in view of/
充分	chōngfèn	/ample/sufficient/adequate/full/fully/to the full/
重复	chóngfù	/variant of 重複|重复[chong2 fu4]/
宠物	chǒngwù	/house pet/
抽象	chōuxiàng	/abstract/abstraction/CL:種|种[zhong3]/
丑	chǒu	/shameful/ugly/disgraceful/
出口	chūkǒu	/an exit/CL:個|个[ge4]/to speak/to export/(of a ship) to leave port/
出示	chūshì	/to show/to take out and show to others/to display/
出席	chūxí	/to attend/to participate/present/
除非	chúfēi	/only if (..., or otherwise, ...)/only when/only in the case that/unless/
除夕	chúxī	/lunar New Year's Eve/
处理	chǔlǐ	/to handle; to deal with/to punish/to treat sth by a special process; to process/to sell at reduced prices/
传染	chuánrǎn	/to infect/contagious/
传统	chuántǒng	/tradition/traditional/convention/conventional/CL:個|个[ge4]/
闯	chuǎng	/to rush/to charge/to dash/to break through/to temper oneself (through battling hardships)/
吹	chuī	/to blow/to play a wind instrument/to blast/to puff/to boast/to brag/to end in failure/to fall through/
此外	cǐwài	/besides/in addition/moreover/furthermore/
次要	cìyào	/secondary/
匆忙	cōngmáng	/hasty/hurried/
从而	cóng’ér	/thus/thereby/
从前	cóngqián	/previously/formerly/once upon a time/
粗糙	cūcāo	/crude/gruff/rough/coarse/
醋	cù	/vinegar/jealousy (in love rivalry)/
促使	cùshǐ	/to prompt; to induce; to spur/
措施	cuòshī	/measure/step/CL:個|个[ge4]/
打工	dǎgōng	/to work a temporary or casual job/(of students) to have a job outside of class time, or during vacation/
大厦	dàshà	/(used in the names of grand buildings such as 百老匯大廈|百老汇大厦 Broadway Mansions (in Shanghai) or 帝國大廈|帝国大厦 Empire State Building etc)/
大象	dàxiàng	/elephant/CL:隻|只[zhi1]/
代表	dàibiǎo	/representative/delegate/CL:位[wei4],個|个[ge4],名[ming2]/to represent/to stand for/on behalf of/in the name of/
待遇	dàiyù	/treatment/pay/salary/status/rank/
单调	dāndiào	/monotonous/
单位	dānwèi	/unit (of measure)/unit (group of people as a whole)/work unit (place of employment, esp. in the PRC prior to economic reform)/CL:個|个[ge4]/
担任	dānrèn	/to hold a governmental office or post/to assume office of/to take charge of/to serve as/
耽误	dānwu	/to delay/to hold up/to waste time/to interfere with/
淡	dàn	/insipid/diluted/weak/mild/light in color/tasteless/indifferent/(variant of 氮[dan4]) nitrogen/
倒霉	dǎoméi	/to have bad luck/to be out of luck/
道理	dàolǐ	/reason/argument/sense/principle/basis/justification/CL:個|个[ge4]/
登记	dēngjì	/to register (one's name)/
等于	děngyú	/to equal/to be tantamount to/
滴	dī	/a drop/to drip/
敌人	dírén	/enemy/CL:個|个[ge4]/
递	dì	/to hand over; to pass on; to deliver/(bound form) progressively; in the proper order/
地毯	dìtǎn	/carpet/rug/
地震	dìzhèn	/earthquake/
电池	diànchí	/battery/CL:節|节[jie2],組|组[zu3]/
顶	dǐng	/apex/crown of the head/top/roof/most/to carry on the head/to push to the top/to go against/to replace/to substitute/to be subjected to (an aerial bombing, hailstorm etc)/(slang) to "bump" a forum thread to raise its profile/classifier for headwear, hats, veils etc/
冻	dòng	/to freeze/to feel very cold/aspic or jelly/
动画片	dònghuàpiàn	/animated film/
逗	dòu	/to tease (playfully); to entice/(coll.) to joke/(coll.) funny; amusing/to stay; to sojourn/brief pause at the end of a phrase (variant of 讀|读[dou4])/
独特	dútè	/unique; distinctive/
度过	dùguò	/to pass/to spend (time)/to survive/to get through/
对比	duìbǐ	/to contrast/contrast/ratio/CL:個|个[ge4]/
对待	duìdài	/to treat/treatment/
对手	duìshǒu	/opponent/rival/competitor/(well-matched) adversary/match/
吨	dūn	/ton (loanword)/Taiwan pr. [dun4]/
顿	dùn	/to stop/to pause/to arrange/to lay out/to kowtow/to stamp (one's foot)/at once/classifier for meals, beatings, scoldings etc: time, bout, spell, meal/
多亏	duōkuī	/thanks to/luckily/
朵	duǒ	/variant of 朵[duo3]/
发表	fābiǎo	/to issue/to publish/
发达	fādá	/well-developed; flourishing/to develop; to promote; to expand/(literary) to achieve fame and fortune; to prosper/
发挥	fāhuī	/to display/to exhibit/to bring out implicit or innate qualities/to express (a thought or moral)/to develop (an idea)/to elaborate (on a theme)/
发票	fāpiào	/invoice; receipt; bill/uniform invoice (abbr. for 統一發票|统一发票[tong3 yi1 fa1 piao4])/
发言	fāyán	/to make a speech/statement/utterance/CL:個|个[ge4]/
罚款	fákuǎn	/to fine/penalty/fine (monetary)/
法院	fǎyuàn	/court of law/court/
繁荣	fánróng	/prosperous; booming (economy)/
反而	fǎn’ér	/on the contrary; instead/
反应	fǎnyìng	/to react/to respond/reaction/response/reply/chemical reaction/CL:個|个[ge4]/
反正	fǎnzhèng	/anyway/in any case/to come over from the enemy's side/
范围	fànwéi	/range/scope/limit/extent/CL:個|个[ge4]/
方案	fāng’àn	/plan/program (for action etc)/proposal/proposed bill/CL:個|个[ge4],套[tao4]/
方式	fāngshì	/way; manner; style; mode; pattern/CL:個|个[ge4]/
妨碍	fáng’ài	/to hinder/to obstruct/
肥皂	féizào	/soap/CL:塊|块[kuai4],條|条[tiao2]/
分布	fēnbù	/to scatter/to distribute/to be distributed (over an area etc)/(statistical, geographic) distribution/
分手	fēnshǒu	/to part company/to split up/to break up/
风景	fēngjǐng	/scenery; landscape/CL:個|个[ge4]/
风险	fēngxiǎn	/risk; hazard/
讽刺	fěngcì	/to satirize/to mock/irony/satire/sarcasm/
否认	fǒurèn	/to declare to be untrue/to deny/
扶	fú	/to support with the hand/to help sb up/to support oneself by holding onto something/to help/
复制	fùzhì	/to duplicate/to make a copy of/to copy/to reproduce/to clone/
改进	gǎijìn	/to improve; to make better/improvement/CL:個|个[ge4]/
改正	gǎizhèng	/to correct/to amend/to put right/correction/CL:個|个[ge4]/
概括	gàikuò	/to summarize; to generalize/briefly; in broad outline/
感想	gǎnxiǎng	/impressions/reflections/thoughts/CL:通[tong4],個|个[ge4]/
赶快	gǎnkuài	/quickly; at once/
干活儿	gànhuór	/erhua variant of 幹活|干活[gan4 huo2]/
高级	gāojí	/high level/high grade/advanced/high-ranking/
告别	gàobié	/to leave; to part from/to bid farewell to; to say goodbye to/
隔壁	gébì	/next door/neighbor/
个人	gèrén	/individual/personal/oneself/
各自	gèzì	/each/respective/apiece/
根本	gēnběn	/fundamental/basic/root/simply/absolutely (not)/(not) at all/CL:個|个[ge4]/
公开	gōngkāi	/open; overt; public/to make public; to release/
公平	gōngpíng	/fair/impartial/
公寓	gōngyù	/apartment building; block of flats (may be a public housing block or a condominium etc) (CL:套[tao4])/
工厂	gōngchǎng	/factory/CL:家[jia1],座[zuo4]/
工具	gōngjù	/tool/instrument/utensil/means (to achieve a goal etc)/
工业	gōngyè	/industry/
功能	gōngnéng	/function; capability/
沟通	gōutōng	/to join; to connect; to link up/to communicate/
姑娘	gūniang	/girl/young woman/young lady/daughter/paternal aunt (old)/CL:個|个[ge4]/
古代	gǔdài	/ancient times/
鼓掌	gǔzhǎng	/to applaud/to clap/
骨头	gǔtou	/bone/CL:根[gen1],塊|块[kuai4]/moral character/bitterness/Taiwan pr. [gu2 tou5]/
乖	guāi	/(of a child) obedient, well-behaved/clever/shrewd/alert/perverse/contrary to reason/irregular/abnormal/
怪不得	guàibude	/no wonder!/so that's why!/
观察	guānchá	/to observe; to watch; to survey/
观念	guānniàn	/notion/thought/concept/sense/views/ideology/general impressions/
冠军	guànjūn	/champion/CL:個|个[ge4]/
光滑	guānghuá	/glossy; sleek; smooth/
光明	guāngmíng	/light/radiance/(fig.) bright (prospects etc)/openhearted/
广大	guǎngdà	/(of an area) vast or extensive/large-scale/widespread/(of people) numerous/
规律	guīlǜ	/rule (e.g. of science)/law of behavior/regular pattern/rhythm/discipline/
规则	guīzé	/rule/regulation/rules and regulations/
滚	gǔn	/to boil/to roll/to take a hike/Get lost!/
国庆节	guóqìngjié	/PRC National Day (October 1st)/
果实	guǒshí	/fruit (produced by a plant)/(fig.) fruits (of success etc)/results/gains/
过敏	guòmǐn	/oversensitive/allergic/allergy/
海鲜	hǎixiān	/seafood/
豪华	háohuá	/luxurious/
好奇	hàoqí	/inquisitive/curious/inquisitiveness/curiosity/
何必	hébì	/there is no need/why should/
合法	héfǎ	/lawful/legitimate/legal/
合理	hélǐ	/rational; reasonable; sensible; fair/
合同	hétong	/(business) contract/CL:個|个[ge4]/
合作	hézuò	/to cooperate; to collaborate; to work together/
恨	hèn	/to hate/to regret/
猴子	hóuzi	/monkey/CL:隻|只[zhi1]/
后背	hòubèi	/the back (human anatomy)/the back part of sth/
忽视	hūshì	/to neglect; to overlook; to disregard; to ignore/
壶	hú	/pot/classifier for bottled liquid/
胡说	húshuō	/to talk nonsense/drivel/
糊涂	hútu	/muddled/silly/confused/
花生	huāshēng	/peanut/groundnut/CL:粒[li4]/
划	huá	/to delimit/to transfer/to assign/to plan/to draw (a line)/stroke of a Chinese character/
话题	huàtí	/subject (of a talk or conversation)/topic/
怀念	huáiniàn	/to cherish the memory of/to think of/to reminisce/
怀孕	huáiyùn	/pregnant/to have conceived/gestation/pregnancy/
慌张	huāngzhāng	/flustered/agitated/
黄金	huángjīn	/gold/golden (opportunity)/prime (time)/
灰	huī	/ash/dust/lime/gray/discouraged; dejected/
灰心	huīxīn	/to lose heart/to be discouraged/
婚礼	hūnlǐ	/wedding ceremony/wedding/CL:場|场[chang3]/
活跃	huóyuè	/active/lively/excited/to enliven/to brighten up/
伙伴	huǒbàn	/partner/companion/comrade/
或许	huòxǔ	/perhaps; maybe/
基本	jīběn	/basic/fundamental/main/elementary/
机器	jīqì	/machine/CL:臺|台[tai2],部[bu4],個|个[ge4]/
及格	jígé	/to pass an exam or a test/to meet a minimum standard/
集合	jíhé	/to gather; to assemble/(math.) set/
集中	jízhōng	/to concentrate/to centralize/to focus/centralized/concentrated/to put together/
急诊	jízhěn	/to give or receive urgent medical treatment/emergency treatment (at a hospital emergency department, or from a doctor on a house call)/
记忆	jìyì	/to remember/to recall/memory/CL:個|个[ge4]/
纪录	jìlù	/variant of 記錄|记录[ji4 lu4] (but in Taiwan, not for the verb sense "to record")/
纪念	jìniàn	/to commemorate; to honor the memory of/memento; keepsake; souvenir/
家务	jiāwù	/household duties/housework/
嘉宾	jiābīn	/esteemed guest/honored guest/guest (on a show)/
甲	jiǎ	/first of the ten Heavenly Stems 十天干[shi2 tian1 gan1]/(used for an unspecified person or thing)/first (in a list, as a party to a contract etc)/letter "A" or roman "I" in list "A, B, C", or "I, II, III" etc/armor plating/shell or carapace/(of the fingers or toes) nail/bladed leather or metal armor (old)/ranking system used in the Imperial examinations (old)/civil administration unit in the baojia 保甲[bao3 jia3] system (old)/ancient Chinese compass point: 75°/
假如	jiǎrú	/if/
假装	jiǎzhuāng	/to feign/to pretend/
驾驶	jiàshǐ	/to pilot (ship, airplane etc)/to drive/
坚强	jiānqiáng	/staunch/strong/
艰苦	jiānkǔ	/difficult/hard/arduous/
捡	jiǎn	/to pick up; to collect; to gather/
简直	jiǎnzhí	/simply; really/
健身	jiànshēn	/to exercise/to keep fit/to work out/physical exercise/
建设	jiànshè	/to build; to construct; to establish; to develop; to institute/
建筑	jiànzhù	/to construct/building/CL:個|个[ge4]/
键盘	jiànpán	/keyboard/
讲座	jiǎngzuò	/a course of lectures/CL:個|个[ge4]/
酱油	jiàngyóu	/soy sauce/
浇	jiāo	/to pour liquid/to irrigate (using waterwheel)/to water/to cast (molten metal)/to mold/
交换	jiāohuàn	/to exchange/to swap/to switch (telecom)/commutative (math)/to commute/
交往	jiāowǎng	/to associate (with)/to have contact (with)/to hang out (with)/to date/(interpersonal) relationship/association/contact/
角度	jiǎodù	/angle/point of view/
教材	jiàocái	/teaching material/CL:本[ben3]/
教训	jiàoxùn	/to provide guidance; to lecture sb; to upbraid/a talking-to; a bitter lesson/CL:番[fan1],頓|顿[dun4]/
接待	jiēdài	/to receive; to entertain; to host (guests, visitors or clients)/
结实	jiēshi	/rugged/sturdy/strong/durable/buff (physique)/
节省	jiéshěng	/saving/to save/to use sparingly/to cut down on/
结构	jiégòu	/structure/composition/makeup/architecture/CL:座[zuo4],個|个[ge4]/
结合	jiéhé	/to combine/to link/to integrate/binding/CL:次[ci4]/
结论	jiélùn	/conclusion/verdict/CL:個|个[ge4]/to conclude/to reach a verdict/
结账	jiézhàng	/to pay the bill/to settle accounts/also written 結帳|结帐/
届	jiè	/to arrive at (place or time)/period/to become due/classifier for events, meetings, elections, sporting fixtures, years (of graduation)/
借口	jièkǒu	/to use as an excuse/excuse; pretext/
戒	jiè	/to guard against/to exhort/to admonish or warn/to give up or stop doing sth/Buddhist monastic discipline/ring (for a finger)/
紧急	jǐnjí	/urgent/emergency/
尽快	jǐnkuài	/see 儘快|尽快[jin3 kuai4]/
谨慎	jǐnshèn	/cautious/prudent/
进步	jìnbù	/progress; improvement/to improve; to progress/CL:個|个[ge4]/
近代	jìndài	/the not-very-distant past/modern times, excluding recent decades/(in the context of Chinese history) the period from the Opium Wars until the May 4th Movement (mid-19th century to 1919)/capitalist times (pre-1949)/
尽量	jìnliàng	/as much as possible/to the greatest extent/
精神	jīngshén	/vigor; vitality/spirited/good-looking/
经典	jīngdiǎn	/the classics/scriptures/classical/classic (example, case etc)/typical/
救	jiù	/to save/to assist/to rescue/
舅舅	jiùjiu	/mother's brother/maternal uncle (informal)/CL:個|个[ge4]/
桔子	júzi	/tangerine/also written 橘子/CL:個|个[ge4],瓣[ban4]/
具备	jùbèi	/to possess/to have/equipped with/able to fulfill (conditions or requirements)/
巨大	jùdà	/huge/immense/very large/tremendous/gigantic/enormous/
决赛	juésài	/finals (of a competition)/
绝对	juéduì	/absolute; unconditional/
军事	jūnshì	/military affairs/(attributive) military/
开放	kāifàng	/to bloom/to open/to be open (to the public)/to open up (to the outside)/to be open-minded/unrestrained by convention/unconstrained in one's sexuality/
开水	kāishuǐ	/boiled water/boiling water/
砍	kǎn	/to chop/to cut down/to throw sth at sb/
看不起	kànbuqǐ	/to look down upon/to despise/
可见	kějiàn	/it can clearly be seen (that this is the case)/it is (thus) clear/clear/visible/
可怕	kěpà	/awful/dreadful/fearful/formidable/frightful/scary/hideous/horrible/terrible/terribly/
克	kè	/variant of 剋|克[ke4]/
客观	kèguān	/objective/impartial/
控制	kòngzhì	/to control/
口味	kǒuwèi	/a person's preferences/tastes (in food)/flavor/
夸	kuā	/to boast; to exaggerate/to praise/
扩大	kuòdà	/to expand/to enlarge/to broaden one's scope/
辣椒	làjiāo	/hot pepper/chili/
烂	làn	/soft; mushy/well-cooked and soft/to rot; to decompose/rotten/worn out/chaotic; messy/utterly; thoroughly/crappy; bad/
劳动	láodòng	/work/toil/physical labor/CL:次[ci4]/
老板	lǎobǎn	/boss/business proprietor/CL:個|个[ge4]/
老鼠	lǎoshǔ	/rat; mouse (CL:隻|只[zhi1])/
姥姥	lǎolao	/(coll.) mother's mother/maternal grandmother/
理论	lǐlùn	/theory/CL:個|个[ge4]/to argue/to take notice of/
理由	lǐyóu	/reason/grounds/justification/CL:個|个[ge4]/
立刻	lìkè	/forthwith/immediate/prompt/promptly/straightway/thereupon/at once/
力量	lìliàng	/power; force; strength/
利息	lìxī	/interest (on a loan)/CL:筆|笔[bi3]/
利用	lìyòng	/to exploit/to make use of/to use/to take advantage of/to utilize/
连忙	liánmáng	/promptly/at once/
联合	liánhé	/to combine/to join/unite/alliance/
了不起	liǎobuqǐ	/amazing/terrific/extraordinary/
列车	lièchē	/(railway) train/
临时	línshí	/as the time draws near/at the last moment/temporary/interim/ad hoc/
灵活	línghuó	/flexible/nimble/agile/
领域	lǐngyù	/domain; sphere; field; territory; area/
流传	liúchuán	/to spread/to circulate/to hand down/
浏览	liúlǎn	/to skim over/to browse/
龙	lóng	/dragon/CL:條|条[tiao2]/imperial/
漏	lòu	/to leak/to divulge/to leave out by mistake/waterclock or hourglass (old)/
陆地	lùdì	/dry land (as opposed to the sea)/
录取	lùqǔ	/to accept an applicant (prospective student, employee etc) who passes an entrance exam/to admit (a student)/to hire (a job candidate)/
论文	lùnwén	/paper/treatise/thesis/CL:篇[pian1]/to discuss a paper or thesis (old)/
落后	luòhòu	/to fall behind/to lag (in technology etc)/backward/to retrogress/
骂	mà	/variant of 罵|骂[ma4]/
麦克风	màikèfēng	/microphone (loanword)/
满足	mǎnzú	/to satisfy/to meet (the needs of)/satisfied/content/
冒险	màoxiǎn	/to take risks/to take chances/foray/adventure/
眉毛	méimao	/eyebrow/CL:根[gen1]/
美术	měishù	/art/fine arts/painting/CL:種|种[zhong3]/
秘密	mìmì	/secret; private; confidential; clandestine/a secret (CL:個|个[ge4])/
面对	miànduì	/to face; to confront/
面临	miànlín	/to face sth; to be confronted with/
苗条	miáotiao	/(of a woman) slim/slender/graceful/
明确	míngquè	/clear-cut; definite; explicit/to clarify; to specify; to make definite/
明显	míngxiǎn	/clear/distinct/obvious/
名牌	míngpái	/famous brand/nameplate/name tag/
名胜古迹	míngshènggǔjì	/historical sites and scenic spots/
命令	mìnglìng	/order/command/CL:道[dao4],個|个[ge4]/
摸	mō	/variant of 摹[mo2]/
模糊	móhu	/vague/indistinct/fuzzy/
摩托车	mótuōchē	/(loanword) motorbike; motorcycle/CL:輛|辆[liang4],部[bu4]/
某	mǒu	/some/a certain/sb or sth indefinite/such-and-such/
目标	mùbiāo	/target/goal/objective/CL:個|个[ge4]/
目录	mùlù	/catalog/table of contents/directory (on computer hard drive)/list/contents/
木头	mùtou	/slow-witted/blockhead/log (of wood, timber etc)/CL:塊|块[kuai4],根[gen1]/
哪怕	nǎpà	/even/even if/even though/no matter how/
难免	nánmiǎn	/hard to avoid/difficult to escape from/will inevitably/
脑袋	nǎodai	/head/skull/brains/mental capability/CL:顆|颗[ke1],個|个[ge4]/
内科	nèikē	/internal medicine; general medicine/
嫩	nèn	/old variant of 嫩[nen4]/
能干	nénggàn	/capable/competent/
能源	néngyuán	/energy/power source/CL:個|个[ge4]/
年代	niándài	/a decade of a century (e.g. the Sixties)/age/era/period/CL:個|个[ge4]/
年纪	niánjì	/age/CL:把[ba3],個|个[ge4]/
宁可	nìngkě	/preferably/one would prefer to...(or not to...)/would rather/(would) be better to/(to pick) the lesser of two evils/
牛仔裤	niúzǎikù	/jeans/CL:條|条[tiao2]/
农村	nóngcūn	/rural area/village/CL:個|个[ge4]/
农业	nóngyè	/agriculture/farming/
女士	nǚshì	/lady/madam/CL:個|个[ge4],位[wei4]/Miss/Ms/
派	pài	/clique/school/group/faction/to dispatch/to send/to assign/to appoint/pi (Greek letter Ππ)/the circular ratio pi = 3.1415926/(loanword) pie/
赔偿	péicháng	/to compensate/
培养	péiyǎng	/to cultivate/to breed/to foster/to nurture/to educate/to groom (for a position)/education/fostering/culture (biology)/
配合	pèihé	/matching/fitting in with/compatible with/to correspond/to fit/to conform to/rapport/to coordinate with/to act in concert with/to cooperate/to become man and wife/to combine parts of machine/
披	pī	/to drape over one's shoulders/to open/to unroll/to split open/to spread out/
片面	piànmiàn	/unilateral/one-sided/
拼音	pīnyīn	/phonetic writing/pinyin (Chinese romanization)/
平	píng	/flat/level/equal/to tie (make the same score)/to draw (score)/calm/peaceful/abbr. for 平聲|平声[ping2 sheng1]/
平常	píngcháng	/ordinary/common/usually/ordinarily/
平方	píngfāng	/square (as in square foot, square mile, square root)/
平静	píngjìng	/tranquil/undisturbed/serene/
评价	píngjià	/to evaluate/to assess/
破坏	pòhuài	/destruction/damage/to wreck/to break/to destroy/
期待	qīdài	/to look forward to/to await/expectation/
奇迹	qíjì	/miracle/miraculous/wonder/marvel/
启发	qǐfā	/to enlighten/to explain (a text etc)/to stimulate (a mental attitude)/enlightenment/revelation/motivation/
气氛	qìfēn	/atmosphere; mood/
汽油	qìyóu	/gasoline/
谦虚	qiānxū	/modest/self-effacing/to make modest remarks/
签	qiān	/inscribed bamboo stick (used in divination, gambling, drawing lots etc)/small wood sliver/label/tag/
浅	qiǎn	/shallow/light (color)/
枪	qiāng	/variant of 槍|枪[qiang1]/rifle/spear/
强调	qiángdiào	/to emphasize (a statement)/to stress/
抢	qiǎng	/to fight over/to rush/to scramble/to grab/to rob/to snatch/
悄悄	qiāoqiāo	/quiet; making little or no noise/surreptitious; stealthy/anxious; worried/Taiwan pr. [qiao3 qiao3]/
瞧	qiáo	/to look at/to see/to see (a doctor)/to visit/
巧妙	qiǎomiào	/ingenious; clever/ingenuity; artifice/
亲爱	qīn’ài	/dear/beloved/darling/
亲切	qīnqiè	/amiable/cordial/close and dear/familiar/
勤奋	qínfèn	/hardworking/diligent/
青春	qīngchūn	/youth/youthfulness/
轻视	qīngshì	/contempt/contemptuous/to despise/to scorn/scornful/
请求	qǐngqiú	/to request; to ask/request (CL:個|个[ge4])/
球迷	qiúmí	/fan (ball sports)/CL:個|个[ge4]/
趋势	qūshì	/trend; tendency/
去世	qùshì	/to pass away/to die/
权力	quánlì	/power/authority/
劝	quàn	/to advise/to urge/to try to persuade/to exhort/to console/to soothe/
缺乏	quēfá	/to lack; to be short of/
确认	quèrèn	/to confirm/to verify/confirmation/
群	qún	/group/crowd/flock, herd, pack etc/
燃烧	ránshāo	/to ignite/to combust/to burn/combustion/flaming/
绕	rào	/variant of 繞|绕[rao4], to rotate around/to spiral/to move around/to go round (an obstacle)/to by-pass/to make a detour/
热爱	rè’ài	/to love ardently/to adore/
热心	rèxīn	/enthusiastic; ardent; zealous/
人才	réncái	/talent/talented person/looks/attractive looks/
人类	rénlèi	/humanity/human race/mankind/
人生	rénshēng	/life (one's time on earth)/
人物	rénwù	/person; personage; figure (esp. sb of importance)/character (in a play, novel etc)/figure painting (as a genre of traditional Chinese painting)/
忍不住	rěnbuzhù	/cannot help/unable to bear/
日程	rìchéng	/schedule/itinerary/CL:個|个[ge4]/
日历	rìlì	/calendar/CL:張|张[zhang1],本[ben3]/
日用品	rìyòngpǐn	/articles for daily use/CL:件[jian4],個|个[ge4]/
如何	rúhé	/how/what way/what/
软件	ruǎnjiàn	/(computer) software/
洒	sǎ	/to sprinkle/to spray/to spill/to shed/
嗓子	sǎngzi	/throat/voice/CL:把[ba3]/
沙滩	shātān	/beach/sandy shore/CL:片[pian4]/
晒	shài	/(of the sun) to shine on/to bask in (the sunshine)/to dry (clothes, grain etc) in the sun/(fig.) to expose and share (one's experiences and thoughts) on the Web (loanword from "share")/(coll.) to give the cold shoulder to/
闪电	shǎndiàn	/lightning/CL:道[dao4]/
善于	shànyú	/to be good at; to be adept at/
商品	shāngpǐn	/commodity; goods; merchandise/CL:件|件[jian4]/
商务	shāngwù	/commercial affairs/commercial/commerce/business/
伤害	shānghài	/to injure; to harm/
舍不得	shěbude	/to hate to do sth/to hate to part with/to begrudge/
设计	shèjì	/to design; to plan/design; plan/
摄影	shèyǐng	/to take a photograph/photography/to shoot (a movie)/
伸	shēn	/to stretch/to extend/
深刻	shēnkè	/profound/deep/deep-going/
身份	shēnfèn	/identity/aspect of one's identity (i.e. sth that one is – mayor, father, permanent resident etc)/role/capacity (as in "in his capacity as a ..." 以…的身份[yi3 xx5 de5 shen1 fen4])/status (social, legal etc)/position/rank/
神秘	shénmì	/mysterious/mystery/
生动	shēngdòng	/vivid/lively/
生长	shēngzhǎng	/to grow/to grow up/to be brought up/
诗	shī	/poem/CL:首[shou3]/poetry/verse/
失眠	shīmián	/to suffer from insomnia/
狮子	shīzi	/lion/CL:隻|只[zhi1],頭|头[tou2]/
时代	shídài	/age/era/epoch/period (in one's life)/CL:個|个[ge4]/
时髦	shímáo	/in vogue/fashionable/
时尚	shíshàng	/fashion/fad/fashionable/
实习	shíxí	/to practice/field work/to intern/internship/
实验	shíyàn	/experiment/test/CL:個|个[ge4],次[ci4]/experimental/to experiment/
石头	shítou	/stone/CL:塊|块[kuai4]/
使劲儿	shǐjìnr	/erhua variant of 使勁|使劲[shi3 jin4]/
始终	shǐzhōng	/from beginning to end/all along/
试卷	shìjuàn	/examination paper/test paper/CL:份[fen4],張|张[zhang1]/
市场	shìchǎng	/marketplace/market (also in abstract)/
事物	shìwù	/thing; object/CL:個|个[ge4]/
收据	shōujù	/receipt/CL:張|张[zhang1]/
手工	shǒugōng	/handwork/manual/
手术	shǒushù	/(surgical) operation/surgery/CL:個|个[ge4]/
手续	shǒuxù	/procedure/CL:道[dao4],個|个[ge4]/formalities/
首	shǒu	/head/chief/first (occasion, thing etc)/classifier for poems, songs etc/
受伤	shòushāng	/to sustain injuries/wounded (in an accident etc)/harmed/
寿命	shòumìng	/life span/life expectancy/lifetime (of a machine)/
书架	shūjià	/bookshelf/CL:個|个[ge4]/
输入	shūrù	/to import/to input/
熟练	shúliàn	/practiced/proficient/skilled/skillful/
鼠标	shǔbiāo	/mouse (computing)/
数据	shùjù	/data/
数码	shùmǎ	/number/numerals/figures/digital/amount/numerical code/
摔倒	shuāidǎo	/to fall down/to slip and fall/to throw sb to the ground/
双方	shuāngfāng	/bilateral/both sides/both parties involved/
税	shuì	/taxes/duties/
说服	shuōfú	/to persuade/to convince/to talk sb over/Taiwan pr. [shui4 fu2]/
丝绸	sīchóu	/silk cloth/silk/
思想	sīxiǎng	/thought/thinking/idea/ideology/CL:個|个[ge4]/
似乎	sìhū	/it seems; seemingly; as if/
随身	suíshēn	/to (carry) on one's person/to (take) with one/
碎	suì	/(transitive or intransitive verb) to break into pieces; to shatter; to crumble/broken; fragmentary; scattered/garrulous/
损失	sǔnshī	/loss/damage/CL:個|个[ge4]/to lose/to suffer damage/
锁	suǒ	/old variant of 鎖|锁[suo3]/
台阶	táijiē	/steps/flight of steps/step (over obstacle)/fig. way out of an embarrassing situation/bench (geology)/
太极拳	tàijíquán	/shadowboxing or Taiji, T'aichi or T'aichichuan/traditional form of physical exercise or relaxation/a martial art/
逃	táo	/to escape/to run away/to flee/
淘气	táoqì	/naughty/mischievous/
讨价还价	tǎojiàhuánjià	/to haggle over price/to bargain/
套	tào	/to cover/to encase/cover/sheath/to overlap/to interleave/to model after/to copy/formula/harness/loop of rope/(fig.) to fish for/to obtain slyly/classifier for sets, collections/bend (of a river or mountain range, in place names)/tau (Greek letter Ττ)/
特色	tèsè	/characteristic/distinguishing feature or quality/
提倡	tíchàng	/to promote/to advocate/
题目	tímù	/subject; title; topic (CL:個|个[ge4])/exercise or exam question (CL:道[dao4])/
体贴	tǐtiē	/considerate (of other people's needs)/
体验	tǐyàn	/to experience for oneself/
天空	tiānkōng	/sky/
天真	tiānzhēn	/naive/innocent/artless/
调整	tiáozhěng	/to adjust/adjustment/revision/CL:個|个[ge4]/
通常	tōngcháng	/regular; usual; normal/usually; normally/
统一	tǒngyī	/to unify; to integrate/unified; integrated/
痛快	tòngkuài	/delighted/to one's heart's content/straightforward/also pr. [tong4 kuai5]/
偷	tōu	/to steal/to pilfer/to snatch/thief/stealthily/
投资	tóuzī	/investment/to invest/
突出	tūchū	/prominent/outstanding/to give prominence to/to protrude/to project/
土豆	tǔdòu	/potato (CL:個|个[ge4])/(Tw) peanut (CL:顆|颗[ke1])/
兔子	tùzi	/hare/rabbit/CL:隻|只[zhi1]/
推辞	tuīcí	/to decline (an appointment, invitation etc)/
推荐	tuījiàn	/to recommend/recommendation/
退	tuì	/to retreat; to withdraw/to reject; to return (sth)/to decline/
退休	tuìxiū	/to retire (from the workforce); to go into retirement/
外公	wàigōng	/(coll.) mother's father/maternal grandfather/
完整	wánzhěng	/complete/intact/
玩具	wánjù	/plaything/toy/
万一	wànyī	/just in case/if by any chance/contingency/
威胁	wēixié	/to threaten; to menace/
维修	wéixiū	/maintenance (of equipment)/to protect and maintain/
围绕	wéirào	/to revolve around/to center on (an issue)/
尾巴	wěiba	/tail/colloquial pr. [yi3 ba5]/
委屈	wěiqu	/to feel wronged/to cause sb to feel wronged/grievance/
胃	wèi	/stomach/CL:個|个[ge4]/
位于	wèiyú	/to be located at/to be situated at/to lie/
未必	wèibì	/not necessarily/maybe not/
温柔	wēnróu	/gentle and soft; tender; sweet (commonly used to describe a girl or woman)/
文具	wénjù	/stationery/item of stationery (pen, pencil, eraser, pencil sharpener etc)/
文学	wénxué	/literature/CL:種|种[zhong3]/
稳定	wěndìng	/steady/stable/stability/to stabilize/to pacify/
问候	wènhòu	/to give one's respects/to send a greeting/(fig.) (coll.) to make offensive reference to (somebody dear to the person to whom one is speaking)/
卧室	wòshì	/bedroom/CL:間|间[jian1]/
无数	wúshù	/countless/numberless/innumerable/
勿	wù	/do not/
物质	wùzhì	/matter/substance/material/materialistic/CL:個|个[ge4]/
吸取	xīqǔ	/to absorb/to draw (a lesson, insight etc)/to assimilate/
系统	xìtǒng	/system/CL:個|个[ge4]/
戏剧	xìjù	/a drama; a play; theater/script of a play/
吓	xià	/to frighten/to scare/
夏令营	xiàlìngyíng	/summer camp/
下载	xiàzài	/to download/also pr. [xia4 zai4]/
显然	xiǎnrán	/clearly; evidently; obviously/
县	xiàn	/county/
现象	xiànxiàng	/phenomenon/CL:個|个[ge4],種|种[zhong3]/appearance/
香肠	xiāngcháng	/sausage/CL:根[gen1]/
相当	xiāngdāng	/equivalent to/appropriate/considerably/to a certain extent/fairly/quite/
相似	xiāngsì	/similar; alike/
想念	xiǎngniàn	/to miss/to remember with longing/to long to see again/
享受	xiǎngshòu	/to enjoy/to live it up/pleasure/CL:種|种[zhong3]/
项链	xiàngliàn	/necklace/CL:條|条[tiao2]/
象征	xiàngzhēng	/emblem/symbol/token/badge/to symbolize/to signify/to stand for/
消极	xiāojí	/negative/passive/inactive/
消失	xiāoshī	/to disappear; to fade away/
小气	xiǎoqi	/stingy/miserly/narrow-minded/petty/
孝顺	xiàoshun	/filial/dutiful/devoted to one's parents (and grandparents etc)/to show filial piety towards (an older family member)/filial piety/
斜	xié	/inclined/slanting/oblique/tilting/
写作	xiězuò	/to write/to compose/writing/written works/
心理	xīnlǐ	/psychology/mentality/
心脏	xīnzàng	/heart/CL:顆|颗[ke1],個|个[ge4]/
信任	xìnrèn	/to trust/to have confidence in/
行为	xíngwéi	/action/conduct/behavior/activity/
形容	xíngróng	/to describe/(literary) countenance; appearance/
形势	xíngshì	/circumstances/situation/terrain/CL:個|个[ge4]/
形状	xíngzhuàng	/form; shape/CL:個|个[ge4]/
幸运	xìngyùn	/fortunate/lucky/fortune/luck/
兄弟	xiōngdì	/brothers/younger brother/CL:個|个[ge4]/I, me (humble term used by men in public speech)/brotherly/fraternal/
虚心	xūxīn	/open-minded/humble/
宣布	xuānbù	/to declare/to announce/to proclaim/
学术	xuéshù	/learning/science/academic/CL:個|个[ge4]/
询问	xúnwèn	/to inquire/
训练	xùnliàn	/to train/to drill/training/CL:個|个[ge4]/
押金	yājīn	/deposit/down payment/
牙齿	yáchǐ	/tooth/dental/CL:顆|颗[ke1]/
宴会	yànhuì	/banquet/feast/dinner party/CL:席[xi2],個|个[ge4]/
痒	yǎng	/to itch/to tickle/
样式	yàngshì	/type/style/
腰	yāo	/waist/lower back/pocket/middle/loins/
咬	yǎo	/variant of 咬[yao3]/
夜	yè	/night/
业余	yèyú	/in one's spare time/outside working hours/amateur (historian etc)/
依然	yīrán	/still; as before/
一旦	yídàn	/in case (sth happens)/if/once (sth happens, then...)/when/in a short time/in one day/
一致	yízhì	/consistent; unanimous; in agreement/together; in unison/
一再	yízài	/repeatedly/
移民	yímín	/to immigrate/to migrate/emigrant/immigrant/
疑问	yíwèn	/question/interrogation/doubt/
以来	yǐlái	/since (a previous event)/
意外	yìwài	/unexpected/accident/mishap/CL:個|个[ge4]/
议论	yìlùn	/to comment/to talk about/to discuss/discussion/CL:個|个[ge4]/
义务	yìwù	/duty; obligation (CL:項|项[xiang4])/volunteer (work etc)/
因素	yīnsù	/element/factor/CL:個|个[ge4]/
英俊	yīngjùn	/handsome/
营养	yíngyǎng	/nutrition/nourishment/CL:種|种[zhong3]/
硬	yìng	/hard; stiff; solid/(fig.) strong; firm/resolutely; uncompromisingly/laboriously; with great difficulty/good (quality); able (person)/(of food) filling; substantial/
应付	yìngfu	/to deal with; to cope/
应用	yìngyòng	/to put to use; to apply/practical; applied (science, linguistics etc)/application; practical use/(computing) app/
拥挤	yōngjǐ	/crowded/to throng/congestion/
勇气	yǒngqì	/courage/valor/
用功	yònggōng	/diligent/industrious (in one's studies)/to study hard/to make great effort/
优惠	yōuhuì	/privilege/favorable (terms)/preferential (treatment)/discount (price)/
优势	yōushì	/superiority/dominance/advantage/
悠久	yōujiǔ	/long (tradition, history etc)/
油炸	yóuzhá	/to deep fry/
有利	yǒulì	/advantageous; favorable/
娱乐	yúlè	/to entertain/to amuse/entertainment/recreation/amusement/hobby/fun/joy/
预报	yùbào	/forecast/
预防	yùfáng	/to prevent/to take precautions against/to protect/to guard against/precautionary/prophylactic/
圆	yuán	/circle/round/circular/spherical/(of the moon) full/unit of Chinese currency (yuan)/tactful/to make consistent and whole (the narrative of a dream or a lie)/
元旦	uándàn	/New Year's Day/
员工	yuángōng	/staff; personnel; employee/
愿望	yuànwàng	/desire/wish/
晕	yūn	/dizzy/halo/ring around moon or sun/
运气	yùnqi	/luck (good or bad)/
运用	yùnyòng	/to use/to put to use/
灾害	zāihài	/calamity/disaster/CL:個|个[ge4]/
在乎	zàihu	/to rest with; to lie in; to be due to (a certain attribute)/(often used in the negative) to care about/
再三	zàisān	/over and over again/again and again/
赞成	zànchéng	/to approve/to endorse/(literary) to assist/
糟糕	zāogāo	/too bad/how terrible/what bad luck/terrible/bad/
造成	zàochéng	/to bring about; to create; to cause/
责备	zébèi	/to blame/to criticize/condemnation/reproach/
窄	zhǎi	/narrow/narrow-minded/badly off/
展开	zhǎnkāi	/to unfold; to spread out; to open up/to launch; to carry out/
掌握	zhǎngwò	/to grasp (often fig.)/to control/to seize (initiative, opportunity, destiny)/to master/to know well/to understand sth well and know how to use it/fluency/
账户	zhànghù	/bank account/online account/
珍惜	zhēnxī	/to treasure/to value/to cherish/
阵	zhèn	/disposition of troops/wave/spate/burst/spell/short period of time/classifier for events or states of short duration/
睁	zhēng	/to open (one's eyes)/
争取	zhēngqǔ	/to fight for/to strive for/to win over/
整个	zhěnggè	/whole/entire/total/
整齐	zhěngqí	/orderly/neat/even/tidy/
正	zhèng	/straight/upright/proper/main/principal/to correct/to rectify/exactly/just (at that time)/right (in that place)/(math.) positive/
政府	zhèngfǔ	/government/CL:個|个[ge4]/
证件	zhèngjiàn	/certificate; papers; credentials; document; ID/
支	zhī	/to support/to sustain/to erect/to raise/branch/division/to draw money/classifier for rods such as pens and guns, for army divisions and for songs or compositions/
支票	zhīpiào	/check (bank)/cheque/CL:本[ben3]/
指导	zhǐdǎo	/to guide/to give directions/to direct/to coach/guidance/tuition/CL:個|个[ge4]/
制定	zhìdìng	/to draw up; to formulate/
制造	zhìzào	/to manufacture; to make/
智慧	zhìhuì	/wisdom; intelligence/
秩序	zhìxù	/order (orderly)/order (sequence)/social order/the state (of society)/CL:個|个[ge4]/
中介	zhōngjiè	/to act as intermediary/to link/intermediate/inter-/agency/agent/
中旬	zhōngxún	/middle third of a month/
周到	zhōudào	/thoughtful/considerate/attentive/thorough/also pr. [zhou1 dao5]/
逐步	zhúbù	/progressively/step by step/
竹子	zhúzi	/bamboo/CL:棵[ke1],支[zhi1],根[gen1]/
主持	zhǔchí	/to take charge of/to manage or direct/to preside over/to uphold/to stand for (justice etc)/to host (a TV or radio program etc)/(TV) anchor/
主观	zhǔguān	/subjective/
主题	zhǔtí	/theme/subject/
主任	zhǔrèn	/director/head/CL:個|个[ge4]/
抓	zhuā	/to grab/to catch/to arrest/to snatch/to scratch/
专家	zhuānjiā	/expert; specialist/
专心	zhuānxīn	/to focus one's attention; to concentrate on (doing sth)/
转告	zhuǎngào	/to pass on/to communicate/to transmit/
装	zhuāng	/adornment/to adorn/dress/clothing/costume (of an actor in a play)/to play a role/to pretend/to install/to fix/to wrap (sth in a bag)/to load/to pack/
装修	zhuāngxiū	/to decorate/interior decoration/to fit up/to renovate/
状况	zhuàngkuàng	/condition; state; situation/CL:個|个[ge4]/
追	zhuī	/to chase/to pursue/to look into/to investigate/to reminisce/to recall/to court (one's beloved)/to binge-watch (a TV drama)/retroactively/posthumously/
资格	zīgé	/qualifications/seniority/
资料	zīliào	/material/resources/data/information/profile (Internet)/CL:份[fen4],個|个[ge4]/
姿势	zīshì	/posture/position/
紫	zǐ	/purple/violet/
字幕	zìmù	/caption/subtitle/
自动	zìdòng	/automatic/voluntarily/
自由	zìyóu	/freedom; liberty/free; unrestricted/CL:種|种[zhong3]/
综合	zōnghé	/comprehensive/composite/synthesized/mixed/to sum up/to integrate/to synthesize/
总共	zǒnggòng	/altogether; in sum; in all; in total/
总理	zǒnglǐ	/premier/prime minister/CL:個|个[ge4],位[wei4],名[ming2]/
总算	zǒngsuàn	/at long last/finally/on the whole/
总之	zǒngzhī	/in a word/in short/in brief/
组成	zǔchéng	/to form/to make up/to constitute/
组织	zǔzhī	/to organize/organization/(biology) tissue/(textiles) weave/CL:個|个[ge4]/
作文	zuòwén	/to write an essay/composition (student essay)/CL:篇[pian1]/
哎	āi	/hey!/(interjection used to attract attention or to express surprise or disapprobation)/
爱护	àihù	/to cherish/to treasure/to take care of/to love and protect/
爱惜	àixī	/to cherish/to treasure/to use sparingly/
安装	ānzhuāng	/to install/to erect/to fix/to mount/installation/
暗	àn	/(literary) to close (a door)/to eclipse/confused; ignorant (variant of 暗[an4])/dark (variant of 暗[an4])/
把握	bǎwò	/to grasp (also fig.)/to seize/to hold/assurance/certainty/sure (of the outcome)/
摆	bǎi	/to arrange/to exhibit/to move to and fro/a pendulum/
办理	bànlǐ	/to handle; to transact; to conduct/
傍晚	bàngwǎn	/in the evening/when night falls/towards evening/at night fall/at dusk/
包裹	bāoguǒ	/to wrap up/to bind up/bundle/parcel/package/CL:個|个[ge4]/
包括	bāokuò	/to comprise/to include/to involve/to incorporate/to consist of/
薄	báo	/see 薄荷[bo4 he5]/
宝贝	bǎobèi	/treasured object/treasure/darling/baby/cowry/good-for-nothing or queer character/
保持	bǎochí	/to keep/to maintain/to hold/to preserve/
保险	bǎoxiǎn	/insurance/to insure/safe/secure/be sure/be bound to/CL:份[fen4]/
抱怨	bàoyuàn	/to complain/to grumble/to harbor a complaint/to feel dissatisfied/
报道	bàodào	/to report (news)/report/CL:篇[pian1],份[fen4]/
报社	bàoshè	/newspaper (i.e. a company)/CL:家[jia1]/
背	bèi	/the back of a body or object/to turn one's back/to hide something from/to learn by heart/to recite from memory/unlucky (slang)/hard of hearing/
本质	běnzhì	/essence/nature/innate character/intrinsic quality/
彼此	bǐcǐ	/each other; one another/
毕竟	bìjìng	/after all/all in all/when all is said and done/in the final analysis/
避免	bìmiǎn	/to avert/to prevent/to avoid/to refrain from/
编辑	biānjí	/to edit/to compile/editor/compiler/
便	biàn	/used in 便宜|便宜[pian2 yi5]/used in 便便[pian2 pian2]/used in 便嬛[pian2 xuan1]/
标点	biāodiǎn	/punctuation/a punctuation mark/to punctuate/CL:個|个[ge4]/
表明	biǎomíng	/to make clear/to make known/to state clearly/to indicate/known/
病毒	bìngdú	/virus/
播放	bōfàng	/to broadcast; to transmit (by radio or TV)/
脖子	bózi	/neck/CL:個|个[ge4]/
不要紧	búyàojǐn	/unimportant/not serious/it doesn't matter/never mind/it looks all right, but/
布	bù	/cloth/to declare/to announce/to spread/to make known/
不安	bù’ān	/unpeaceful/unstable/uneasy/disturbed/restless/worried/
不得了	bùdéliǎo	/desperately serious/disastrous/extremely/exceedingly/
不如	bùrú	/not equal to; not as good as; inferior to/it would be better to/
步骤	bùzhòu	/procedure/step/
采访	cǎifǎng	/to interview/to gather news/to hunt for and collect/to cover/
彩虹	cǎihóng	/rainbow/CL:道[dao4]/
参与	cānyù	/to participate (in sth)/
惭愧	cánkuì	/ashamed/
操心	cāoxīn	/to worry about/
册	cè	/book/booklet/classifier for books/
测验	cèyàn	/test/to test/CL:次[ci4],個|个[ge4]/
曾经	céngjīng	/once/already/former/previously/ever/(past tense marker used before verb or clause)/
差距	chājù	/disparity/gap/
产品	chǎnpǐn	/goods/merchandise/product/CL:個|个[ge4]/
长途	chángtú	/long distance/
抄	chāo	/to make a copy/to plagiarize/to search and seize/to raid/to grab/to go off with/to take a shortcut/to make a turning move/to fold one's arms/
超级	chāojí	/super-/ultra-/hyper-/
朝	cháo	/morning/
炒	chǎo	/to sauté; to stir-fry/to speculate (in real estate etc); to scalp/to hype up/to sack; to fire (sb)/
吵架	chǎojià	/to quarrel/to have a row/quarrel/CL:頓|顿[dun4]/
车厢	chēxiāng	/carriage/CL:節|节[jie2]/
沉默	chénmò	/taciturn/uncommunicative/silent/
称呼	chēnghu	/to call; to address as/form of address; appellation/
承认	chéngrèn	/to admit/to concede/to recognize/recognition (diplomatic, artistic etc)/to acknowledge/
程度	chéngdù	/degree; level; extent/
成分	chéngfèn	/composition; ingredient; element; component/one's social status/CL:個|个[ge4]/
成果	chéngguǒ	/result/achievement/gain/profit/CL:個|个[ge4]/
成就	chéngjiù	/accomplishment/success/achievement/CL:個|个[ge4]/to achieve (a result)/to create/to bring about/
成熟	chéngshú	/mature; ripe/to mature; to ripen/Taiwan pr. [cheng2 shou2]/
成长	chéngzhǎng	/to mature/to grow/growth/
吃亏	chīkuī	/to suffer losses/to come to grief/to lose out/to get the worst of it/to be at a disadvantage/unfortunately/
迟早	chízǎo	/sooner or later/
池塘	chítáng	/pool/pond/
翅膀	chìbǎng	/wing/CL:個|个[ge4],對|对[dui4]/
充电器	chōngdiànqì	/battery charger/
充满	chōngmǎn	/full of/brimming with/very full/permeated/
抽屉	chōuti	/drawer/
臭	chòu	/sense of smell/smell bad/
出版	chūbǎn	/to publish/
出色	chūsè	/remarkable; outstanding/
初级	chūjí	/junior/primary/
传播	chuánbō	/to disseminate; to propagate; to spread/
传说	chuánshuō	/legend; folk tale/to repeat from mouth to mouth; they say that.../
窗帘	chuānglián	/window curtains/
创造	chuàngzào	/to create/to bring about/to produce/to set (a record)/
词汇	cíhuì	/vocabulary/list of words (e.g. for language teaching purposes)/word/
辞职	cízhí	/to resign/
刺激	cìjī	/to provoke; to irritate; to upset; to stimulate; to excite/irritant/
从此	cóngcǐ	/from now on/since then/henceforth/
从事	cóngshì	/to go for/to engage in/to undertake/to deal with/to handle/to do/
促进	cùjìn	/to promote (an idea or cause); to advance; boost/
催	cuī	/to urge/to press/to prompt/to rush sb/to hasten sth/to expedite/
存在	cúnzài	/to exist/to be/existence/
答应	dāying	/to answer; to respond/to answer positively; to agree; to accept; to promise/
达到	dádào	/to reach; to achieve; to attain/
打交道	dǎjiāodao	/to come into contact with/to have dealings/
打喷嚏	dǎpēntì	/to sneeze/
打听	dǎting	/to ask about/to make some inquiries/to ask around/
大方	dàfang	/generous/magnanimous/stylish/in good taste/easy-mannered/natural and relaxed/
大型	dàxíng	/large/large-scale/
呆	dāi	/foolish/stupid/expressionless/blank/to stay/
代替	dàitì	/to replace; to take the place of/
贷款	dàikuǎn	/a loan/CL:筆|笔[bi3]/to provide a loan (e.g. bank)/to raise a loan (from e.g. a bank)/
单纯	dānchún	/simple/pure/unsophisticated/merely/purely/
单独	dāndú	/alone/by oneself/on one's own/
单元	dānyuán	/unit (forming an entity)/element/(in a residential building) entrance or staircase/
胆小鬼	dǎnxiǎoguǐ	/coward/
当地	dāngdì	/local/
当心	dāngxīn	/to take care/to look out/
挡	dǎng	/variant of 擋|挡[dang3]/
岛屿	dǎoyǔ	/island/
导演	dǎoyǎn	/to direct/director (film etc)/
导致	dǎozhì	/to lead to; to create; to cause; to bring about/
到达	dàodá	/to reach; to arrive/
道德	dàodé	/virtue/morality/ethics/CL:種|种[zhong3]/
等待	děngdài	/to wait; to wait for/
的确	díquè	/really/indeed/
地道	dìdao	/authentic/genuine/proper/
地理	dìlǐ	/geography/
地区	dìqū	/local/regional/district (not necessarily formal administrative unit)/region/area/as suffix to city name, means prefecture or county (area administered by a prefecture-level city or, county-level city)/CL:個|个[ge4]/
地位	dìwèi	/position/status/place/CL:個|个[ge4]/
点心	diǎnxin	/light refreshments/pastry/dim sum (in Cantonese cooking)/dessert/
电台	diàntái	/transmitter-receiver/broadcasting station/radio station/CL:個|个[ge4],家[jia1]/
钓	diào	/to fish with a hook and bait/
洞	dòng	/cave/hole/zero (unambiguous spoken form when spelling out numbers)/CL:個|个[ge4]/
豆腐	dòufu	/tofu/bean curd/
独立	dúlì	/independent/independence/to stand alone/
断	duàn	/to break/to snap/to cut off/to give up or abstain from sth/to judge/(usu. used in the negative) absolutely/definitely/decidedly/
堆	duī	/to pile up/to heap up/a mass/pile/heap/stack/large amount/
对方	duìfāng	/the other person; the other side; the other party/
对象	duìxiàng	/target; object/partner; boyfriend; girlfriend/CL:個|个[ge4]/
兑换	duìhuàn	/to convert/to exchange/
蹲	dūn	/to crouch/to squat/to stay (somewhere)/
多余	duōyú	/superfluous/unnecessary/surplus/
躲藏	duǒcáng	/to conceal oneself/to go into hiding/to take cover/
恶劣	èliè	/vile/nasty/of very poor quality/
耳环	ěrhuán	/earring/CL:隻|只[zhi1],對|对[dui4]/
发愁	fāchóu	/to worry/to fret/to be anxious/to become sad/
发抖	fādǒu	/to tremble/to shake/to shiver/
发明	fāmíng	/to invent/an invention/CL:個|个[ge4]/
翻	fān	/variant of 翻[fan1]/
反复	fǎnfù	/repeatedly/over and over/to upend/unstable/to come and go/(of an illness) to return/
反映	fǎnyìng	/to mirror/to reflect/mirror image/reflection/(fig.) to report/to make known/to render/
方	fāng	/square/power or involution (math.)/upright/honest/fair and square/direction/side/party (to a contract, dispute etc)/place/method/prescription (medicine)/just when/only or just/classifier for square things/abbr. for square or cubic meter/
仿佛	fǎngfú	/to seem/as if/alike/similar/
非	fēi	/to not be; not/wrong; incorrect/non-; un-; in-; de-/to reproach; to blame/(coll.) to insist on; simply must/
废话	fèihuà	/nonsense; rubbish; superfluous words/You don't say!; No kidding! (gently sarcastic)/
分别	fēnbié	/to part; to leave each other/to distinguish; to tell apart/difference; distinction/in different ways; differently/separately; individually/
分配	fēnpèi	/to distribute/to assign/to allocate/to partition (a hard drive)/
分析	fēnxī	/to analyze/analysis/CL:個|个[ge4]/
纷纷	fēnfēn	/one after another/in succession/one by one/continuously/diverse/in profusion/numerous and confused/pell-mell/
奋斗	fèndòu	/to strive; to struggle/
风格	fēnggé	/style/
风俗	fēngsú	/social custom/CL:個|个[ge4]/
疯狂	fēngkuáng	/crazy; frenzied; wild/
否定	fǒudìng	/to negate/to deny/to reject/negative (answer)/negation/
幅	fú	/width/roll/classifier for textiles or pictures/
服装	fúzhuāng	/dress/clothing/costume/clothes/CL:身[shen1]/
辅导	fǔdǎo	/to give guidance/to mentor/to counsel/to coach/to tutor/
妇女	fùnǚ	/woman/
改革	gǎigé	/reform/CL:次[ci4],種|种[zhong3],項|项[xiang4]/to reform/
改善	gǎishàn	/to make better; to improve/CL:個|个[ge4]/
盖	gài	/lid/top/cover/canopy/to cover/to conceal/to build/
概念	gàiniàn	/concept/idea/CL:個|个[ge4]/
干脆	gāncuì	/candid/direct and to the point/simply/just/might as well/
干燥	gānzào	/(of weather, climate, soil etc) dry; arid/(of skin, mouth etc) dry/(fig.) dull; dry; boring/(of timber etc) to dry out; to season; to cure/
感激	gǎnjī	/to be grateful/to appreciate/thankful/
感受	gǎnshòu	/to sense/perception/to feel (through the senses)/to experience/a feeling/an impression/an experience/
赶紧	gǎnjǐn	/hurriedly/without delay/
钢铁	gāngtiě	/steel/
高档	gāodàng	/superior quality/high grade/top grade/
搞	gǎo	/to do/to make/to go in for/to set up/to get hold of/to take care of/
格外	géwài	/especially/particularly/
个别	gèbié	/individually; one by one/just one or two; exceptional; rare/
个性	gèxìng	/individuality/personality/
根	gēn	/root/basis/classifier for long slender objects, e.g. cigarettes, guitar strings/CL:條|条[tiao2]/radical (chemistry)/
公布	gōngbù	/to announce; to make public; to publish/
公元	gōngyuán	/CE (Common Era)/Christian Era/AD (Anno Domini)/
公主	gōngzhǔ	/princess/
工程师	gōngchéngshī	/engineer/CL:個|个[ge4],位[wei4],名[ming2]/
工人	gōngrén	/worker/CL:個|个[ge4],名[ming2]/
恭喜	gōngxǐ	/to congratulate/(interj.) congratulations!/
贡献	gòngxiàn	/to contribute/to dedicate/to devote/contribution/CL:個|个[ge4]/
构成	gòuchéng	/to constitute/to form/to compose/to make up/to configure (computing)/
姑姑	gūgu	/paternal aunt/CL:個|个[ge4]/
古典	gǔdiǎn	/classical/
鼓舞	gǔwǔ	/heartening (news)/to boost (morale)/CL:個|个[ge4]/
股票	gǔpiào	/share certificate/stock (finance)/
固定	gùdìng	/to fix/to fasten/to set rigidly in place/fixed/set/regular/
挂号	guàhào	/to register (at a hospital etc)/to send by registered mail/
拐弯	guǎiwān	/to go round a curve/to turn a corner/fig. a new direction/
官	guān	/government official/governmental/official/public/organ of the body/CL:個|个[ge4]/
关闭	guānbì	/to close; to shut (a window etc)/(of a shop, school etc) to shut down/
观点	guāndiǎn	/point of view/viewpoint/standpoint/CL:個|个[ge4]/
管子	guǎnzi	/tube/pipe/drinking straw/CL:根[gen1]/
光临	guānglín	/(formal) to honor with one's presence/to attend/
光盘	guāngpán	/compact disc (CD); DVD; CD-ROM/CL:片[pian4],張|张[zhang1]/
广场	guǎngchǎng	/public square; plaza/
广泛	guǎngfàn	/wide; broad; extensive; widespread/
规矩	guīju	/lit. compass and set square/fig. established standard/rule/customs/practices/fig. upright and honest/well-behaved/
规模	guīmó	/scale/scope/extent/CL:個|个[ge4]/
归纳	guīnà	/to sum up/to summarize/to conclude from facts/induction (method of deduction in logic)/
柜台	guìtái	/variant of 櫃檯|柜台[gui4 tai2]/
锅	guō	/pot; pan; wok; cauldron/pot-shaped thing/CL:口[kou3],隻|只[zhi1]/
国王	guówáng	/king/CL:個|个[ge4]/
果然	guǒrán	/really/sure enough/as expected/if indeed/
过分	guòfèn	/excessive/undue/overly/
过期	guòqī	/to be overdue/to exceed the time limit/to expire (as in expiration date)/
哈	hā	/a Pekinese; a pug/(dialect) to scold/
海关	hǎiguān	/customs (i.e. border crossing inspection)/CL:個|个[ge4]/
喊	hǎn	/to yell/to shout/to call out for (a person)/
行业	hángyè	/trade; profession; industry; business/
好客	hàokè	/hospitality/to treat guests well/to enjoy having guests/hospitable/friendly/
和平	hépíng	/peace/peaceful/
何况	hékuàng	/let alone/to say nothing of/besides/what's more/
合影	héyǐng	/to take a joint photo/group photo/
核心	héxīn	/core; nucleus/
后果	hòuguǒ	/consequences/aftermath/
忽然	hūrán	/suddenly; all of a sudden/
呼吸	hūxī	/to breathe/
蝴蝶	húdié	/butterfly/CL:隻|只[zhi1]/
胡同	hútòng	/variant of 胡同[hu2 tong4]/
华裔	huáyì	/ethnic Chinese/non-Chinese citizen of Chinese ancestry/
滑	huá	/to slip; to slide/slippery; smooth/sly; slippery; not to be trusted/
化学	huàxué	/chemistry/chemical/
缓解	huǎnjiě	/to bring relief/to alleviate (a crisis)/to dull (a pain)/
幻想	huànxiǎng	/to fantasize; to imagine/an illusion; a fantasy/
挥	huī	/to wave/to brandish/to command/to conduct/to scatter/to disperse/
灰尘	huīchén	/dust/
恢复	huīfù	/to reinstate/to resume/to restore/to recover/to regain/to rehabilitate/
汇率	huìlǜ	/exchange rate/
婚姻	hūnyīn	/marriage; matrimony/CL:樁|桩[zhuang1],次[ci4]/
火柴	huǒchái	/match (for lighting fire)/CL:根[gen1],盒[he2]/
激烈	jīliè	/(of competition or fighting) intense/fierce/(of pain) acute/(of an expression of opinion) impassioned/vehement/(of a course of action) drastic/extreme/
肌肉	jīròu	/muscle/flesh/
极其	jíqí	/extremely/
集体	jítǐ	/collective (decision)/joint (effort)/a group/a team/en masse/as a group/
急忙	jímáng	/hastily/
记录	jìlù	/to record/record (written account)/note-taker/record (in sports etc)/CL:個|个[ge4]/
计算	jìsuàn	/to count/to calculate/to compute/CL:個|个[ge4]/
系领带	jìlǐngdài	to tie a necktie; wear a tie
纪律	jìlǜ	/discipline/
寂寞	jìmò	/lonely/lonesome/(of a place) quiet/silent/
家庭	jiātíng	/family/household/CL:戶|户[hu4],個|个[ge4]/
家乡	jiāxiāng	/hometown/native place/CL:個|个[ge4]/
夹子	jiāzi	/clip/clamp/tongs/folder/wallet/
假设	jiǎshè	/to suppose/to presume/to assume/supposing that .../if/hypothesis/conjecture/
嫁	jià	/(of a woman) to marry/to marry off a daughter/to shift (blame etc)/
价值	jiàzhí	/value/worth/fig. values (ethical, cultural etc)/CL:個|个[ge4]/
肩膀	jiānbǎng	/shoulder/
坚决	jiānjué	/firm; resolute; determined/
艰巨	jiānjù	/arduous/terrible (task)/very difficult/formidable/
兼职	jiānzhí	/to hold concurrent posts/concurrent job/moonlighting/
简历	jiǎnlì	/curriculum vitae (CV)/résumé/biographical notes/
剪刀	jiǎndāo	/scissors/CL:把[ba3]/
建立	jiànlì	/to establish/to set up/to found/
讲究	jiǎngjiu	/to pay particular attention to/carefully selected for quality/tastefully chosen/
交际	jiāojì	/communication/social intercourse/
胶水	jiāoshuǐ	/glue/
狡猾	jiǎohuá	/crafty; cunning; sly/
教练	jiàoliàn	/instructor/sports coach/trainer/CL:個|个[ge4],位[wei4],名[ming2]/
接触	jiēchù	/to touch/to contact/access/in touch with/
接近	jiējìn	/to approach; to get close to/
阶段	jiēduàn	/stage/section/phase/period/CL:個|个[ge4]/
戒指	jièzhi	/(finger) ring/
金属	jīnshǔ	/metal/CL:種|种[zhong3]/
进口	jìnkǒu	/to import/imported/entrance/inlet (for the intake of air, water etc)/
尽力	jìnlì	/to strive one's hardest; to spare no effort/
精力	jīnglì	/energy/
经商	jīngshāng	/to trade/to carry out commercial activities/in business/
经营	jīngyíng	/to engage in (business etc); to run; to operate/
酒吧	jiǔbā	/bar/pub/saloon/CL:家[jia1]/
救护车	jiùhùchē	/ambulance/CL:輛|辆[liang4]/
居然	jūrán	/unexpectedly/to one's surprise/go so far as to/
具体	jùtǐ	/concrete; specific; detailed/
俱乐部	jùlèbù	/club (the organisation or its premises) (loanword)/CL:個|个[ge4]/
据说	jùshuō	/it is said that; reportedly/
捐	juān	/to relinquish; to abandon/to contribute; to donate/(bound form) tax; levy/
决心	juéxīn	/determination/resolution/determined/firm and resolute/to make up one's mind/CL:個|个[ge4]/
角色	juésè	/role; part (in a play or movie etc)/
均匀	jūnyún	/even/well-distributed/homogeneous/well-proportioned (figure, body etc)/
卡车	kǎchē	/truck/CL:輛|辆[liang4]/
开发	kāifā	/to exploit (a resource); to open up (for development); to develop/
开幕式	kāimùshì	/opening ceremony/
看望	kànwàng	/to pay a visit to; to see (sb)/
靠	kào	/to lean against or on/to stand by the side of/to come near to/to depend on/to trust/to fuck (vulgar)/traditional military costume drama where the performers wear armor (old)/
颗	kē	/classifier for small spheres, pearls, corn grains, teeth, hearts, satellites etc/
可靠	kěkào	/reliable/
课程	kèchéng	/course/academic program/CL:堂[tang2],節|节[jie2],門|门[men2]/
克服	kèfú	/(try to) overcome (hardships etc)/to conquer/to put up with/to endure/
刻苦	kèkǔ	/hardworking/assiduous/
空间	kōngjiān	/space; room/(fig.) scope; leeway/(astronomy) outer space/(physics, math.) space/
空闲	kòngxián	/leisure; spare time/(of a person) free; unoccupied/(of equipment, rooms etc) unoccupied; unused; idle; vacant; spare/
夸张	kuāzhāng	/to exaggerate/overstated; exaggerated/hyperbole/(coll.) excessive; ridiculous; outrageous/
会计	kuàijì	/accountant/accountancy/accounting/
宽	kuān	/wide/broad/loose/relaxed/lenient/
昆虫	kūnchóng	/insect/CL:隻|只[zhi1],群[qun2],堆[dui1]/
拦	lán	/to block sb's path/to obstruct/to flag down (a taxi)/
朗读	lǎngdú	/to read aloud/
劳驾	láojià	/excuse me/
老百姓	lǎobǎixìng	/ordinary people/the "person in the street"/CL:個|个[ge4]/
老实	lǎoshi	/honest; sincere/well-behaved/naive; gullible/
老婆	lǎopó	/(coll.) wife/
乐观	lèguān	/optimistic; hopeful/
雷	léi	/thunder/(bound form) (military) mine, as in 地雷[di4 lei2] land mine/(coll.) to shock; to stun; to astound/(Tw) (coll.) spoiler/(Tw) (coll.) to reveal plot details to (sb)/
类型	lèixíng	/type; kind; category/(computer programming) type/
冷淡	lěngdàn	/cold/indifferent/
梨	lí	/pear/CL:個|个[ge4]/
离婚	líhūn	/to divorce/
厘米	límǐ	/centimeter/
立即	lìjí	/immediately/
利润	lìrùn	/profits/
利益	lìyì	/benefit/(in sb's) interest/CL:個|个[ge4]/
连续	liánxù	/continuous/in a row/serial/consecutive/
恋爱	liàn’ài	/(romantic) love/CL:個|个[ge4],場|场[chang3]/in love/to have an affair/
良好	liánghǎo	/good/favorable/well/fine/
粮食	liángshi	/foodstuff/cereals/CL:種|种[zhong3]/
亮	liàng	/bright; light/to shine; to flash/loud and clear/to show (one's passport etc); to make public (one's views etc)/
铃	líng	/(small) bell/CL:隻|只[zhi1]/
零件	língjiàn	/part/component/
零食	língshí	/between-meal nibbles/snacks/
领导	lǐngdǎo	/lead/leading/to lead/leadership/leader/CL:位[wei4],個|个[ge4]/
流泪	liúlèi	/to shed tears/
陆续	lùxù	/in turn/successively/one after the other/bit by bit/
录音	lùyīn	/to record (sound)/sound recording/CL:個|个[ge4]/
轮流	lúnliú	/to alternate; to take turns/
逻辑	luóji	/logic (loanword)/
馒头	mántou	/steamed bun/
毛病	máobìng	/fault/defect/shortcomings/ailment/CL:個|个[ge4]/
矛盾	máodùn	/contradiction/CL:個|个[ge4]/conflicting views/contradictory/
贸易	màoyì	/(commercial) trade/CL:個|个[ge4]/
媒体	méitǐ	/media, esp. news media/
煤炭	méitàn	/coal/
魅力	mèilì	/charm/fascination/glamor/charisma/
梦想	mèngxiǎng	/(fig.) to dream of/dream/
蜜蜂	mìfēng	/bee/honeybee/CL:隻|只[zhi1],群[qun2]/
密切	mìqiè	/close/familiar/intimate/closely (related)/to foster close ties/to pay close attention/
秘书	mìshū	/secretary/
面积	miànjī	/area (of a floor, piece of land etc)/surface area/tract of land/
描写	miáoxiě	/to describe/to depict/to portray/description/
敏感	mǐngǎn	/sensitive/susceptible/
明星	míngxīng	/star; celebrity/
名片	míngpiàn	/(business) card/
命运	mìngyùn	/fate; destiny/CL:個|个[ge4]/
模仿	mófǎng	/to imitate/to copy/to emulate/to mimic/model/
模特	mótè	/(fashion) model (loanword)/
陌生	mòshēng	/strange/unfamiliar/
目前	mùqián	/at the present time/currently/
难怪	nánguài	/(it's) no wonder (that...)/(it's) not surprising (that)/
内部	nèibù	/interior/inside (part, section)/internal/
嗯	en	/interjection indicating approval, appreciation or agreement/
念	niàn	/to read/to study (a subject)/to attend (a school)/to read aloud/to give (sb) a tongue-lashing (CL:頓|顿[dun4])/to miss (sb)/idea/remembrance/twenty (banker's anti-fraud numeral corresponding to 廿[nian4])/
浓	nóng	/concentrated/dense/strong (smell etc)/
农民	nóngmín	/peasant; farmer/
欧洲	Ōuzhōu	/Europe (abbr. for 歐羅巴洲|欧罗巴洲[Ou1 luo2 ba1 Zhou1])/
偶然	ǒurán	/incidentally/occasional/occasionally/by chance/randomly/
拍	pāi	/to pat/to clap/to slap/to swat/to take (a photo)/to shoot (a film)/racket (sports)/beat (music)/
盼望	pànwàng	/to hope for; to look forward to/
培训	péixùn	/to cultivate/to train/to groom/training/
佩服	pèifu	/to admire/
盆	pén	/basin/flower pot/unit of volume equal to 12 斗[dou3] and 8 升[sheng1], approx 128 liters/CL:個|个[ge4]/
碰	pèng	/old variant of 碰[peng4]/
批	pī	/to ascertain/to act on/to criticize/to pass on/classifier for batches, lots, military flights/tier (for the ranking of universities and colleges)/
批准	pīzhǔn	/to approve; to ratify/
疲劳	píláo	/fatigue/wearily/weariness/weary/
匹	pǐ	/variant of 匹[pi3]/classifier for cloth: bolt/
片	piàn	/thin piece/flake/a slice/film/TV play/to slice/to carve thin/partial/incomplete/one-sided/classifier for slices, tablets, tract of land, area of water/classifier for CDs, movies, DVDs etc/used with numeral 一[yi1]: classifier for scenario, scene, feeling, atmosphere, sound etc/Kangxi radical 91/
飘	piāo	/to float (in the air); to flutter; to waft/complacent; frivolous/weak; shaky; wobbly/
频道	píndào	/frequency/(television) channel/
凭	píng	/to lean against/to rely on/on the basis of/no matter (how, what etc)/proof/
平安	píng’ān	/safe and sound/well/without mishap/quiet and safe/at peace/
平等	píngděng	/equal/equality/
平衡	pínghéng	/balance/equilibrium/
平均	píngjūn	/average; on average/evenly; in equal proportions/
破产	pòchǎn	/to go bankrupt/to become impoverished/bankruptcy/
迫切	pòqiè	/urgent; pressing/
期间	qījiān	/period of time/time/time period/period/CL:個|个[ge4]/
其余	qíyú	/the rest/the others/remaining/remainder/apart from them/
企业	qǐyè	/company; firm; enterprise; corporation/CL:家[jia1]/
前途	qiántú	/prospects/future outlook/journey/
欠	qiàn	/to owe/to lack/(literary) to be deficient in/(bound form) yawn/to raise slightly (a part of one's body)/
墙	qiáng	/wall (CL:面[mian4],堵[du3])/(slang) to block (a website) (usu. in the passive: 被牆|被墙[bei4 qiang2])/
强烈	qiángliè	/strong; intense/
切	qiē	/definitely; absolutely (not)/(scoffing or dismissive interjection) Yeah, right.; Tut!/to grind/(bound form) close to/(bound form) eager/to correspond to/(used to indicate that the fanqie 反切[fan3 qie4] system should be applied to the previous two characters)/
亲自	qīnzì	/personally/in person/oneself/
青	qīng	/green/blue/black/youth/young (of people)/
青少年	qīngshàonián	/adolescent/youth/teenager/
轻易	qīngyì	/easy; simple/rashly; offhandedly/
清淡	qīngdàn	/light (of food, not greasy or strongly flavored)/insipid/slack (sales)/
情景	qíngjǐng	/scene; spectacle/circumstances; situation/
情绪	qíngxù	/mood/state of mind/moodiness/CL:種|种[zhong3]/
庆祝	qìngzhù	/to celebrate/
娶	qǔ	/to take a wife/to marry (a woman)/
取消	qǔxiāo	/to cancel/cancellation/
圈	quān	/circle; ring; loop (CL:個|个[ge4])/classifier for loops, orbits, laps of race etc/to surround; to circle/
全面	quánmiàn	/all-around/comprehensive/total/overall/
权利	quánlì	/right (i.e. an entitlement to sth)/(classical) power and wealth/
确定	quèdìng	/definite/certain/fixed/to fix (on sth)/to determine/to be sure/to ensure/to make certain/to ascertain/to clinch/to recognize/to confirm/OK (on computer dialog box)/
热烈	rèliè	/enthusiastic/ardent/warm/
人口	rénkǒu	/population/people/
人民币	rénmínbì	/Renminbi (RMB)/Chinese Yuan (CNY)/
人事	rénshì	/personnel/human resources/human affairs/ways of the world/(euphemism) sexuality/the facts of life/
人员	rényuán	/staff/crew/personnel/CL:個|个[ge4]/
日常	rìcháng	/day-to-day; daily; everyday/
日期	rìqī	/date/CL:個|个[ge4]/
日子	rìzi	/day/a (calendar) date/days of one's life/
如今	rújīn	/nowadays; now/
软	ruǎn	/variant of 軟|软[ruan3]/
弱	ruò	/weak; feeble/young/inferior; not as good as/(following a decimal or fraction) slightly less than/
色彩	sècǎi	/tint; coloring; coloration/(fig.) flavor; character/
杀	shā	/to kill; to slay; to murder; to attack/to weaken; to reduce/(dialect) to smart/(used after a verb) extremely/
沙漠	shāmò	/desert/CL:個|个[ge4]/
傻	shǎ	/foolish/
删除	shānchú	/to delete/to cancel/
善良	shànliáng	/good and honest/kindhearted/
扇子	shànzi	/fan/CL:把[ba3]/
商业	shāngyè	/business/trade/commerce/
上当	shàngdàng	/taken in (by sb's deceit)/to be fooled/to be duped/
蛇	shé	/snake/serpent/CL:條|条[tiao2]/
设备	shèbèi	/equipment; facilities; installations/CL:個|个[ge4]/
设施	shèshī	/facilities/installation/
射击	shèjī	/to shoot; to fire (a gun)/
身材	shēncái	/stature/build (height and weight)/figure/
神话	shénhuà	/legend/fairy tale/myth/mythology/
升	shēng	/variant of 升[sheng1]/
生产	shēngchǎn	/to produce; to manufacture/to give birth to a child/
声调	shēngdiào	/tone/note/a tone (on a Chinese syllable)/CL:個|个[ge4]/
绳子	shéngzi	/cord; string; rope/CL:條|条[tiao2]/
省略	shěnglüè	/to leave out/an omission/
胜利	shènglì	/victory/CL:個|个[ge4]/
失去	shīqù	/to lose/
失业	shīyè	/unemployment/to lose one's job/
湿润	shīrùn	/moist/
时差	shíchā	/time difference/time lag/jet lag/
时刻	shíkè	/time/juncture/moment/period of time/CL:個|个[ge4],段[duan4]/constantly/always/
时期	shíqī	/period/phase/CL:個|个[ge4]/
实话	shíhuà	/truth/
实践	shíjiàn	/practice/to put into practice/to live up to (a promise)/to carry out (a project)/
实现	shíxiàn	/to achieve; to implement; to realize; to bring about/
实用	shíyòng	/practical/functional/pragmatic/applied (science)/
食物	shíwù	/food/CL:種|种[zhong3]/
士兵	shìbīng	/soldier/CL:個|个[ge4]/
似的	shìde	/seems as if/rather like/Taiwan pr. [si4 de5]/
事实	shìshí	/fact/CL:個|个[ge4]/
事先	shìxiān	/in advance/before the event/beforehand/prior/
收获	shōuhuò	/to harvest/to reap/to gain/crop/harvest/profit/gain/bonus/reward/
手套	shǒutào	/glove/mitten/CL:雙|双[shuang1],隻|只[zhi1]/
手指	shǒuzhǐ	/finger/CL:個|个[ge4],隻|只[zhi1]/
蔬菜	shūcài	/vegetables/CL:種|种[zhong3]/
舒适	shūshì	/cozy/snug/
梳子	shūzi	/comb/CL:把[ba3]/
属于	shǔyú	/to be classified as/to belong to/to be part of/
数	shǔ	/(literary) frequently; repeatedly/
甩	shuǎi	/to throw/to fling/to swing/to leave behind/to throw off/to dump (sb)/
说不定	shuōbudìng	/can't say for sure/maybe/
撕	sī	/to tear/
丝毫	sīháo	/the slightest amount or degree/a bit/
思考	sīkǎo	/to reflect on/to ponder over/
私人	sīrén	/private/personal/interpersonal/sb with whom one has a close personal relationship/a member of one's clique/
搜索	sōusuǒ	/to search (a place)/to search (a database)/to search for (sth)/
宿舍	sùshè	/dormitory/dorm room/living quarters/hostel/CL:間|间[jian1]/
随时	suíshí	/at any time; at all times/at the right time; whenever necessary/
随手	suíshǒu	/conveniently/without extra trouble/while doing it/in passing/
缩短	suōduǎn	/to curtail/to cut down/
所	suǒ	/actually/place/classifier for houses, small buildings, institutions etc/that which/particle introducing a relative clause or passive/CL:個|个[ge4]/
太太	tàitai	/married woman/Mrs./Madam/wife/CL:個|个[ge4],位[wei4]/
谈判	tánpàn	/to negotiate/negotiation/talks/conference/CL:個|个[ge4]/
坦率	tǎnshuài	/frank (discussion)/blunt/open/
烫	tàng	/to scald/to burn (by scalding)/to blanch (cooking)/to heat (sth) up in hot water/to perm/to iron/scalding hot/
桃	táo	/peach/
逃避	táobì	/to escape/to evade/to avoid/to shirk/
特殊	tèshū	/special/particular/unusual/extraordinary/
特征	tèzhēng	/characteristic/diagnostic property/distinctive feature/trait/
疼爱	téng’ài	/to love dearly/
提纲	tígāng	/outline/synopsis/notes/
提问	tíwèn	/to question; to quiz; to grill/
体会	tǐhuì	/to know from experience/to learn through experience/to realize/understanding/experience/
体现	tǐxiàn	/to embody/to reflect/to incarnate/
调皮	tiáopí	/naughty/mischievous/unruly/
挑战	tiǎozhàn	/to challenge/challenge/
痛苦	tòngkǔ	/pain/suffering/painful/CL:個|个[ge4]/
投入	tóurù	/to throw into/to put into/to throw oneself into/to participate in/to invest in/absorbed/engrossed/
透明	tòumíng	/transparent/(fig.) transparent; open to scrutiny/
土地	tǔdì	/local god/genius loci/
吐	tù	/to vomit/to throw up/
团	tuán	/dumpling/
推广	tuīguǎng	/to extend/to spread/to popularize/generalization/promotion (of a product etc)/
退步	tuìbù	/to do less well than before/to make a concession/setback/backward step/leeway/room to maneuver/fallback/
歪	wāi	/to sprain (one's ankle) (Tw)/
外交	wàijiāo	/diplomacy/diplomatic/foreign affairs/CL:個|个[ge4]/
完美	wánměi	/perfect/
完善	wánshàn	/(of systems, facilities etc) comprehensive/well-developed/excellent/to refine/to improve/
王子	wángzǐ	/prince/son of a king/
往返	wǎngfǎn	/to go back and forth; to go to and fro; to do a round trip/
网络	wǎngluò	/network (computing, telecommunications, transport etc)/
危害	wēihài	/to jeopardize/to harm/to endanger/harmful effect/damage/CL:個|个[ge4]/
微笑	wēixiào	/smile/CL:個|个[ge4],絲|丝[si1]/to smile/
违反	wéifǎn	/to violate (a law)/
围巾	wéijīn	/scarf/shawl/CL:條|条[tiao2]/
唯一	wéiyī	/only; sole/
伟大	wěidà	/huge; great; grand; worthy of the greatest admiration; important (contribution etc)/
胃口	wèikǒu	/appetite/liking/
位置	wèizhì	/position/place/seat/CL:個|个[ge4]/
未来	wèilái	/future/tomorrow/CL:個|个[ge4]/approaching/coming/pending/
温暖	wēnnuǎn	/warm/
闻	wén	/to hear/news/well-known/famous/reputation/fame/to smell/to sniff at/
文件	wénjiàn	/document/file/CL:份[fen4]/
文明	wénmíng	/civilized/civilization/culture/CL:個|个[ge4]/
文字	wénzì	/character/script/writing/written language/writing style/phraseology/CL:個|个[ge4]/
吻	wěn	/variant of 吻[wen3]/
握手	wòshǒu	/to shake hands/
屋子	wūzi	/house/room/CL:間|间[jian1]/
无奈	wúnài	/to have no alternative/frustrated/exasperated/helpless/(conjunction) but unfortunately/
无所谓	wúsuǒwèi	/to be indifferent/not to matter/cannot be said to be/
武术	wǔshù	/military skill or technique (in former times)/all kinds of martial art sports (some claiming spiritual development)/self-defense/tradition of choreographed fights from opera and film (recent usage)/also called kungfu 功夫/CL:種|种[zhong3]/
雾	wù	/fog/mist/CL:場|场[chang2],陣|阵[zhen4]/
物理	wùlǐ	/physics/
吸收	xīshōu	/to absorb/to assimilate/to ingest/to recruit/
系	xì	/to connect/to arrest/to worry/
细节	xìjié	/details; particulars/
瞎	xiā	/blind/groundlessly/foolishly/to no purpose/
鲜艳	xiānyàn	/bright-colored; gaily-colored/
显得	xiǎnde	/to seem/to look/to appear/
显示	xiǎnshì	/to show/to illustrate/to display/to demonstrate/
现代	xiàndài	/modern times/modern age/modern era/
现实	xiànshí	/reality; actuality/real; actual/realistic; pragmatic; materialistic; self-interested/
限制	xiànzhì	/to restrict/to limit/to confine/restriction/limit/CL:個|个[ge4]/
相处	xiāngchǔ	/to be in contact (with sb)/to associate/to interact/to get along (well, poorly)/
相对	xiāngduì	/relatively/opposite/to resist/to oppose/relative/vis-a-vis/counterpart/
相关	xiāngguān	/related/relevant/pertinent/to be interrelated/(statistics) correlation/
想象	xiǎngxiàng	/to imagine; to envision/imagination/
项	xiàng	/back of neck/item/thing/term (in a mathematical formula)/sum (of money)/classifier for principles, items, clauses, tasks, research projects etc/
项目	xiàngmù	/item/project/(sports) event/CL:個|个[ge4]/
象棋	xiàngqí	/Chinese chess/CL:副[fu4]/
消费	xiāofèi	/to consume (goods and services, resources etc)/
消化	xiāohuà	/to digest (food)/(fig.) to absorb (information etc); to assimilate; to process/
销售	xiāoshòu	/to sell/to market/sales (representative, agreement etc)/
小麦	xiǎomài	/wheat/CL:粒[li4]/
效率	xiàolǜ	/efficiency/
歇	xiē	/to rest/to take a break/to stop/to halt/(dialect) to sleep/a moment/a short while/
欣赏	xīnshǎng	/to appreciate; to enjoy; to admire/
信号	xìnhào	/signal/
行动	xíngdòng	/operation/action/CL:個|个[ge4]/to move about/mobile/
行人	xíngrén	/pedestrian/traveler on foot/passer-by/official responsible for arranging audiences with the emperor/
形成	xíngchéng	/to form; to take shape/
形式	xíngshì	/outer appearance/form/shape/formality/CL:個|个[ge4]/
形象	xíngxiàng	/image/form/figure/CL:個|个[ge4]/visualization/vivid/
性质	xìngzhì	/nature/characteristic/CL:個|个[ge4]/
幸亏	xìngkuī	/fortunately/luckily/
胸	xiōng	/chest/bosom/heart/mind/thorax/
修改	xiūgǎi	/to amend/to alter/to modify/
休闲	xiūxián	/leisure/relaxation/not working/idle/to enjoy leisure/to lie fallow/
叙述	xùshù	/to relate (a story or information)/to tell or talk about/to recount/narration/telling/narrative/account/
宣传	xuānchuán	/to disseminate/to give publicity to/propaganda/CL:個|个[ge4]/
学历	xuélì	/educational background/academic qualifications/
学问	xuéwen	/learning/knowledge/CL:個|个[ge4]/
血	xuè	/blood/colloquial pr. [xie3]/CL:滴[di1],片[pian4]/
寻找	xúnzhǎo	/to seek; to look for/
迅速	xùnsù	/rapid/speedy/fast/
延长	yáncháng	/to prolong/to extend/to delay/
严肃	yánsù	/solemn/grave/serious/earnest/severe/
演讲	yǎnjiǎng	/to give a lecture; to make a speech/
阳台	yángtái	/balcony/porch/
摇	yáo	/to shake/to rock/to row/to crank/
要不	yàobù	/otherwise/or else/how about...?/either... (or...)/
业务	yèwù	/business/professional work/service/CL:項|项[xiang4]/
一辈子	yíbèizi	/(for) a lifetime/
一律	yílǜ	/same/uniformly/all/without exception/
移动	yídòng	/to move/movement/migration/mobile/portable/
遗憾	yíhàn	/regret/to regret/to be sorry that/
乙	yǐ	/turning stroke (in Chinese characters), aka 折[zhe2]/
以及	yǐjí	/as well as/too/and/
亿	yì	/100 million/
意义	yìyì	/sense/meaning/significance/importance/CL:個|个[ge4]/
因而	yīn’ér	/therefore/as a result/thus/and as a result, .../
银	yín	/silver/silver-colored/relating to money or currency/
印刷	yìnshuā	/to print/printing/
英雄	yīngxióng	/hero/CL:個|个[ge4]/
迎接	yíngjiē	/to welcome; to greet/
营业	yíngyè	/to do business/to trade/
影子	yǐngzi	/shadow/reflection/(fig.) hint/indication/influence/CL:個|个[ge4]/
硬件	yìngjiàn	/hardware/
拥抱	yōngbào	/to embrace/to hug/
用途	yòngtú	/use; application/
优美	yōuměi	/graceful/fine/elegant/
游览	yóulǎn	/to go sightseeing/to tour/to visit/CL:次[ci4]/
犹豫	yóuyù	/to hesitate/
幼儿园	yòu’éryuán	/kindergarten/nursery school/
与其	yǔqí	/rather than... (used in expressions of the form 與其|与其[yu3qi2] + {verb1} + 不如[bu4ru2] + {verb2} "rather than {verb1}, better to {verb2}")/
语气	yǔqì	/tone/manner of speaking/mood/CL:個|个[ge4]/
预订	yùdìng	/to place an order/to book ahead/
玉米	yùmǐ	/corn/maize/CL:粒[li4]/
原料	yuánliào	/raw material/
原则	yuánzé	/principle/doctrine/CL:個|个[ge4]/
乐器	yuèqì	/musical instrument/CL:件[jian4]/
运输	yùnshū	/to transport/to carry/transportation/
在于	zàiyú	/to rest with; to lie in; to be due to (a certain attribute)/(of a matter) to be determined by; to be up to (sb)/
赞美	zànměi	/to admire/to praise/to eulogize/
则	zé	/(literary) (conjunction used to express contrast with a previous clause) but; then/(bound form) standard; norm/(bound form) principle/(literary) to imitate; to follow/classifier for written items/
摘	zhāi	/to take; to pick (flowers, fruit etc); to pluck; to remove; to take off (glasses, hat etc)/to select; to pick out/to borrow money at a time of urgent need/
粘贴	zhāntiē	/to stick/to affix/to adhere/to paste (as in "copy and paste")/Taiwan pr. [nian2 tie1]/also written 黏貼|黏贴[nian2 tie1]/
展览	zhǎnlǎn	/to put on display/to exhibit/exhibition/show/CL:個|个[ge4],次[ci4]/
占	zhàn	/to take possession of/to occupy/to take up/
战争	zhànzhēng	/war; conflict/CL:場|场[chang2],次[ci4]/
长辈	zhǎngbèi	/one's elders/older generation/
涨	zhǎng	/to swell/to distend/
招待	zhāodài	/to hold a reception; to offer hospitality; to entertain (guests); to serve (customers)/
着火	zháohuǒ	/to catch fire/
着凉	zháoliáng	/to catch cold/Taiwan pr. [zhao1 liang2]/
召开	zhàokāi	/to convene (a conference or meeting)/to convoke/to call together/
照常	zhàocháng	/as usual/
哲学	zhéxué	/philosophy/CL:個|个[ge4]/
真实	zhēnshí	/true; real/
针对	zhēnduì	/to target; to focus on; to be aimed at or against; in response to/
诊断	zhěnduàn	/to diagnose/
振动	zhèndòng	/to vibrate/to shake/vibration/
争论	zhēnglùn	/to argue/to debate/to contend/argument/contention/controversy/debate/CL:次[ci4],場|场[chang3]/
征求	zhēngqiú	/to solicit/to seek/to request (opinions, feedback etc)/to petition/
整体	zhěngtǐ	/whole entity/entire body/synthesis/as a whole (situation, construction, team etc)/global/macrocosm/integral/holistic/whole/
政治	zhèngzhì	/politics/political/
证据	zhèngjù	/evidence/proof/testimony/
挣	zhèng	/to struggle to get free/to strive to acquire/to make (money)/
直	zhí	/straight/to straighten/fair and reasonable/frank/straightforward/(indicates continuing motion or action)/vertical/vertical downward stroke in Chinese characters/
执照	zhízhào	/license; permit/
指挥	zhǐhuī	/to conduct/to command/to direct/conductor (of an orchestra)/CL:個|个[ge4]/
制度	zhìdù	/system (e.g. political, adminstrative etc)/institution/CL:個|个[ge4]/
制作	zhìzuò	/to make; to manufacture/
至今	zhìjīn	/so far/to this day/until now/
至于	zhìyú	/as for/as to/to go so far as to/
治疗	zhìliáo	/to treat (an illness)/medical treatment/therapy/
志愿者	zhìyuànzhě	/volunteer/
中心	zhōngxīn	/center; heart; core/
种类	zhǒnglèi	/kind/genus/type/category/variety/species/sort/class/
重大	zhòngdà	/great/important/major/significant/
重量	zhòngliàng	/weight/CL:個|个[ge4]/
猪	zhū	/hog/pig/swine/CL:口[kou3],頭|头[tou2]/
逐渐	zhújiàn	/gradually/
煮	zhǔ	/to cook/to boil/
主动	zhǔdòng	/to take the initiative/to do sth of one's own accord/spontaneous/active/opposite: passive 被動|被动[bei4 dong4]/drive (of gears and shafts etc)/
主人	zhǔrén	/master/host/owner/CL:個|个[ge4]/
主席	zhǔxí	/chairperson/premier/chairman/CL:個|个[ge4],位[wei4]/
主张	zhǔzhāng	/to advocate/to stand for/view/position/stand/proposition/viewpoint/assertion/CL:個|个[ge4]/
祝福	zhùfú	/blessings/to wish sb well/
注册	zhùcè	/to register/to enroll/
抓紧	zhuājǐn	/to keep a firm grip on/to pay close attention to/to lose no time in (doing sth)/
转变	zhuǎnbiàn	/to change/to transform/shift/transformation/CL:個|个[ge4]/
装饰	zhuāngshì	/to decorate/decoration/decorative/ornamental/
撞	zhuàng	/to knock against/to bump into/to run into/to meet by accident/
状态	zhuàngtài	/condition; state; state of affairs/CL:個|个[ge4]/
追求	zhuīqiú	/to pursue (a goal etc) stubbornly/to seek after/to woo/
资金	zījīn	/funds; capital/
资源	zīyuán	/natural resource (such as water or minerals)/resource (such as manpower or tourism)/
咨询	zīxún	/to consult/to seek advice/consultation/(sales) inquiry (formal)/
字母	zìmǔ	/letter (of the alphabet)/CL:個|个[ge4]/
自从	zìcóng	/since (a time)/ever since/
自豪	zìháo	/proud (of one's achievements etc)/
自觉	zìjué	/conscious/aware/on one's own initiative/conscientious/
自私	zìsī	/selfish/selfishness/
自愿	zìyuàn	/voluntary/
总裁	zǒngcái	/chairman/director-general (of a company etc)/
总统	zǒngtǒng	/president (of a country)/CL:個|个[ge4],位[wei4],名[ming2],屆|届[jie4]/
组	zǔ	/to form/to organize/group/team/classifier for sets, series, groups of people, batteries/
组合	zǔhé	/to assemble; to combine; to compose/combination; association; set; compilation/(math.) combinatorial/
阻止	zǔzhǐ	/to prevent/to block/
醉	zuì	/intoxicated/
最初	zuìchū	/first/primary/initial/original/at first/initially/originally/
尊敬	zūnjìng	/to respect; to revere; to esteem/honorable; distinguished (used on formal occasions before a term of address)/
遵守	zūnshǒu	/to comply with; to abide by; to respect (an agreement)/
作品	zuòpǐn	/work (of art)/opus/CL:部[bu4],篇[pian1]/
作为	zuòwéi	/one's conduct/deed/activity/accomplishment/achievement/to act as/as (in the capacity of)/qua/to view as/to look upon (sth as)/to take sth to be/
