挨	ái	/to suffer; to endure/to pull through (hard times)/to delay; to stall; to play for time; to dawdle/
癌症	áizhèng	/cancer/
爱不释手	àibúshìshǒu	/(idiom) to like sth so much that one is reluctant to put it down; to find sth utterly irresistible/
爱戴	àidài	/to love and respect/love and respect/
暧昧	àimèi	/vague/ambiguous/equivocal/dubious/
安宁	ānníng	/peaceful/tranquil/calm/composed/free from worry/
安详	ānxiáng	/serene/
安置	ānzhì	/to find a place for/to help settle down/to arrange for/to get into bed/placement/
暗示	ànshì	/to hint; to suggest/hint; suggestion/
案件	ànjiàn	/case/instance/CL:宗[zong1],樁|桩[zhuang1],起[qi3]/
案例	ànlì	/case (of fraud, hepatitis, international cooperation etc); instance; example/CL:個|个[ge4]/
按摩	ànmó	/massage/to massage/
昂贵	ángguì	/expensive/costly/
凹凸	āotū	/concave or convex/bumps and holes/uneven (surface)/rugged/
熬	áo	/to cook on a slow fire; to extract by heating; to decoct/to endure/
奥秘	àomì	/secret/mystery/
扒	bā	/to rake up/to steal/to braise/to crawl/
疤	bā	/scar/scab/
巴不得	bābude	/(coll.) to be eager for/to long for/to look forward to/
巴结	bājié	/to fawn on/to curry favor with/to make up to/
拔苗助长	bámiáozhùzhǎng	/to spoil things through excessive enthusiasm (idiom)/
把关	bǎguān	/to guard a pass/to check on sth/
把手	bǎshou	/handle/grip/knob/
霸道	bàdào	/the Way of the Hegemon/abbr. for 霸王之道/despotic rule/rule by might/evil as opposed to the Way of the King 王道/overbearing/tyranny/(of liquor, medicine etc) strong/potent/
罢工	bàgōng	/a strike/to go on strike/
掰	bāi	/to break off or break open sth with one's hands/(fig.) to break off (a relationship)/
摆脱	bǎituō	/to break away from/to cast off (old ideas etc)/to get rid of/to break away (from)/to break out (of)/to free oneself from/to extricate oneself/
拜访	bàifǎng	/to pay a visit; to call on/
拜年	bàinián	/to pay a New Year call/to wish sb a Happy New Year/
拜托	bàituō	/to request sb to do sth/please!/
败坏	bàihuài	/to ruin/to corrupt/to undermine/
斑	bān	/spot/colored patch/stripe/spotted/striped/variegated/
颁布	bānbù	/to issue/to proclaim/to enact (laws, decrees etc)/
颁发	bānfā	/to issue/to promulgate/to award/
版本	bǎnběn	/version/edition/release/
半途而废	bàntú’érfèi	/to give up halfway (idiom); leave sth unfinished/
伴侣	bànlǚ	/companion/mate/partner/
伴随	bànsuí	/to accompany/to follow/to occur together with/concomitant/
扮演	bànyǎn	/to play the role of/to act/
绑架	bǎngjià	/to kidnap/to abduct/to hijack/a kidnapping/abduction/staking/
榜样	bǎngyàng	/example/model/CL:個|个[ge4]/
磅	bàng	/used in 磅礴[pang2 bo2]/Taiwan pr. [pang1]/
包庇	bāobì	/to shield/to harbor/to cover up/
包袱	bāofu	/wrapping cloth/a bundle wrapped in cloth/load/weight/burden/funny part/punchline/
包围	bāowéi	/to surround/to encircle/to hem in/
包装	bāozhuāng	/to pack/to package/to wrap/packaging/
饱和	bǎohé	/saturated; filled to capacity/
饱经沧桑	bǎojīngcāngsāng	/having lived through many changes/
保管	bǎoguǎn	/to hold in safekeeping; to have in one's care/to guarantee/certainly; surely/custodian; curator/
保密	bǎomì	/to keep sth confidential/to maintain secrecy/
保姆	bǎomǔ	/nanny/housekeeper/
保守	bǎoshǒu	/conservative/to guard/to keep/
保卫	bǎowèi	/to defend/to safeguard/
保养	bǎoyǎng	/to take good care of (or conserve) one's health/to keep in good repair/to maintain/maintenance/
保障	bǎozhàng	/to ensure/to guarantee/to safeguard/
保重	bǎozhòng	/to take care of oneself/
抱负	bàofù	/aspiration/ambition/
报仇	bàochóu	/to take revenge/to avenge/
报酬	bàochou	/reward/remuneration/
报答	bàodá	/to repay/to requite/
报复	bàofù	/to make reprisals; to retaliate/revenge; retaliation/
报警	bàojǐng	/to sound an alarm/to report sth to the police/
报销	bàoxiāo	/to submit an expense account/to apply for reimbursement/to write off/to wipe out/
爆发	bàofā	/to break out/to erupt/to explode/to burst out/
爆炸	bàozhà	/explosion/to explode/to blow up/to detonate/
曝光	bàoguāng	/to expose (photography)/(fig.) to expose (a scandal)/(advertising) exposure/Taiwan pr. [pu4 guang1]/
暴力	bàolì	/violence/force/violent/
暴露	bàolù	/to expose/to reveal/to lay bare/also pr. [pu4 lu4]/
悲哀	bēi’āi	/grieved/sorrowful/
悲惨	bēicǎn	/miserable/tragic/
卑鄙	bēibǐ	/base/mean/contemptible/despicable/
北极	běijí	/the North Pole; the Arctic Pole/the north magnetic pole/
被动	bèidòng	/passive/
被告	bèigào	/defendant/
背叛	bèipàn	/to betray/
背诵	bèisòng	/to recite/to repeat from memory/
备份	bèifèn	/backup/
备忘录	bèiwànglù	/memorandum/aide-memoire/memorandum book/
贝壳	bèikè	/shell (of a mollusk)/
奔波	bēnbō	/to rush about/to be constantly on the move/
奔驰	bēnchí	/to run quickly/to speed/to gallop/
本能	běnnéng	/instinct/
本钱	běnqián	/capital/(fig.) asset; advantage; the means (to do sth)/
本人	běnrén	/I; me; myself/oneself; yourself; himself; herself; the person concerned/
本身	běnshēn	/itself/in itself/per se/
本事	běnshi	/ability/skill/
笨拙	bènzhuō	/clumsy/awkward/stupid/
崩溃	bēngkuì	/to collapse; to crumble; to fall apart/
甭	béng	/(dialect) very/
蹦	bèng	/to jump; to bounce; to hop/
迸发	bèngfā	/to burst forth/
逼迫	bīpò	/to force/to compel/to coerce/
鼻涕	bítì	/nasal mucus; snivel; snot/
比方	bǐfāng	/analogy/instance/for instance/
比喻	bǐyù	/to compare/to liken to/metaphor/analogy/figure of speech/figuratively/
比重	bǐzhòng	/proportion/specific gravity/
鄙视	bǐshì	/to despise/to disdain/to look down upon/
臂	bì	/arm/
弊病	bìbìng	/malady/evil/malpractice/drawback/disadvantage/
弊端	bìduān	/systemic problem (sometimes refers specifically to corrupt practices)/
闭塞	bìsè	/to stop up/to close up/hard to get to/out of the way/inaccessible/unenlightened/blocking/
鞭策	biāncè	/to spur on/to urge on/to encourage sb (e.g. to make progress)/
编织	biānzhī	/to weave; to knit; to plait; to braid/(fig.) to create (sth abstract, e.g. a dream, a lie etc)/
边疆	biānjiāng	/border area/borderland/frontier/frontier region/
边界	biānjiè	/boundary/border/
边境	biānjìng	/frontier; border/
边缘	biānyuán	/edge; fringe; verge; brink; periphery/marginal; borderline/
扁	biǎn	/small boat/
贬低	biǎndī	/to belittle/to disparage/to play down/to demean/to degrade/to devalue/
贬义	biǎnyì	/derogatory sense/negative connotation/
遍布	biànbù	/to cover the whole (area)/to be found throughout/
便利	biànlì	/convenient/easy/to facilitate/
便条	biàntiáo	/(informal) note/CL:張|张[zhang1],個|个[ge4]/
便于	biànyú	/easy to; convenient for/
变故	biàngù	/an unforeseen event/accident/misfortune/
变迁	biànqiān	/changes/vicissitudes/
变质	biànzhì	/to degenerate; to deteriorate/(of food) to go bad; to go off/(geology) metamorphism/
辩护	biànhù	/to speak in defense of/to argue in favor of/to defend/to plead/
辩解	biànjiě	/to explain/to justify/to defend (a point of view etc)/to provide an explanation/to try to defend oneself/
辩证	biànzhèng	/to investigate/dialectical/
辨认	biànrèn	/to recognize/to identify/
辫子	biànzi	/plait/braid/pigtail/a mistake or shortcoming that may be exploited by an opponent/handle/CL:根[gen1],條|条[tiao2]/
标本	biāoběn	/specimen; sample/the root cause and symptoms of a disease/
标记	biāojì	/sign/mark/symbol/to mark up/(computing) token/
标题	biāotí	/title/heading/headline/caption/subject/
表决	biǎojué	/to decide by vote/to vote/
表态	biǎotài	/to declare one's position/to say where one stands/
表彰	biǎozhāng	/to honor/to commend/to cite (in dispatches)/
憋	biē	/to choke/to stifle/to restrain/to hold back/to hold in (urine)/to hold (one's breath)/
别墅	biéshù	/villa/CL:幢[zhuang4],座[zuo4]/
别致	biézhì	/variant of 別緻|别致[bie2 zhi4]/
别扭	bièniu	/awkward/difficult/uncomfortable/not agreeing/at loggerheads/gauche/
濒临	bīnlín	/on the edge of/(fig.) on the verge of/close to/
冰雹	bīngbáo	/hail/hailstone/CL:場|场[chang2],粒[li4]/
丙	bǐng	/third of the ten Heavenly Stems 十天干[shi2 tian1 gan1]/third in order/letter "C" or Roman "III" in list "A, B, C", or "I, II, III" etc/ancient Chinese compass point: 165°/propyl/
并非	bìngfēi	/really isn't/
并列	bìngliè	/to stand side by side/to be juxtaposed/
拨	bō	/to push aside with the hand, foot, a stick etc/to dial/to allocate/to set aside (money)/to poke (the fire)/to pluck (a string instrument)/to turn round/classifier: group, batch/
播种	bōzhòng	/to grow (maize etc) from seed/to plant (maize etc) by sowing seed/
波浪	bōlàng	/wave/
波涛	bōtāo	/great waves/billows/
剥削	bōxuē	/to exploit/exploitation/
博大精深	bódàjīngshēn	/wide-ranging and profound/broad and deep/
博览会	bólǎnhuì	/exposition/international fair/
搏斗	bódòu	/to wrestle; to fight; to struggle/
伯母	bómǔ	/wife of father's elder brother/aunt/(polite form of address for a woman who is about the age of one's mother)/CL:個|个[ge4]/
薄弱	bóruò	/weak; frail/
不顾	búgù	/in spite of; regardless of/
不愧	búkuì	/to be worthy of/to deserve to be called/to prove oneself to be/
不料	búliào	/unexpectedly/to one's surprise/
不像话	búxiànghuà	/unreasonable/shocking/outrageous/
不屑一顾	búxièyígù	/to disdain as beneath contempt (idiom)/
补偿	bǔcháng	/to compensate/to make up/
补救	bǔjiù	/to remedy/
补贴	bǔtiē	/to subsidize/subsidy/allowance/to supplement (one's salary etc)/benefit/
哺乳	bǔrǔ	/breastfeeding/to suckle/to nurse/
捕捉	bǔzhuō	/to catch; to seize; to capture/
不得已	bùdéyǐ	/to act against one's will/to have no alternative but to/to have to/to have no choice/must/
不妨	bùfáng	/there is no harm in; might as well/
不敢当	bùgǎndāng	/lit. I dare not (accept the honor); fig. I don't deserve your praise/you flatter me/
不禁	bùjīn	/can't help (doing sth)/can't refrain from/
不堪	bùkān	/cannot bear/cannot stand/utterly/extremely/
不可思议	bùkěsīyì	/inconceivable (idiom); unimaginable/unfathomable/
不免	bùmiǎn	/inevitably/
不时	bùshí	/from time to time/now and then/occasionally/frequently/
不惜	bùxī	/not stint/not spare/not hesitate (to do sth)/not scruple (to do sth)/
不相上下	bùxiāngshàngxià	/equally matched/about the same/
不言而喻	bùyán’éryù	/it goes without saying; it is self-evident/
不由得	bùyóude	/can't help/cannot but/
不择手段	bùzéshǒuduàn	/by fair means or foul/by hook or by crook/unscrupulously/
不止	bùzhǐ	/incessantly/without end/more than/not limited to/
布告	bùgào	/posting on a bulletin board/notice/bulletin/to announce/
布局	bùjú	/arrangement/composition/layout/opening (chess jargon)/
布置	bùzhì	/to put in order/to arrange/to decorate/to fix up/to deploy/
步伐	bùfá	/pace/(measured) step/march/
部署	bùshǔ	/to dispose/to deploy/deployment/
部位	bùwèi	/part (esp. of the body, but also of a vegetable, e.g. the root, or a garment, e.g. the sleeve, etc)/
才干	cáigàn	/ability/competence/
财富	cáifù	/wealth/riches/
财务	cáiwù	/financial affairs/
财政	cáizhèng	/finances (public)/financial/
裁缝	cáifeng	/tailor/dressmaker/
裁判	cáipàn	/(law) to judge; to adjudicate; verdict; judgement/(sports) to referee/(sports) umpire; referee; judge/
裁员	cáiyuán	/to cut staff/to lay off employees/
采购	cǎigòu	/to procure (for an enterprise etc)/to purchase/
采集	cǎijí	/to gather/to collect/to harvest/
采纳	cǎinà	/to accept/to adopt/
彩票	cǎipiào	/lottery ticket/
参谋	cānmóu	/staff officer/to give advice/
参照	cānzhào	/to consult a reference/to refer to (another document)/
残疾	cánjí	/disabled/handicapped/deformity on a person or animal/
残酷	cánkù	/cruel/cruelty/
残留	cánliú	/to remain; to be left over/residual; remnant/residue/
残忍	cánrěn	/cruel/mean/merciless/ruthless/
灿烂	cànlàn	/to glitter/brilliant/splendid/
舱	cāng	/cabin/the hold of a ship or airplane/
苍白	cāngbái	/pale/wan/
仓促	cāngcù	/all of a sudden/hurriedly/
仓库	cāngkù	/depot/storehouse/warehouse/
操劳	cāoláo	/to work hard/to look after/
操练	cāoliàn	/drill/practice/
操纵	cāozòng	/to operate/to control/to rig/to manipulate/
操作	cāozuò	/to work/to operate/to manipulate/
嘈杂	cáozá	/noisy/clamorous/
草案	cǎo’àn	/draft (legislation, proposal etc)/
草率	cǎoshuài	/careless/negligent/sloppy/not serious/
策划	cèhuà	/to plot/to scheme/to bring about/to engineer/planning/producer/planner/
策略	cèlüè	/strategy; tactics/crafty; adroit/
测量	cèliáng	/survey/to measure/to gauge/to determine/
侧面	cèmiàn	/lateral side/side/aspect/profile/
层出不穷	céngchūbùqióng	/more and more emerge/innumerable succession/breeding like flies (idiom)/
层次	céngcì	/layer/level/gradation/arrangement of ideas/(a person's) standing/
插座	chāzuò	/socket/outlet/
差别	chābié	/difference; distinction; disparity/
查获	cháhuò	/to track down and seize (a criminal suspect, contraband etc)/
岔	chà	/fork in road/bifurcation/branch in road, river, mountain range etc/to branch off/to turn off/to diverge/to stray (from the path)/to change the subject/to interrupt/to stagger (times)/
刹那	chànà	/an instant (Sanskrit: ksana); split second; the twinkling of an eye/
诧异	chàyì	/flabbergasted/astonished/
柴油	cháiyóu	/diesel fuel/
搀	chān	/to take by the arm and assist/to mix/to blend/to dilute/to adulterate/
馋	chán	/gluttonous/greedy/to have a craving/
缠绕	chánrào	/twisting/to twine/to wind/to pester/to bother/
产业	chǎnyè	/industry/estate/property/industrial/
阐述	chǎnshù	/to expound (a position)/to elaborate (on a topic)/to treat (a subject)/
颤抖	chàndǒu	/to shudder/to shiver/to shake/to tremble/
昌盛	chāngshèng	/prosperous/
尝试	chángshì	/to try; to attempt/CL:次[ci4]/
偿还	chánghuán	/to repay/to reimburse/
场合	chǎnghé	/situation/occasion/context/setting/location/venue/
场面	chǎngmiàn	/scene/spectacle/occasion/situation/
场所	chǎngsuǒ	/location/place/
敞开	chǎngkāi	/to open wide/unrestrictedly/
倡导	chàngdǎo	/to advocate/to initiate/to propose/to be a proponent of (an idea or school of thought)/
倡议	chàngyì	/to suggest/to initiate/proposal/initiative/
畅通	chàngtōng	/unimpeded/free-flowing/straight path/unclogged/move without obstruction/
畅销	chàngxiāo	/to sell well/bestselling; chart-topping/
超越	chāoyuè	/to surpass; to exceed; to transcend/
钞票	chāopiào	/paper money/a bill (e.g. 100 yuan)/CL:張|张[zhang1],紮|扎[za1]/
朝代	cháodài	/dynasty/reign (of a king)/
潮流	cháoliú	/tide/current/trend/
嘲笑	cháoxiào	/to jeer at/to deride/to ridicule/mockery/derision/
巢穴	cháoxué	/lair/nest/den/hideout/
撤退	chètuì	/to retreat/
撤销	chèxiāo	/to repeal/to revoke/(computing) to undo/
沉淀	chéndiàn	/(chemistry) to settle; to precipitate/(chemistry) sediment; precipitate/(fig.) to accumulate/
沉闷	chénmèn	/oppressive (of weather)/heavy/depressed/not happy/(of sound) dull/muffled/
沉思	chénsī	/to contemplate/to ponder/contemplation/meditation/
沉重	chénzhòng	/heavy/hard/serious/critical/
沉着	chénzhuó	/steady/calm and collected/not nervous/
陈旧	chénjiù	/old-fashioned/
陈列	chénliè	/to display; to exhibit/
陈述	chénshù	/an assertion/to declare/to state/
衬托	chèntuō	/to serve to highlight; to serve as a backdrop or contrasting element/
称心如意	chènxīnrúyì	/(idiom) after one's own heart; gratifying; satisfactory; everything one could wish/
称号	chēnghào	/name/term of address/title/
盛	chéng	/flourishing/vigorous/magnificent/extensively/
橙	chéng	/orange tree/orange (color)/
乘	chéng	/old variant of 乘[cheng2]/
承办	chéngbàn	/to undertake/to accept a contract/
承包	chéngbāo	/to contract/to undertake (a job)/
承诺	chéngnuò	/to promise/to undertake to do something/commitment/
城堡	chéngbǎo	/castle/rook (chess piece)/
成本	chéngběn	/(manufacturing, production etc) costs/
成交	chéngjiāo	/to complete a contract/to reach a deal/
成天	chéngtiān	/(coll.) all day long/all the time/
成效	chéngxiào	/effect/result/
成心	chéngxīn	/intentionally; deliberately; on purpose/
成员	chéngyuán	/member/
惩罚	chéngfá	/penalty/punishment/to punish/
诚挚	chéngzhì	/sincere/cordial/
澄清	chéngqīng	/to settle (of liquid)/to become clear (by precipitation of impurities)/precipitate (chemistry)/to put in order/to quell disturbances/
呈现	chéngxiàn	/to appear/to emerge/to present (a certain appearance)/to demonstrate/
秤	chèng	/steelyard/Roman balance/CL:臺|台[tai2]/
吃苦	chīkǔ	/to bear hardships/
吃力	chīlì	/to entail strenuous effort/to toil at a task/strenuous/laborious/strain/
迟钝	chídùn	/slow in one's reactions/sluggish (in movement or thought)/
迟缓	chíhuǎn	/slow/sluggish/
迟疑	chíyí	/to hesitate/
持久	chíjiǔ	/lasting/enduring/persistent/permanent/protracted/endurance/persistence/to last long/
赤道	chìdào	/equator (of the earth or a celestial body)/celestial equator/
赤字	chìzì	/(financial) deficit/red letter/
冲动	chōngdòng	/to have an urge/to be impetuous/impulse/urge/
冲击	chōngjī	/to attack/to batter/(of waves) to pound against/shock/impact/
冲突	chōngtū	/conflict/to conflict/clash of opposing forces/collision (of interests)/contention/
充当	chōngdāng	/to serve as/to act as/to play the role of/
充沛	chōngpèi	/abundant; plentiful/
充实	chōngshí	/rich/full/substantial/to enrich/to augment/to substantiate (an argument)/
充足	chōngzú	/adequate/sufficient/abundant/
崇拜	chóngbài	/to worship/adoration/
崇高	chónggāo	/majestic/sublime/
崇敬	chóngjìng	/to revere/to venerate/high esteem/
重叠	chóngdié	/to overlap/to superimpose/to telescope/to run together/to duplicate/one over another/superposition/an overlap/redundancy/reduplication (in Chinese grammar, e.g. 散散步[san4 san4 bu4] to have a stroll)/
筹备	chóubèi	/preparations/to get ready for sth/
稠密	chóumì	/dense/
丑恶	chǒu’è	/ugly/repulsive/
出路	chūlù	/a way out (lit. and fig.)/opportunity for advancement; a way forward/outlet (for one's products)/
出卖	chūmài	/to offer for sale; to sell/to sell out; to betray/
出身	chūshēn	/to be born of/to come from/family background/class origin/
出神	chūshén	/spellbound/entranced/lost in thought/
出息	chūxi	/future prospects/profit/to mature/to grow up/
初步	chūbù	/initial/preliminary/tentative/
除	chú	/to get rid of/to remove/to exclude/to eliminate/to wipe out/to divide/except/not including/
储备	chǔbèi	/to store up/reserves/
储存	chǔcún	/stockpile/to store/to stockpile/storage/
储蓄	chǔxù	/to save money (in a bank)/savings/
处分	chǔfèn	/to discipline sb/to punish/disciplinary action/to deal with (a matter)/CL:個|个[ge4]/
处境	chǔjìng	/situation (of a person)/
处置	chǔzhì	/to handle/to take care of/to punish/
触犯	chùfàn	/to violate/to offend/
穿越	chuānyuè	/to pass through/to traverse/to cross/
川流不息	chuānliúbùxī	/the stream flows without stopping (idiom); unending flow/
船舶	chuánbó	/shipping/boats/
传达	chuándá	/to pass on/to convey/to relay/to transmit/transmission/
传单	chuándān	/leaflet; flier; pamphlet/
传授	chuánshòu	/to impart; to pass on; to teach/
喘气	chuǎnqì	/to breathe deeply; to pant; to gasp/to take a breather; to catch one's breath/
串	chuàn	/to string together/to skewer/to connect wrongly/to gang up/to rove/string/bunch/skewer/classifier for things that are strung together, or in a bunch, or in a row: string of, bunch of, series of/to make a swift or abrupt linear movement (like a bead on an abacus)/to move across/
床单	chuángdān	/bed sheet/CL:條|条[tiao2],件[jian4],張|张[zhang1],床[chuang2]/
创立	chuànglì	/to establish; to set up; to found/
创新	chuàngxīn	/to bring forth new ideas; to blaze new trails/innovation/
创业	chuàngyè	/to begin an undertaking; to start an enterprise/entrepreneurship/
创作	chuàngzuò	/to create; to produce; to write/a creative work; a creation/
吹牛	chuīniú	/to talk big/to shoot off one's mouth/to chat (dialect)/
吹捧	chuīpěng	/to flatter/to laud sb's accomplishments/adulation/
炊烟	chuīyān	/smoke from kitchen chimneys/
锤	chuí	/variant of 錘|锤[chui2]/
垂直	chuízhí	/perpendicular; vertical/
纯粹	chúncuì	/pure/unadulterated/purely/completely/
纯洁	chúnjié	/pure/clean and honest/to purify/
磁带	cídài	/magnetic tape/CL:盤|盘[pan2],盒[he2]/
慈祥	cíxiáng	/kindly/benevolent (often of older person)/
慈善	císhàn	/benevolent/charitable/
雌雄	cíxióng	/male and female/
刺	cì	/thorn/sting/thrust/to prick/to pierce/to stab/to assassinate/to murder/
次品	cìpǐn	/substandard products/defective/seconds/
次序	cìxù	/sequence; order/
伺候	cìhou	/to serve; to wait upon/
丛	cóng	/cluster/collection/collection of books/thicket/
从容	cóngróng	/to go easy/unhurried/calm/Taiwan pr. [cong1 rong2]/
凑合	còuhuo	/to bring together/to make do in a bad situation/to just get by/to improvise/passable/not too bad/
粗鲁	cūlǔ	/coarse/crude (in one's manner)/boorish/
窜	cuàn	/to flee/to scuttle/to exile or banish/to amend or edit/
摧残	cuīcán	/to ravage/to ruin/
脆弱	cuìruò	/weak/frail/
搓	cuō	/to rub or roll between the hands or fingers/to twist/
磋商	cuōshāng	/to consult/to discuss seriously/to negotiate/to confer/negotiations/consultations/
挫折	cuòzhé	/setback/reverse/check/defeat/frustration/disappointment/to frustrate/to discourage/to set sb back/to blunt/to subdue/
搭	dā	/to put up/to build (scaffolding)/to hang (clothes on a pole)/to connect/to join/to arrange in pairs/to match/to add/to throw in (resources)/to take (boat, train)/variant of 褡[da1]/
搭档	dādàng	/to cooperate/partner/
搭配	dāpèi	/to pair up/to match/to arrange in pairs/to add sth into a group/
答辩	dábiàn	/to reply (to an accusation)/to defend one's dissertation/
答复	dáfù	/to answer/to reply/Reply to: (in email header)/
达成	dáchéng	/to reach (an agreement)/to accomplish/
打包	dǎbāo	/to wrap; to pack/to put leftovers in a doggy bag for take-out/(computing) to package (i.e. create an archive file)/
打官司	dǎguānsi	/to file a lawsuit/to sue/to dispute/
打击	dǎjī	/to hit/to strike/to attack/to crack down on sth/blow/(psychological) shock/percussion (music)/
打架	dǎjià	/to fight/to scuffle/to come to blows/CL:場|场[chang2]/
打量	dǎliang	/to size sb up/to look sb up and down/to take the measure of/to suppose/to reckon/
打猎	dǎliè	/to go hunting/
打仗	dǎzhàng	/to fight a battle/to go to war/
大不了	dàbuliǎo	/at worst; if worst comes to worst/(usu. in the negative) serious; alarming/
大臣	dàchén	/chancellor (of a monarchy)/cabinet minister/
大伙儿	dàhuǒr	/erhua variant of 大伙[da4 huo3]/
大肆	dàsì	/wantonly/without restraint (of enemy or malefactor)/unbridled/
大体	dàtǐ	/in general; more or less; in rough terms; basically; on the whole/overall situation; the big picture/cadaver for dissection in training medical students/
大意	dàyi	/careless/
大致	dàzhì	/more or less; roughly; approximately/
歹徒	dǎitú	/evildoer/malefactor/gangster/hoodlum/
带领	dàilǐng	/to guide/to lead/
代价	dàijià	/price/cost/consideration (in share dealing)/
代理	dàilǐ	/to act on behalf of sb in a responsible position/to act as an agent or proxy/surrogate/(computing) proxy/
逮捕	dàibǔ	/to arrest/to apprehend/an arrest/
怠慢	dàimàn	/to slight/to neglect/
担保	dānbǎo	/to guarantee/to vouch for/
胆怯	dǎnqiè	/timidity/timid/cowardly/
淡季	dànjì	/off season/slow business season/see also 旺季[wang4 ji4]/
淡水	dànshuǐ	/potable water (water with low salt content)/fresh water/
蛋白质	dànbáizhì	/protein/
诞辰	dànchén	/birthday/
诞生	dànshēng	/to be born/
当场	dāngchǎng	/at the scene; on the spot/
当初	dāngchū	/at that time/originally/
当代	dāngdài	/the present age/the contemporary era/
当面	dāngmiàn	/to sb's face/in sb's presence/
当前	dāngqián	/the present time/to be faced with/
当事人	dāngshìrén	/persons involved or implicated; party (to an affair)/
当务之急	dāngwùzhījí	/(idiom) top priority job; matter of vital importance/
当选	dāngxuǎn	/to be elected/to be selected/
党	dǎng	/party/association/club/society/CL:個|个[ge4]/
档案	dàng’àn	/file; record; archive/
档次	dàngcì	/grade/class/quality/level/
倒闭	dǎobì	/to go bankrupt/to close down/
导弹	dǎodàn	/(guided) missile/CL:枚[mei2]/
导航	dǎoháng	/navigation/
导向	dǎoxiàng	/to be oriented towards/orientation/
捣乱	dǎoluàn	/to disturb/to look for trouble/to stir up a row/to bother sb intentionally/
稻谷	dàogǔ	/unhusked rice/paddy/
盗窃	dàoqiè	/to steal/
得不偿失	débùchángshī	/the gains do not make up for the losses (idiom)/
得力	délì	/able/capable/competent/efficient/
得天独厚	détiāndúhòu	/blessed by heaven (idiom)/enjoying exceptional advantages/favored by nature/
得罪	dézuì	/to offend sb/to make a faux pas/a faux pas/see also 得罪[de2 zui4]/
蹬	dēng	/to step on; to tread on/to put on; to wear (shoes, trousers etc)/(slang) to dump (sb)/Taiwan pr. [deng4]/
灯笼	dēnglong	/lantern/
登陆	dēnglù	/to land/to come ashore/to make landfall (of typhoon etc)/to log in (frequently used erroneous variant of 登錄|登录[deng1 lu4])/
登录	dēnglù	/to register/to log in/
等候	děnghòu	/to wait/to wait for/
等级	děngjí	/grade/rank/status/
瞪	dèng	/to open (one's eyes) wide/to stare at/to glare at/
堤坝	dībà	/dam/dike/
敌视	díshì	/hostile/malevolence/antagonism/to view as enemy/to stand against/
抵达	dǐdá	/to arrive/to reach (a destination)/
抵抗	dǐkàng	/to resist/resistance/
抵制	dǐzhì	/to resist/to boycott/to refuse (to cooperate)/to reject/resistance/refusal/
递增	dìzēng	/to increase by degrees/in increasing order/incremental/progressive/
地步	dìbù	/stage; degree (to which a situation has evolved)/a (usu. bad) situation/leeway/
地势	dìshì	/terrain/topography relief/
地质	dìzhì	/geology/
颠簸	diānbǒ	/to be jolted around (car on a bumpy road, boat on a rough sea, aircraft experiencing turbulence)/(fig.) to undergo a rough experience/
颠倒	diāndǎo	/to turn upside down/to reverse/back to front/confused/deranged/crazy/
点缀	diǎnzhuì	/to decorate/to adorn/sprinkled/studded/only for show/
典礼	diǎnlǐ	/ceremony; celebration/
典型	diǎnxíng	/model/typical case/archetype/typical/representative/
垫	diàn	/pad/cushion/mat/to pad out/to fill a gap/to pay for sb/to advance (money)/
电源	diànyuán	/electric power source/
奠定	diàndìng	/to establish/to fix/to settle/
惦记	diànjì	/to think of/to keep thinking about/to be concerned about/
叼	diāo	/to hold with one's mouth (as a smoker with a cigarette or a dog with a bone)/
雕刻	diāokè	/to carve/to engrave/carving/
雕塑	diāosù	/a statue/a Buddhist image/sculpture/to carve/
吊	diào	/a string of 100 cash (arch.)/to lament/to condole with/variant of 吊[diao4]/
调动	diàodòng	/to transfer/to maneuver (troops etc)/movement of personnel/to mobilize/to bring into play/
跌	diē	/to fall/to tumble/to trip/(of prices etc) to drop/Taiwan pr. [die2]/
丁	dīng	/male adult/the 4th of the 10 Heavenly Stems 天干[tian1 gan1]/fourth (used like "4" or "D")/small cube of meat or vegetable/(literary) to encounter/(archaic) ancient Chinese compass point: 195°/(chemistry) butyl/
盯	dīng	/to watch attentively/to fix one's attention on/to stare at/to gaze at/
叮嘱	dīngzhǔ	/to warn repeatedly/to urge/to exhort again and again/
定期	dìngqī	/at set dates/at regular intervals/periodic/limited to a fixed period of time/fixed term/
定义	dìngyì	/definition/to define/
丢人	diūrén	/to lose face/
丢三落四	diūsānlàsì	/forgetful/empty-headed/
东道主	dōngdàozhǔ	/host/official host (e.g. venue for games or a conference)/
东张西望	dōngzhāngxīwàng	/to look in all directions (idiom)/to glance around/
董事长	dǒngshìzhǎng	/chairman of the board of directors/
栋	dòng	/classifier for houses or buildings/ridgepole (old)/
冻结	dòngjié	/to freeze (water etc)/(fig.) to freeze (assets, prices etc)/
动荡	dòngdàng	/unrest (social or political)/turmoil/upheaval/commotion/
动机	dòngjī	/motive; motivation/
动静	dòngjing	/(detectable) movement; (sign of) activity/movement and stillness/
动力	dònglì	/motive power/force/(fig.) motivation/impetus/
动脉	dòngmài	/artery/
动身	dòngshēn	/to go on a journey/to leave/
动手	dòngshǒu	/to set about (a task)/to hit/to punch/to touch/
动态	dòngtài	/movement/motion/development/trend/dynamic (science)/
动员	dòngyuán	/to mobilize/mobilization/CL:次[ci4]/
兜	dōu	/old variant of 兜[dou1]/
陡峭	dǒuqiào	/precipitous/
斗争	dòuzhēng	/a struggle/fight/battle/
督促	dūcù	/to supervise and urge completion of a task/to urge on/
独裁	dúcái	/dictatorship/
毒品	dúpǐn	/drugs/narcotics/poison/
赌博	dǔbó	/to gamble/
堵塞	dǔsè	/to clog up/blockage/
杜绝	dùjué	/to put an end to/
端	duān	/old variant of 端[duan1]/start/origin/
端午节	uānwǔjié	/Dragon Boat Festival (5th day of the 5th lunar month)/
端正	duānzhèng	/upright/regular/proper/correct/
短促	duǎncù	/short in time/fleeting/brief/gasping (breath)/curt (tone of voice)/
断定	duàndìng	/to conclude/to determine/to come to a judgment/
断绝	duànjué	/to sever; to break off/
堆积	duījī	/to pile up/to heap/accumulation/
对策	duìcè	/countermeasure for dealing with a situation/
对称	duìchèn	/symmetry/symmetrical/
对付	duìfu	/to handle; to deal with; to tackle/to get by with; to make do/(dialect) (usu. used in the negative) to get along with (sb)/
对抗	duìkàng	/to withstand/to resist/to stand off/antagonism/confrontation/
对立	duìlì	/to oppose/to set sth against/to be antagonistic to/antithetical/relative opposite/opposing/diametrical/
对联	duìlián	/rhyming couplet/pair of lines of verse written vertically down the sides of a doorway/CL:副[fu4],幅[fu2]/
对应	duìyìng	/to correspond (to); to be equivalent to; to be a counterpart to/
对照	duìzhào	/to contrast/to compare/to place side by side for comparison (as parallel texts)/to check/
兑现	duìxiàn	/(of a check etc) to cash/to honor a commitment/
队伍	duìwu	/ranks/troops/queue/line/procession/CL:個|个[ge4],支[zhi1],條|条[tiao2]/
顿时	dùnshí	/immediately/suddenly/
多元化	duōyuánhuà	/diversification/pluralism/to diversify/
哆嗦	duōsuo	/to tremble/to shiver/uncontrolled shaking of the body/
堕落	duòluò	/to degrade/to degenerate/to become depraved/corrupt/a fall from grace/
额外	éwài	/extra/added/additional/
恶心	ěxin	/bad habit/vicious habit/vice/
恶化	èhuà	/to worsen/
遏制	èzhì	/to check/to contain/to hold back/to keep within limits/to constrain/to restrain/
恩怨	ēnyuàn	/gratitude and grudges/resentment/grudges/grievances/
而已	éryǐ	/that's all/nothing more/
二氧化碳	èryǎnghuàtàn	/carbon dioxide CO2/
发布	fābù	/to release/to issue/to announce/to distribute/
发财	fācái	/to get rich/
发呆	fādāi	/to stare blankly/to be stunned/to be lost in thought/
发动	fādòng	/to start/to launch/to unleash/to mobilize/to arouse/
发觉	fājué	/to become aware/to detect/to realize/to perceive/
发射	fāshè	/to shoot (a projectile)/to fire (a rocket)/to launch/to emit (a particle)/to discharge/emanation/emission/
发誓	fāshì	/to vow/to pledge/to swear/
发行	fāxíng	/to publish; to issue; to release; to distribute/
发炎	fāyán	/to become inflamed/inflammation/
发扬	fāyáng	/to develop/to make full use of/
发育	fāyù	/to develop/to mature/growth/development/(sexually) mature/
法人	fǎrén	/legal person/corporation/see also 自然人[zi4 ran2 ren2]/
番	fān	/(bound form) foreign (non-Chinese); barbarian/classifier for processes or actions that take time and effort/(classifier) a kind; a sort/(classifier) (used after the verb 翻[fan1] to indicate how many times a quantity doubles, as in 翻一番[fan1 yi1 fan1] "to double")/
繁华	fánhuá	/flourishing/bustling/
繁忙	fánmáng	/busy/bustling/
繁体字	fántǐzì	/traditional Chinese character/
繁殖	fánzhí	/to breed/to reproduce/to propagate/
凡是	fánshì	/each and every; every; all; any/
反驳	fǎnbó	/to retort/to refute/
反常	fǎncháng	/unusual/abnormal/
反感	fǎngǎn	/to be disgusted with/to dislike/bad reaction/antipathy/
反抗	fǎnkàng	/to resist/to rebel/
反馈	fǎnkuì	/to send back information/feedback/
反面	fǎnmiàn	/reverse side/backside/the other side (of a problem etc)/negative/bad/
反射	fǎnshè	/to reflect/reflection (from a mirror etc)/reflex (i.e. automatic reaction of organism)/
反思	fǎnsī	/to think back over sth/to review/to revisit/to rethink/reflection/reassessment/
反问	fǎnwèn	/to ask (a question) in reply/to answer a question with a question/rhetorical question/
反之	fǎnzhī	/on the other hand.../conversely.../
范畴	fànchóu	/category/
泛滥	fànlàn	/to be in flood/to overflow (the banks)/to inundate/to spread unchecked/
贩卖	fànmài	/to sell/to peddle/to traffic/
方位	fāngwèi	/direction/points of the compass/bearing/position/azimuth/
方言	fāngyán	/topolect/dialect/
方圆	fāngyuán	/perimeter/range/(within) a radius of .../
方针	fāngzhēn	/policy/guidelines/CL:個|个[ge4]/
防守	fángshǒu	/to defend/to protect (against)/
防御	fángyù	/defense/to defend/
防止	fángzhǐ	/to prevent/to guard against/to take precautions/
防治	fángzhì	/to prevent and cure/prevention and cure/
访问	fǎngwèn	/to visit/to call on/to interview/CL:次[ci4]/
纺织	fǎngzhī	/spinning and weaving/
放大	fàngdà	/to enlarge/to magnify/
放射	fàngshè	/to radiate/radioactive/
非法	fēifǎ	/illegal/
飞禽走兽	fēiqínzǒushòu	/birds and animals/the beasts of the field and the birds of the air/
飞翔	fēixiáng	/to circle in the air/to soar/
飞跃	fēiyuè	/to leap/
肥沃	féiwò	/fertile/
诽谤	fěibàng	/to slander/to libel/
肺	fèi	/lung/CL:個|个[ge4]/
废除	fèichú	/to abolish/to abrogate/to repeal/
废墟	fèixū	/ruins/
废寝忘食	fèiqǐnwàngshí	/(idiom) to skip one's sleep and meals; to be completely wrapped up in one's work/
沸腾	fèiténg	/(of a liquid) to boil/(of sentiments etc) to boil over/to flare up/to be impassioned/
分辨	fēnbiàn	/to distinguish; to differentiate/to resolve/
分寸	fēncùn	/propriety/appropriate behavior/proper speech or action/within the norms/
分红	fēnhóng	/dividend/to award a bonus/
分解	fēnjiě	/to resolve/to decompose/to break down/
分裂	fēnliè	/to split up/to divide/to break up/fission/schism/
分泌	fēnmì	/to secrete/secretion/
分明	fēnmíng	/clear/distinct/evidently/clearly/
分歧	fēnqí	/divergent/difference (of opinion, position); disagreement/(math.) bifurcation/
分散	fēnsàn	/to scatter/to disperse/to distribute/
吩咐	fēnfù	/to tell; to instruct; to command/
坟墓	fénmù	/grave/tomb/
粉末	fěnmò	/fine powder/dust/
粉色	fěnsè	/pink/white/erotic/beautiful woman/powdered (with make-up)/
粉碎	fěnsuì	/to crush; to smash; to shatter/
分量	fènliàng	/quantity/weight/measure/
愤怒	fènnù	/angry/indignant/wrath/ire/
风暴	fēngbào	/storm/violent commotion/fig. crisis (e.g. revolution, uprising, financial crisis etc)/
风度	fēngdù	/elegance (for men)/elegant demeanor/grace/poise/
风光	fēngguāng	/scene/view/sight/landscape/to be well-regarded/to be well-off/grand (dialect)/impressive (dialect)/
风气	fēngqì	/general mood/atmosphere/common practice/
风趣	fēngqù	/charm/humor/wit/humorous/witty/
风土人情	fēngtǔrénqíng	/local conditions and customs (idiom)/
风味	fēngwèi	/distinctive flavor/distinctive style/
封闭	fēngbì	/to close; to seal off/to close down (an illegal venue)/closed (i.e. isolated from outside input)/
封建	fēngjiàn	/system of enfeoffment/feudalism/feudal/feudalistic/
封锁	fēngsuǒ	/to blockade/to seal off/to lock down/
丰满	fēngmǎn	/ample/well developed/fully rounded/
丰盛	fēngshèng	/rich/sumptuous/
丰收	fēngshōu	/bumper harvest/
锋利	fēnglì	/sharp (e.g. knife blade)/incisive/to the point/
逢	féng	/to meet by chance/to come across/(of a calendar event) to come along/(of an event) to fall on (a particular day)/to fawn upon/
奉献	fèngxiàn	/to offer respectfully/to consecrate/to dedicate/to devote/
否决	fǒujué	/to veto/to overrule/
夫妇	fūfù	/a (married) couple/husband and wife/CL:對|对[dui4]/
夫人	fūrén	/lady/madam/Mrs./CL:位[wei4]/
敷衍	fūyǎn	/to elaborate (on a theme)/to expound (the classics)/perfunctory/to skimp/to botch/to do sth half-heartedly or just for show/barely enough to get by/
幅度	fúdù	/width/extent/range/scope/
服从	fúcóng	/to obey (an order)/to comply/to defer/
服气	fúqì	/to be convinced/to accept/
符号	fúhào	/symbol; mark; sign/
福利	fúlì	/material benefit/benefit in kind/(social) welfare/
福气	fúqi	/good fortune/a blessing/
俘虏	fúlǔ	/captive/
辐射	fúshè	/radiation/
腐败	fǔbài	/corruption/to corrupt/to rot/rotten/
腐烂	fǔlàn	/to rot/to putrefy/(fig.) corrupt/
腐蚀	fǔshí	/corrosion/to corrode (degrade chemically)/to rot/corruption/
腐朽	fǔxiǔ	/rotten/decayed/decadent/degenerate/
辅助	fǔzhù	/to assist; to aid/supplementary; auxiliary/
抚养	fǔyǎng	/to foster/to bring up/to raise/
抚摸	fǔmō	/to gently caress and stroke/to pet/to fondle/
俯视	fǔshì	/to overlook/to look down at/
富裕	fùyù	/prosperous; well-to-do; well-off/
副	fù	/secondary/auxiliary/deputy/assistant/vice-/abbr. for 副詞|副词 adverb/classifier for pairs, sets of things & facial expressions/
负担	fùdān	/to bear (an expense, a responsibility etc)/burden/
覆盖	fùgài	/to cover/
附和	fùhè	/to agree/to go along with/to echo (what sb says)/
附件	fùjiàn	/appendix (in a document)/enclosure (accompanying a document)/(email) attachment/accessory (for a car, computer etc)/(anatomy) adnexa/
附属	fùshǔ	/subsidiary/auxiliary/attached/affiliated/subordinate/subordinating/
复活	fùhuó	/to revive/(lit. and fig.) to come back to life/(religion) resurrection/
复兴	fùxīng	/to revive/to rejuvenate/
腹泻	fùxiè	/diarrhea/to have the runs/
赋予	fùyǔ	/to assign/to entrust (a task)/to give/to bestow/
改良	gǎiliáng	/to improve (sth)/to reform (a system)/
盖章	gàizhāng	/to affix a seal/to stamp (a document)/to sign off on sth/
钙	gài	/calcium (chemistry)/
干旱	gānhàn	/drought/arid/dry/
干扰	gānrǎo	/to disturb/to interfere/perturbation/interference (physics)/
干涉	gānshè	/to interfere/to meddle/interference/
干预	gānyù	/to meddle/to intervene/intervention/
尴尬	gāngà	/awkward; embarrassed/
感慨	gǎnkǎi	/to sigh with sorrow, regret etc/rueful/deeply moved/
感染	gǎnrǎn	/to infect; infection/(fig.) to influence/
干劲	gànjìn	/enthusiasm for doing sth/
纲领	gānglǐng	/program (i.e. plan of action)/guiding principle/
港口	gǎngkǒu	/port/harbor/
港湾	gǎngwān	/bay serving as a harbor/
岗位	gǎngwèi	/a post; a job/
杠杆	gànggǎn	/lever/pry bar/crowbar/financial leverage/
高超	gāochāo	/excellent/superlative/
高潮	gāocháo	/high tide; high water/upsurge; peak of activity/climax (of a story, a competition etc)/to have an orgasm/
高峰	gāofēng	/peak/summit/height/
高明	gāomíng	/brilliant; superior; wise/
高尚	gāoshàng	/noble/lofty/refined/exquisite/
高涨	gāozhǎng	/to surge up/to rise/(of tensions etc) to run high/
稿件	gǎojiàn	/piece of writing submitted for publication; manuscript; article/
告辞	gàocí	/to say goodbye/to take one's leave/
告诫	gàojiè	/to warn/to admonish/
割	gē	/to cut/to cut apart/
搁	gē	/to bear/to stand/to endure/
疙瘩	gēda	/swelling or lump on skin; pimple/knot; lump/preoccupation; problem/
歌颂	gēsòng	/to sing the praises of/to extol/to eulogize/
鸽子	gēzi	/pigeon/dove/various birds of the family Columbidae/
隔阂	géhé	/misunderstanding/estrangement/(language etc) barrier/
隔离	gélí	/to separate/to isolate/
格局	géjú	/structure/pattern/layout/
格式	géshi	/form/specification/format/
革命	gémìng	/to withdraw the mandate of heaven (and transition to a new dynasty) (original meaning)/revolution/revolutionary/to revolt (against sb or sth)/to revolutionize (sth)/(separable verb sometimes used in the pattern 革noun的命)/CL:次[ci4]/
个体	gètǐ	/individual/
各抒己见	gèshūjǐjiàn	/everyone gives their own view/
根深蒂固	gēnshēndìgù	/deep-rooted (problem etc)/
根源	gēnyuán	/origin/root (cause)/
跟前	gēnqián	/(of children, parents etc) at one's side; living with one/
跟随	gēnsuí	/to follow/
跟踪	gēnzōng	/to follow sb's tracks/to tail/to shadow/tracking/
耕地	gēngdì	/arable land/to plow land/
更新	gēngxīn	/to replace the old with new/to renew/to renovate/to upgrade/to update/to regenerate/
更正	gēngzhèng	/to correct/to make a correction/
公安局	gōng’ānjú	/public security bureau (government office similar in function to a police station)/
公道	gōngdao	/fair/equitable/
公告	gōnggào	/post/announcement/
公关	gōngguān	/public relations/
公民	gōngmín	/citizen/
公然	gōngrán	/openly/publicly/undisguised/
公认	gōngrèn	/publicly known (to be)/accepted (as)/
公式	gōngshì	/formula/
公务	gōngwù	/official business/
公正	gōngzhèng	/just; fair; equitable/
公证	gōngzhèng	/notarization/notarized/acknowledgement/
供不应求	gōngbúyìngqiú	/supply does not meet demand/
供给	gōngjǐ	/to furnish/to provide/supply (as in supply and demand)/
工艺品	gōngyìpǐn	/handicraft article/handiwork/CL:個|个[ge4]/
宫殿	gōngdiàn	/palace/CL:座[zuo4]/
功劳	gōngláo	/contribution/meritorious service/credit/
功效	gōngxiào	/efficacy/
攻击	gōngjī	/to attack/to accuse/to charge/an attack (terrorist or military)/
攻克	gōngkè	/to capture/to take/to overcome/to solve/
恭敬	gōngjìng	/deferential/respectful/
巩固	gǒnggù	/to consolidate/consolidation/to strengthen/
共和国	gònghéguó	/republic/
共计	gòngjì	/to sum up to/to total/
共鸣	gòngmíng	/(physics) to resonate; resonance/sympathetic response/
勾结	gōujié	/to collude with/to collaborate with/to gang up with/
钩子	gōuzi	/hook/
构思	gòusī	/to design/to plot/to plan out/to compose/to draw a mental sketch/conception/plan/idea/composition/
孤独	gūdú	/lonely/solitary/
孤立	gūlì	/to isolate/isolated/unrelated; irrelevant/
辜负	gūfù	/to fail to live up (to expectations)/unworthy (of trust)/to let down/to betray (hopes)/to disappoint/
姑且	gūqiě	/for the time being; tentatively/
古董	gǔdǒng	/curio/antique/
古怪	gǔguài	/strange/weird/eccentric/bizarre/
股东	gǔdōng	/shareholder/stockholder/
股份	gǔfèn	/a share (in a company)/stock/
鼓动	gǔdòng	/to urge (an activity that may be beneficial, harmful or neutral); to encourage; to agitate; to instigate; to incite/to beat; to flap (wings, a fan etc)/
骨干	gǔgàn	/diaphysis (long segment of a bone)/fig. backbone/
固然	gùrán	/admittedly (it's true that...)/
固体	gùtǐ	/solid/
固有	gùyǒu	/intrinsic to sth/inherent/native/
固执	gùzhi	/obstinate/stubborn/to fixate on/to cling to/
顾虑	gùlǜ	/misgivings; apprehensions/to worry about; to be concerned about/
顾问	gùwèn	/adviser/consultant/
故乡	gùxiāng	/home/homeland/native place/CL:個|个[ge4]/
故障	gùzhàng	/malfunction/breakdown/defect/shortcoming/fault/failure/impediment/error/bug (in software)/
雇佣	gùyōng	/to employ/to hire/
拐杖	guǎizhàng	/crutches/crutch/walking stick/
关怀	guānhuái	/care/solicitude/to show care for/concerned about/attentive to/
关照	guānzhào	/to take care/to keep an eye on/to look after/to tell/to remind/
官方	guānfāng	/government/official (approved or issued by an authority)/
观光	guānguāng	/to tour/sightseeing/tourism/
管辖	guǎnxiá	/to administer/to have jurisdiction (over)/
罐	guàn	/variant of 罐[guan4]/
贯彻	guànchè	/to implement/to put into practice/to carry out/
灌溉	guàngài	/to irrigate/
惯例	guànlì	/convention/usual practice/
光彩	guāngcǎi	/luster/splendor/radiance/brilliance/
光辉	guānghuī	/radiance/glory/brilliant/magnificent/
光芒	guāngmáng	/rays of light/brilliant rays/radiance/
光荣	guāngróng	/honor and glory/glorious/
广阔	guǎngkuò	/wide/vast/
规范	guīfàn	/norm/standard/specification/regulation/rule/within the rules/to fix rules/to regulate/to specify/
规格	guīgé	/standard/norm/specification/
规划	guīhuà	/to draw up a plan; to map out a program/a plan; a program/
规章	guīzhāng	/rule; regulation/
归根到底	guīgēndàodǐ	/after all/in the final analysis/ultimately/
归还	guīhuán	/to return sth/to revert/
轨道	guǐdào	/track (for trains etc)/orbit (of a satellite)/(fig.) a person's established path in life/desired trajectory (of a business or other endeavor)/(audio engineering) track/(quantum mechanics) orbital/
跪	guì	/to kneel/
贵族	guìzú	/lord/nobility/nobleman/noblewoman/aristocrat/aristocracy/
棍棒	gùnbàng	/club; staff; stick/
国防	guófáng	/national defense/
国务院	guówùyuàn	/State Council (PRC)/State Department (USA)/
果断	guǒduàn	/firm/decisive/
过度	guòdù	/excessive/over-/excess/going too far/extravagant/intemperate/overdue/
过渡	guòdù	/to cross over (by ferry)/transition/interim/caretaker (administration)/
过奖	guòjiǎng	/to overpraise/to flatter/
过滤	guòlǜ	/to filter/filter/
过失	guòshī	/error/fault/(law) negligence/delinquency/
过问	guòwèn	/to show an interest in/to get involved with/
过瘾	guòyǐn	/to satisfy a craving/to get a kick out of sth/gratifying/immensely enjoyable/satisfying/fulfilling/
过于	guòyú	/excessively; too/
嗨	hāi	/oh alas/hey!/hi! (loanword)/a high (natural or drug-induced) (loanword)/
海拔	hǎibá	/height above sea level/elevation/
海滨	hǎibīn	/shore/seaside/
含糊	hánhu	/ambiguous/vague/careless/perfunctory/
含义	hányì	/meaning (implicit in a phrase)/implied meaning/hidden meaning/hint/connotation/
寒暄	hánxuān	/to exchange conventional greetings; to exchange pleasantries/
罕见	hǎnjiàn	/rare/rarely seen/
捍卫	hànwèi	/to defend/to uphold/to safeguard/
航空	hángkōng	/aviation/
航天	hángtiān	/space flight/
航行	hángxíng	/to sail/to fly/to navigate/
行列	hángliè	/formation/array/(fig.) ranks (as in "join the ranks of ...")/
豪迈	háomài	/bold/open-minded/heroic/
毫米	háomǐ	/millimeter/
毫无	háowú	/not in the least/to completely lack/
号召	hàozhào	/to call/to appeal/
耗费	hàofèi	/to waste/to spend/to consume/to squander/
呵	hē	/expel breath/my goodness/
和蔼	hé’ǎi	/kindly/nice/amiable/
和解	héjiě	/to settle (a dispute out of court)/to reconcile/settlement/conciliation/to become reconciled/
和睦	hémù	/peaceful relations/harmonious/
和气	héqi	/friendly/polite/amiable/
和谐	héxié	/harmonious/harmony/(euphemism) to censor/
合并	hébìng	/to merge/to annex/
合成	héchéng	/to compose/to constitute/compound/synthesis/mixture/synthetic/
合伙	héhuǒ	/to act jointly/to form a partnership/
合算	hésuàn	/worthwhile/to be a good deal/to be a bargain/to reckon up/to calculate/
嘿	hēi	/hey/
痕迹	hénjì	/vestige/mark/trace/
狠心	hěnxīn	/callous; heartless/to resolve (to do sth)/firm resolve (as in 下狠心[xia4 hen3 xin1])/
恨不得	hènbude	/wishing one could do sth; to hate to be unable; itching to do sth/
哼	hēng	/to groan/to snort/to hum/to croon/humph!/
横	héng	/harsh and unreasonable/unexpected/
哄	hōng	/tumult/uproar/commotion/disturbance/
烘	hōng	/to bake/to heat by fire/to set off by contrast/
轰动	hōngdòng	/to cause a sensation/to create a stir in (a place)/commotion/controversy/
宏观	hóngguān	/macro-/macroscopic/holistic/
宏伟	hóngwěi	/grand/imposing/magnificent/
洪水	hóngshuǐ	/deluge; flood/
喉咙	hóulóng	/the throat/
吼	hǒu	/to roar/to howl/to shriek/roar or howl of an animal/bellow of rage/
后代	hòudài	/descendant; progeny/posterity; later ages; later generations/
后顾之忧	hòugùzhīyōu	/fears of trouble in the rear (idiom); family worries (obstructing freedom of action)/worries about the future consequences/often in negative expressions, meaning "no worries about anything"/
后勤	hòuqín	/logistics/
候选	hòuxuǎn	/candidate (attributive)/
忽略	hūlüè	/to neglect; to overlook; to ignore/
呼唤	hūhuàn	/to call out (a name etc)/to shout/
呼啸	hūxiào	/to whistle; to scream; to whiz/
呼吁	hūyù	/to call on (sb to do sth)/to appeal (to)/an appeal/
胡乱	húluàn	/careless/reckless/casually/absent-mindedly/at will/at random/any old how/
胡须	húxū	/beard/CL:根[gen1],綹|绺[liu3]/
湖泊	húpō	/lake/
花瓣	huābàn	/petal/CL:片[pian4]/
花蕾	huālěi	/bud/flower bud/
华丽	huálì	/gorgeous/
华侨	huáqiáo	/overseas Chinese/(in a restricted sense) Chinese emigrant who still retains Chinese nationality/CL:個|个[ge4],位[wei4],名[ming2]/
画蛇添足	huàshétiānzú	/lit. draw legs on a snake (idiom); fig. to ruin the effect by adding sth superfluous/to overdo it/
化肥	huàféi	/fertilizer/
化石	huàshí	/fossil/
化验	huàyàn	/chemical examination/to do a lab test/
化妆	huàzhuāng	/to put on makeup/
划分	huàfēn	/to divide up/to partition/to differentiate/
话筒	huàtǒng	/microphone/(telephone) receiver; handset/megaphone/(fig.) mouthpiece; spokesperson/
欢乐	huānlè	/gaiety/gladness/glee/merriment/pleasure/happy/joyous/gay/
还原	huányuán	/to restore to the original state/to reconstruct (an event)/reduction (chemistry)/
环节	huánjié	/(zoology) segment (of the body of a worm, centipede etc)/(fig.) a part of an integrated whole: aspect (of a project), element (of a policy), sector (of the economy), stage (of a process) etc/
缓和	huǎnhé	/to ease (tension)/to alleviate/to moderate/to allay/to make more mild/
患者	huànzhě	/patient; sufferer/
荒凉	huāngliáng	/desolate/
荒谬	huāngmiù	/absurd/ridiculous/
荒唐	huāngtáng	/beyond belief/preposterous/absurd/intemperate/dissipated/
黄昏	huánghūn	/dusk/evening/nightfall/
皇帝	huángdì	/emperor/CL:個|个[ge4]/
皇后	huánghòu	/empress/imperial consort/
晃	huǎng	/to sway/to shake/to wander about/
恍然大悟	huǎngrándàwù	/to suddenly realize; to suddenly see the light/
挥霍	huīhuò	/to squander money/extravagant/prodigal/free and easy/agile/
辉煌	huīhuáng	/splendid/glorious/
回报	huíbào	/(in) return/reciprocation/payback/retaliation/to report back/to reciprocate/
回避	huíbì	/to shun/to avoid (sb)/to skirt/to evade (an issue)/to step back/to withdraw/to recuse (a judge etc)/
回顾	huígù	/to look back/to review/
回收	huíshōu	/to recycle/to reclaim/to retrieve/to recover/to recall (a defective product)/
悔恨	huǐhèn	/remorse/repentance/
毁灭	huǐmiè	/to perish/to ruin/to destroy/
会晤	huìwù	/to meet/meeting/conference/
汇报	huìbào	/to report/to give an account of/report/
贿赂	huìlù	/to bribe/a bribe/
昏迷	hūnmí	/to lose consciousness/to be in a coma/stupor/coma/stunned/disoriented/
荤	hūn	/strong-smelling vegetable (garlic etc)/non-vegetarian food (meat, fish etc)/vulgar/obscene/
浑身	húnshēn	/all over/from head to foot/
混合	hùnhé	/to mix; to blend/hybrid; composite/
混乱	hùnluàn	/confusion/chaos/disorder/
混淆	hùnxiáo	/to obscure/to confuse/to mix up/to blur/to mislead/
混浊	hùnzhuó	/turbid/muddy/dirty/
活该	huógāi	/(coll.) serve sb right/deservedly/ought/should/
活力	huólì	/energy/vitality/vigor/vital force/
火箭	huǒjiàn	/rocket/CL:枚[mei2]/
火焰	huǒyàn	/blaze/flame/
火药	huǒyào	/gunpowder/
货币	huòbì	/currency/monetary/money/
基地	jīdì	/base (of operations)/industrial or military base/al-Qaeda/
基金	jījīn	/fund/
基因	jīyīn	/gene (loanword)/
机动	jīdòng	/locomotive/motorized/power-driven/adaptable/flexible (use, treatment, timing etc)/
机构	jīgòu	/mechanism/structure/organization/agency/institution/CL:所[suo3]/
机灵	jīling	/clever/quick-witted/
机密	jīmì	/secret/classified (information)/
机械	jīxiè	/machine/machinery/mechanical/(old) cunning/scheming/
机遇	jīyù	/opportunity/favorable circumstance/stroke of luck/
机智	jīzhì	/quick-witted/resourceful/
激发	jīfā	/to arouse/to stimulate/(physics) to excite/
激励	jīlì	/to encourage/to urge/motivation/incentive/
激情	jīqíng	/passion/fervor/enthusiasm/strong emotion/
饥饿	jī’è	/hunger/starvation/famine/
讥笑	jīxiào	/to sneer/
极端	jíduān	/extreme/
极限	jíxiàn	/limit/extreme boundary/
即便	jíbiàn	/even if/even though/right away/immediately/
即将	jíjiāng	/on the eve of/to be about to/to be on the verge of/
级别	jíbié	/(military) rank/level/grade/
疾病	jíbìng	/disease; sickness; ailment/
嫉妒	jídù	/to be jealous of; to envy/
及早	jízǎo	/at the earliest possible time; as soon as possible/
急功近利	jígōngjìnlì	/seeking instant benefit (idiom); shortsighted vision, looking only for fast return/
急剧	jíjù	/rapid; sudden/
急切	jíqiè	/eager/impatient/
急于求成	jíyúqiúchéng	/anxious for quick results (idiom); to demand instant success/impatient for result/impetuous/
急躁	jízào	/irritable; irascible/impetuous/
籍贯	jíguàn	/one's native place/place of ancestry/registered birthplace/
集团	jítuán	/group/bloc/corporation/conglomerate/
吉祥	jíxiáng	/lucky/auspicious/propitious/
给予	jǐyǔ	/(literary) to give; to accord; to render/
寄托	jìtuō	/to entrust (to sb)/to place (one's hope, energy etc) in/a thing in which one invests (one's hope, energy etc)/
继承	jìchéng	/to inherit/to succeed to (the throne etc)/to carry on (a tradition etc)/
记性	jìxing	/memory (ability to retain information)/
记载	jìzǎi	/to write down/to record/written account/
季度	jìdù	/quarter of a year/season (sports)/
季军	jìjūn	/third in a race/bronze medalist/
计较	jìjiào	/to bother about/to haggle/to bicker/to argue/plan/stratagem/
忌讳	jìhuì	/taboo/to avoid as taboo/to abstain from/
寂静	jìjìng	/quiet/
纪要	jìyào	/minutes/written summary of a meeting/
技巧	jìqiǎo	/skill/technique/
迹象	jìxiàng	/sign; indication; mark; indicator/
家常	jiācháng	/the daily life of a family/
家伙	jiāhuo	/household dish, implement or furniture/domestic animal/(coll.) guy/chap/weapon/
家属	jiāshǔ	/family member/(family) dependent/
家喻户晓	jiāyùhùxiǎo	/understood by everyone (idiom); well known/a household name/
加工	jiāgōng	/to process/processing/working (of machinery)/
加剧	jiājù	/to intensify/
佳肴	jiāyáo	/fine food/delicacies/delicious food/
夹杂	jiāzá	/to mix together (disparate substances)/to mingle/a mix/to be tangled up with/
煎	jiān	/to pan fry/to sauté/
坚定	jiāndìng	/firm/steady/staunch/resolute/
坚固	jiāngù	/firm/firmly/hard/stable/
坚韧	jiānrèn	/tough and durable/tenacious/
坚实	jiānshí	/firm and substantial/solid/
坚硬	jiānyìng	/hard/solid/
监督	jiāndū	/to control/to supervise/to inspect/
监视	jiānshì	/to monitor/to keep a close watch over/surveillance/
监狱	jiānyù	/prison/
尖端	jiānduān	/sharp pointed end/the tip/the cusp/tip-top/most advanced and sophisticated/highest peak/the best/
尖锐	jiānruì	/sharp/intense/penetrating/pointed/acute (illness)/
艰难	jiānnán	/difficult/hard/challenging/
拣	jiǎn	/to choose/to pick/to sort out/to pick up/
剪彩	jiǎncǎi	/to cut the ribbon (at a launching or opening ceremony)/
检讨	jiǎntǎo	/to examine or inspect/self-criticism/review/
检验	jiǎnyàn	/to inspect/to examine/to test/
简化	jiǎnhuà	/to simplify/
简陋	jiǎnlòu	/simple and crude/
简体字	jiǎntǐzì	/simplified Chinese character, as opposed to traditional Chinese character 繁體字|繁体字[fan2 ti3 zi4]/
简要	jiǎnyào	/concise/brief/
溅	jiàn	/to splash/
鉴别	jiànbié	/to differentiate; to distinguish/
鉴定	jiàndìng	/to appraise/to identify/to evaluate/
鉴于	jiànyú	/in view of/seeing that/considering/whereas/
间谍	jiàndié	/spy/
间隔	jiàngé	/gap/interval/compartment/to divide/to separate/to leave a gap of (two weeks, three meters etc)/
间接	jiànjiē	/indirect/
见多识广	jiànduōshíguǎng	/experienced and knowledgeable (idiom)/
见解	jiànjiě	/opinion/view/understanding/
见闻	jiànwén	/what one has seen and heard/knowledge/one's experience/
见义勇为	jiànyìyǒngwéi	/to see what is right and act courageously (idiom, from Analects); to stand up bravely for the truth/acting heroically in a just cause/
健全	jiànquán	/robust/sound/
践踏	jiàntà	/to trample/
舰艇	jiàntǐng	/warship/naval vessel/
剑	jiàn	/variant of 劍|剑[jian4]/
将近	jiāngjìn	/almost/nearly/close to/
将军	jiāngjūn	/general/high-ranking military officer/to check or checkmate/fig. to embarrass/to challenge/to put sb on the spot/
将就	jiāng jiù	/to accept (a bit reluctantly)/to put up with/
僵硬	jiāngyìng	/stiff; rigid/
桨	jiǎng	/oar; paddle/CL:隻|只[zhi1]/
奖励	jiǎnglì	/to reward/reward (as encouragement)/
奖赏	jiǎngshǎng	/reward; prize; award/
降临	jiànglín	/to descend/to arrive/to come/
交叉	jiāochā	/to cross/to intersect/to overlap/
交代	jiāodài	/to transfer (duties to sb else)/to give instructions; to tell (sb to do sth)/to explain; to give an account; to brief/to confess; to account for oneself/(jocular) to come to a bad end/
交涉	jiāoshè	/to negotiate (with)/to have dealings (with)/
交易	jiāoyì	/to deal; to trade; to transact/transaction; deal/CL:筆|笔[bi3]/
焦点	jiāodiǎn	/focal point; focus (lit. and fig.)/
焦急	jiāojí	/anxiety/anxious/
娇气	jiāoqì	/delicate/squeamish/finicky/
角落	jiǎoluò	/nook; corner/
搅拌	jiǎobàn	/to stir/to agitate/
缴纳	jiǎonà	/to pay (taxes etc)/
侥幸	jiǎoxìng	/luckily/by a fluke/
教养	jiàoyǎng	/to educate; to bring up; to nurture/upbringing; breeding; culture/
较量	jiàoliàng	/to pit oneself against sb/to compete with sb/contest/battle/to haggle/to quibble/
皆	jiē	/all/each and every/in all cases/
接连	jiēlián	/on end/in a row/in succession/
阶层	jiēcéng	/social class/
揭露	jiēlù	/to expose/to unmask/to ferret out/to disclose/disclosure/
节奏	jiézòu	/rhythm/tempo/musical pulse/cadence/beat/
节制	jiézhì	/to control/to restrict/to moderate/to temper/moderation/sobriety/to administer/
杰出	jiéchū	/outstanding/distinguished/remarkable/prominent/illustrious/
结晶	jiéjīng	/to crystallize/crystallization/crystal/crystalline/(fig.) the fruit (of labor etc)/
结局	jiéjú	/conclusion/ending/
结算	jiésuàn	/to settle a bill; to close an account/
竭尽全力	jiéjìnquánlì	/to spare no effort (idiom); to do one's utmost/
截至	jiézhì	/up to (a time)/by (a time)/
截止	jiézhǐ	/to close/to stop/to put a stop to sth/cut-off point/stopping point/deadline/
解除	jiěchú	/to remove/to sack/to get rid of/to relieve (sb of their duties)/to free/to lift (an embargo)/to rescind (an agreement)/
解放	jiěfàng	/to liberate/to emancipate/liberation/refers to the Communists' victory over the Nationalists in 1949/CL:次[ci4]/
解雇	jiěgù	/to fire/to sack/to dismiss/to terminate employment/
解剖	jiěpōu	/to dissect (an animal)/to analyze/anatomy/
解散	jiěsàn	/to dissolve/to disband/
解体	jiětǐ	/to break up into components/to disintegrate/to collapse/to crumble/
借鉴	jièjiàn	/to draw on (others' experience)/to learn from (how others do things)/lesson to be learned (by observing others)/
借助	jièzhù	/to draw support from/with the help of/
戒备	jièbèi	/to take precautions/to guard against (emergency)/
界限	jièxiàn	/boundary/
津津有味	jīnjīnyǒuwèi	/with keen interest (idiom)/with great pleasure/with gusto/eagerly/
金融	jīnróng	/banking/finance/financial/
紧迫	jǐnpò	/pressing/urgent/
锦上添花	jǐnshàngtiānhuā	/lit. add flowers to brocade (idiom)/fig. to give sth additional splendor/to provide the crowning touch/(derog.) to benefit sb who is already well off/
进而	jìn’ér	/and then (what follows next)/
进攻	jìngōng	/to attack/to assault/to go on the offensive/attack/assault/offense (sports)/
进化	jìnhuà	/evolution/CL:個|个[ge4]/
进展	jìnzhǎn	/to make headway; to make progress/
近来	jìnlái	/recently/lately/
浸泡	jìnpào	/to steep/to soak/to immerse/
晋升	jìnshēng	/to promote to a higher position/
茎	jīng	/stalk/stem/CL:條|条[tiao2]/
精打细算	jīngdǎxìsuàn	/meticulous planning and careful accounting (idiom)/
精华	jīnghuá	/best feature/most important part of an object/quintessence/essence/soul/
精简	jīngjiǎn	/to simplify/to reduce/
精密	jīngmì	/accuracy/exact/precise/refined/
精确	jīngquè	/accurate; precise/
精通	jīngtōng	/to be proficient in/to master (a subject)/
精心	jīngxīn	/with utmost care/fine/meticulous/detailed/
精益求精	jīngyìqiújīng	/(idiom) to constantly seek to improve; to keep perfecting/
精致	jīngzhì	/delicate; fine; exquisite; refined/
经费	jīngfèi	/funds/expenditure/CL:筆|笔[bi3]/
经纬	jīngwěi	/warp and woof/longitude and latitude/main points/
惊动	jīngdòng	/to alarm/to startle/to disturb/
惊奇	jīngqí	/to be amazed/to be surprised/to wonder/
惊讶	jīngyà	/amazed/astonished/to surprise/amazing/astonishment/awe/
兢兢业业	jīngjīngyèyè	/(idiom) conscientious/assiduous/
井	jǐng	/a well/CL:口[kou3]/neat/orderly/
警告	jǐnggào	/to warn/to admonish/
警惕	jǐngtì	/to be on the alert/vigilant/alert/on guard/to warn/
颈椎	jǐngzhuī	/cervical vertebra/the seven cervical vertebrae in the neck of humans and most mammals/
敬礼	jìnglǐ	/to salute/salute/
敬业	jìngyè	/dedicated to one's work/
境界	jìngjiè	/boundary/state/realm/
竞赛	jìngsài	/to compete; to race/contest; competition; match; race/
竞选	jìngxuǎn	/to take part in an election/to run for office/
镜头	jìngtóu	/camera lens/camera shot (in a movie etc)/scene/
纠纷	jiūfēn	/dispute/
纠正	jiūzhèng	/to correct/to make right/
酒精	jiǔjīng	/alcohol/ethanol CH3CH2OH/ethyl alcohol/also written 乙醇/grain alcohol/
救济	jiùjì	/emergency relief/to help the needy with cash or goods/
就近	jiùjìn	/nearby/in a close neighborhood/
就业	jiùyè	/to get a job/employment/
就职	jiùzhí	/to take office; to assume a post/
鞠躬	jūgōng	/to bow/(literary) to bend down/
拘留	jūliú	/to detain (a prisoner)/to keep sb in custody/
拘束	jūshù	/to restrict/to restrain/constrained/awkward/ill at ease/uncomfortable/reticent/
居民	jūmín	/resident; inhabitant/
居住	jūzhù	/to reside/to dwell/to live in a place/resident in/
局部	júbù	/part/local/
局面	júmiàn	/aspect/phase/situation/
局势	júshì	/situation/state (of affairs)/
局限	júxiàn	/to limit/to confine/to restrict sth within set boundaries/
举动	jǔdòng	/act/action/activity/move/movement/
举世瞩目	jǔshìzhǔmù	/to receive worldwide attention/
举足轻重	jǔzúqīngzhòng	/to play a critical role (idiom)/influential/
咀嚼	jǔjué	/to chew/to think over/
沮丧	jǔsàng	/dispirited/dejected/dismayed/
剧本	jùběn	/script for play, opera, movie etc/screenplay/scenario/
剧烈	jùliè	/violent; acute; severe; fierce/
聚精会神	jùjīnghuìshén	/to concentrate one's attention (idiom)/
据悉	jùxī	/according to reports/it is reported (that)/
卷	juǎn	/to roll up/to sweep up; to carry along/a roll/classifier for rolls, spools etc/
决策	juécè	/strategic decision/decision-making/policy decision/to determine policy/
觉悟	juéwù	/to come to understand/to realize/consciousness/awareness/Buddhist enlightenment (Sanskrit: cittotpāda)/
觉醒	juéxǐng	/to awaken/to come to realize/awakened to the truth/the truth dawns upon one/scales fall from the eyes/to become aware/
绝望	juéwàng	/to despair/to give up all hope/desperate/desperation/
倔强	juéjiàng	/stubborn; obstinate; unbending/
军队	jūnduì	/armed forces; troops/CL:支[zhi1],個|个[ge4]/
君子	jūnzǐ	/nobleman/person of noble character/
卡通	kǎtōng	/cartoon (loanword)/
开采	kāicǎi	/to extract (ore or other resource from a mine)/to exploit/to mine/
开除	kāichú	/to expel (a member of an organization)/to fire (an employee)/
开阔	kāikuò	/wide/open (spaces)/to open up/
开朗	kāilǎng	/spacious and well-lit/open and clear/(of character) optimistic/cheerful/carefree/
开明	kāimíng	/enlightened/open-minded/enlightenment/
开辟	kāipì	/to open up/to set up/to establish/
开拓	kāituò	/to break new ground (for agriculture)/to open up (a new seam)/to develop (border regions)/fig. to open up (new horizons)/
开展	kāizhǎn	/to launch/to develop/to unfold/(of an exhibition etc) to open/
开支	kāizhī	/expenditures; expenses (CL:筆|笔[bi3], 項|项[xiang4])/to spend money/(coll.) to pay wages/
刊登	kāndēng	/to carry a story/to publish (in a newspaper or magazine)/
刊物	kānwù	/publication/
勘探	kāntàn	/to explore/to survey/to prospect (for oil etc)/prospecting/
砍伐	kǎnfá	/to hew/to cut down/
侃侃而谈	kǎnkǎn ér tán	/to speak frankly with assurance/
看待	kàndài	/to look upon; to regard/
慷慨	kāngkǎi	/vehement; fervent/generous; magnanimous/
扛	káng	/old variant of 扛[gang1]/
抗议	kàngyì	/to protest/protest/
考察	kǎochá	/to inspect/to observe and study/on-the-spot investigation/
考古	kǎogǔ	/archaeology/
考核	kǎohé	/to examine/to check up on/to assess/to review/appraisal/review/evaluation/
考验	kǎoyàn	/to test/to put to the test/trial/ordeal/
靠拢	kàolǒng	/to draw close to/
磕	kē	/variant of 嗑[ke4]/
科目	kēmù	/academic subject/field of study/
渴望	kěwàng	/to thirst for/to long for/
可观	kěguān	/considerable/impressive/significant/
可口	kěkǒu	/tasty; to taste good/
可恶	kěwù	/repulsive/vile/hateful/abominable/
可行	kěxíng	/feasible/
刻不容缓	kèbùrónghuǎn	/to brook no delay/to demand immediate action/
课题	kètí	/task/problem/issue/
克制	kèzhì	/to restrain/to control/restraint/self-control/
客户	kèhù	/client/customer/
啃	kěn	/to gnaw/to nibble/to bite/
恳切	kěnqiè	/earnest/sincere/
坑	kēng	/variant of 坑[keng1]/
空洞	kōngdòng	/cavity/empty/vacuous/
空前绝后	kōngqiánjuéhòu	/unprecedented and never to be duplicated/the first and the last/unmatched/unique/
空想	kōngxiǎng	/daydream/fantasy/to fantasize/
空虚	kōngxū	/hollow/emptiness/meaningless/
孔	kǒng	/hole/CL:個|个[ge4]/classifier for cave dwellings/
恐怖	kǒngbù	/terrible/frightful/frightening/terror/terrorist/
恐吓	kǒnghè	/to threaten/to menace/
恐惧	kǒngjù	/to be frightened/fear/dread/
空白	kòngbái	/blank space/
空隙	kòngxì	/crack/gap between two objects/gap in time between two events/
口气	kǒuqì	/tone of voice/the way one speaks/manner of expression/tone/
口腔	kǒuqiāng	/oral cavity/
口头	kǒutóu	/oral/verbal/
口音	kǒuyīn	/voice/accent/
扣	kòu	/button/
哭泣	kūqì	/to weep/
枯燥	kūzào	/dry and dull; uninteresting; tedious/
枯萎	kūwěi	/to wilt/to wither/wilted/withered/drained/enervated/exhausted/
苦涩	kǔsè	/bitter and astringent/pained/agonized/
苦尽甘来	kǔjìngānlái	/bitterness finishes, sweetness begins (idiom); the hard times are over, the good times just beginning/
挎	kuà	/to carry (esp. slung over the arm, shoulder or side)/
跨	kuà	/to step across/to stride over/to straddle/to span/
快活	kuàihuo	/happy/cheerful/
宽敞	kuānchang	/spacious/wide/
宽容	kuānróng	/lenient/tolerant/indulgent/charitable/to forgive/
款待	kuǎndài	/to entertain/to be hospitable to/
款式	kuǎnshì	/elegant/elegance/good taste/
筐	kuāng	/basket/CL:隻|只[zhi1]/
旷课	kuàngkè	/to play truant/to cut classes/
框架	kuàngjià	/(construction) frame/(fig.) framework/
况且	kuàngqiě	/moreover/besides/in addition/furthermore/
矿产	kuàngchǎn	/minerals/
亏待	kuīdài	/to treat sb unfairly/
亏损	kuīsǔn	/deficit/(financial) loss/
捆绑	kǔnbǎng	/to bind/
扩充	kuòchōng	/to expand/
扩散	kuòsàn	/to spread; to proliferate; to diffuse/
扩张	kuòzhāng	/expansion/dilation/to expand (e.g. one's power or influence)/to broaden/
喇叭	lǎba	/horn (automobile etc)/loudspeaker/brass wind instrument/trumpet/suona 鎖吶|锁呐[suo3 na4]/
蜡烛	làzhú	/candle/CL:根[gen1],支[zhi1]/
啦	la	/sentence-final particle, contraction of 了啊, indicating exclamation/particle placed after each item in a list of examples/
来历	láilì	/history/antecedents/origin/
来源	láiyuán	/source (of information etc)/origin/
栏目	lánmù	/regular column or segment (in a publication or broadcast program)/program (TV or radio)/
懒惰	lǎnduò	/idle/lazy/
狼狈	lángbèi	/in a difficult situation/to cut a sorry figure/scoundrel! (derog.)/
狼吞虎咽	lángtūnhǔyàn	/to wolf down one's food (idiom); to devour ravenously/to gorge oneself/
捞	lāo	/to fish up/to dredge up/
唠叨	láodao	/to prattle/to chatter away/to nag/garrulous/nagging/
牢固	láogù	/firm/secure/
牢骚	láosāo	/discontent/complaint/to complain/
乐趣	lèqù	/delight; pleasure; joy/
乐意	lèyì	/to be willing to do sth/to be ready to do sth/to be happy to do sth/content/satisfied/
雷达	léidá	/radar (loanword)/
类似	lèisì	/similar; analogous/
冷酷	lěngkù	/unfeeling; callous/
冷却	lěngquè	/to cool (lit. and fig.)/
冷落	lěngluò	/desolate/unfrequented/to treat sb coldly/to snub/to cold shoulder/
愣	lèng	/to look distracted/to stare blankly/distracted/blank/(coll.) unexpectedly/rash/rashly/
黎明	límíng	/dawn; daybreak/
里程碑	lǐchéngbēi	/milestone/
礼节	lǐjié	/etiquette/
礼尚往来	lǐshàngwǎnglái	/lit. proper behavior is based on reciprocity (idiom)/fig. to return politeness for politeness/
理睬	lǐcǎi	/to heed/to pay attention to/
理所当然	lǐsuǒdāngrán	/as it should be by rights (idiom); proper and to be expected as a matter of course/inevitable and right/
理直气壮	lǐzhíqìzhuàng	/in the right and self-confident (idiom); bold and confident with justice on one's side/to have the courage of one's convictions/just and forceful/
理智	lǐzhì	/reason/intellect/rationality/rational/
粒	lì	/grain/granule/classifier for small round things (peas, bullets, peanuts, pills, grains etc)/
立场	lìchǎng	/position/standpoint/CL:個|个[ge4]/
立方	lìfāng	/cube (math.)/abbr. for 立方體|立方体[li4 fang1 ti3]/abbr. for 立方米[li4 fang1 mi3]/
立交桥	lìjiāoqiáo	/overpass/flyover/
立体	lìtǐ	/three-dimensional/solid/stereoscopic/
立足	lìzú	/to stand/to have a footing/to be established/to base oneself on/
历代	lìdài	/successive generations/successive dynasties/past dynasties/
历来	lìlái	/always/throughout (a period of time)/(of) all-time/
利害	lìhài	/terrible/formidable/serious/devastating/tough/capable/sharp/severe/fierce/
力所能及	lìsuǒnéngjí	/as far as one's capabilities extend (idiom); to the best of one's ability/within one's powers/
力争	lìzhēng	/to work hard for/to do all one can/to contend strongly/
力求	lìqiú	/to make every effort to/striving to do one's best/
例外	lìwài	/exception/to be an exception/
连年	liánnián	/successive years/over many years/
连锁	liánsuǒ	/to interlock/to be linked/chain (store etc)/
连同	liántóng	/together with/along with/
联欢	liánhuān	/to have a get-together/celebration/party/
联络	liánluò	/to get in touch with/to contact/to stay in contact (with)/liaison/(math.) connection/
联盟	liánméng	/alliance/union/coalition/
联想	liánxiǎng	/to associate (cognitively)/to make an associative connection/mental association/word prediction and auto-complete functions of input method editing programs/
廉洁	liánjié	/incorruptible; unbribable; honest/
良心	liángxīn	/conscience/
晾	liàng	/to dry in the air/(fig.) to cold-shoulder/
谅解	liàngjiě	/to understand/to make allowances for/understanding/
辽阔	liáokuò	/vast; extensive/
列举	lièjǔ	/a list/to list/to enumerate/
淋	lín	/to filter/to strain/to drain/gonorrhea/(TCM) strangury/
临床	línchuáng	/clinical/
吝啬	lìnsè	/stingy; mean; miserly/
零星	língxīng	/fragmentary/random/bits and pieces/sporadic/
凌晨	língchén	/very early in the morning/in the wee hours/
灵感	línggǎn	/inspiration/insight/a burst of creativity in scientific or artistic endeavor/
灵魂	línghún	/soul/spirit/
灵敏	língmǐn	/smart/clever/sensitive/keen/quick/sharp/
伶俐	línglì	/clever; witty; intelligent/
领会	lǐnghuì	/to understand/to comprehend/to grasp/
领事馆	lǐngshìguǎn	/consulate/
领土	lǐngtǔ	/territory/
领悟	lǐngwù	/to understand/to comprehend/
领先	lǐngxiān	/to lead/to be in front/
领袖	lǐngxiù	/leader/
溜	liū	/used in 冰溜[bing1 liu4]/
留恋	liúliàn	/reluctant to leave/to hate to have to go/to recall fondly/
留念	liúniàn	/to keep as a souvenir/to recall fondly/
留神	liúshén	/to take care/to be careful/
流浪	liúlàng	/to drift about/to wander/to roam/nomadic/homeless/unsettled (e.g. population)/vagrant/
流露	liúlù	/to reveal (indirectly, implicitly)/to show (interest, contempt etc) by means of one's actions, tone of voice etc/
流氓	liúmáng	/rogue/hoodlum/gangster/immoral behavior/
流通	liútōng	/to circulate; to distribute/circulation; distribution/
聋哑	lóngyǎ	/deaf and nonverbal/
隆重	lóngzhòng	/grand/prosperous/ceremonious/solemn/
垄断	lǒngduàn	/to monopolize/
笼罩	lǒngzhào	/to envelop/to shroud/
搂	lǒu	/to hug/to embrace/to hold in one's arms/
炉灶	lúzào	/stove/
轮船	lúnchuán	/steamship; steamer; steamboat/CL:艘[sou1]/
轮廓	lúnkuò	/outline; silhouette/
轮胎	lúntāi	/tire; pneumatic tire/
论坛	lùntán	/forum (for discussion)/
论证	lùnzhèng	/to prove a point/to expound on/to demonstrate or prove (through argument)/proof/
啰唆	luōsuo	/variant of 囉嗦|啰嗦[luo1 suo5]/
落成	luòchéng	/to complete a construction project/
落实	luòshí	/practical/workable/to implement/to carry out/to decide/
络绎不绝	luòyìbùjué	/(idiom) continuously; in an endless stream/
屡次	lǚcì	/repeatedly/time and again/
履行	lǚxíng	/to fulfill (one's obligations)/to carry out (a task)/to implement (an agreement)/to perform/
掠夺	lüèduó	/to plunder/to rob/
麻痹	mábì	/paralysis/palsy/numbness/to benumb/(fig.) to lull/negligent/apathetic/
麻木	mámù	/numb/insensitive/apathetic/
麻醉	mázuì	/anesthesia/to anesthetize; (fig.) to corrupt (sb's mind); to enervate; to numb the mind (to escape from harsh reality)/
码头	mǎtóu	/dock/pier/wharf/CL:個|个[ge4]/
蚂蚁	mǎyǐ	/ant/
嘛	ma	/modal particle indicating that sth is obvious/particle indicating a pause for emphasis/
埋伏	máifú	/to ambush/to lie in wait for/to lie low/ambush/
埋没	máimò	/to engulf/to bury/to overlook/to stifle/to neglect/to fall into oblivion/
埋葬	máizàng	/to bury/
迈	mài	/to take a step/to stride/
脉搏	màibó	/pulse (both medical and figurative)/
埋怨	mányuàn	/to complain/to grumble (about)/to reproach/to blame/
慢性	mànxìng	/slow and patient/chronic (disease)/slow to take effect (e.g. a slow poison)/
漫长	màncháng	/very long/endless/
漫画	mànhuà	/caricature/cartoon/Japanese manga/
蔓延	mànyán	/to extend/to spread/
忙碌	mánglù	/busy; bustling/
茫茫	mángmáng	/boundless/vast and obscure/
茫然	mángrán	/blankly/vacantly/at a loss/
盲目	mángmù	/blind/blindly/ignorant/lacking understanding/
冒充	màochōng	/to feign/to pretend to be/to pass oneself off as/
冒犯	màofàn	/to offend/
茂盛	màoshèng	/lush/
枚	méi	/classifier for coins, rings, badges, pearls, sporting medals, rockets, satellites etc/tree trunk/whip/wooden peg, used as a gag for marching soldiers (old)/
媒介	méijiè	/intermediary/vehicle/vector/medium/media/
美观	měiguān	/pleasing to the eye/beautiful/artistic/
美满	měimǎn	/happy/blissful/
美妙	měimiào	/beautiful/wonderful/splendid/
萌芽	méngyá	/to sprout (lit. or fig.)/to bud/to germinate/germ/seed/bud/
猛烈	měngliè	/fierce; violent; vigorous; intense/
眯	mī	/to narrow one's eyes/to squint/(dialect) to take a nap/
弥补	míbǔ	/to complement/to make up for a deficiency/
弥漫	mímàn	/variant of 彌漫|弥漫[mi2 man4]/
迷惑	míhuò	/to puzzle/to confuse/to baffle/
迷人	mírén	/fascinating/enchanting/charming/tempting/
迷信	míxìn	/superstition/to have a superstitious belief (in sth)/
谜语	míyǔ	/riddle/conundrum/CL:條|条[tiao2]/
密度	mìdù	/density/thickness/
密封	mìfēng	/to seal up/
棉花	miánhua	/cotton/
免得	miǎndé	/so as not to; so as to avoid/
免疫	miǎnyì	/immunity (to disease)/
勉励	miǎnlì	/to encourage/
勉强	miǎnqiǎng	/to do with difficulty/to force sb to do sth/reluctant/barely enough/
面貌	miànmào	/face; features/appearance; look/CL:個|个[ge4]/
面子	miànzi	/(medicinal) powder/
描绘	miáohuì	/to describe; to depict; to portray/
瞄准	miáozhǔn	/to take aim at; to target/
渺小	miǎoxiǎo	/minute/tiny/negligible/insignificant/
藐视	miǎoshì	/to despise/to look down on/
蔑视	mièshì	/to loathe/to despise/contempt/
灭亡	mièwáng	/to be destroyed; to become extinct; to perish; to die out/to destroy; to exterminate/
民间	mínjiān	/among the people/popular/folk/non-governmental/involving people rather than governments/
民主	mínzhǔ	/democracy/
敏捷	mǐnjié	/nimble/quick/shrewd/
敏锐	mǐnruì	/keen; sharp; acute/
明明	míngmíng	/obviously/plainly/undoubtedly/definitely/
明智	míngzhì	/sensible/wise/judicious/sagacious/
名次	míngcì	/position in a ranking of names/place/rank/
名额	míng’é	/quota/number of places/place (in an institution, a group etc)/
名副其实	míngfùqíshí	/not just in name only, but also in reality (idiom)/aptly named/worthy of the name/
名誉	míngyù	/fame/reputation/honor/honorary/emeritus (of retired professor)/
命名	mìngmíng	/to give a name to/to dub/to christen/to designate/named after/naming/
摸索	mōsuǒ	/to feel about/to grope about/to fumble/to do things slowly/
膜	mó	/membrane/film/
摩擦	mócā	/friction/rubbing/chafing/fig. disharmony/conflict/also written 磨擦/
磨合	móhé	/to break in/to wear in/
模范	mófàn	/model/fine example/
模式	móshì	/mode/method/pattern/
模型	móxíng	/model/mold/matrix/pattern/
魔鬼	móguǐ	/devil/
魔术	móshù	/magic/
抹杀	mǒshā	/to erase/to cover traces/to obliterate evidence/to expunge/to blot out/to suppress/
莫名其妙	mòmíng-qímiào	/(idiom) baffling; bizarre; without rhyme or reason; inexplicable/
默默	mòmò	/in silence; not speaking/
墨水儿	mòshuǐr	/erhua variant of 墨水[mo4 shui3]/
谋求	móuqiú	/to seek; to strive for/
模样	múyàng	/look/style/appearance/approximation/about/CL:個|个[ge4]/also pr. [mo2 yang4]/
母语	mǔyǔ	/native language/mother tongue/(linguistics) parent language/
目睹	mùdǔ	/to witness/to see at first hand/to see with one's own eyes/
目光	mùguāng	/gaze; (fig.) attention/expression in one's eyes; look/(lit. and fig.) sight; vision/
沐浴	mùyù	/to take a bath/to bathe/to immerse/
拿手	náshǒu	/expert in/good at/
纳闷儿	nàmènr	/erhua variant of 納悶|纳闷[na4 men4]/
耐用	nàiyòng	/durable/
南辕北辙	nányuánběizhé	/to act in a way that defeats one's purpose (idiom)/
难得	nándé	/seldom/rare/hard to come by/
难堪	nánkān	/hard to take/embarrassed/
难能可贵	nánnéngkěguì	/rare and precious/valuable/remarkable/
恼火	nǎohuǒ	/annoyed; riled; vexed/
内涵	nèihán	/meaningful content/implication/(semantics) connotation/inner qualities (of a person)/
内幕	nèimù	/inside story/non-public information/behind the scenes/internal/
内在	nèizài	/inner/internal/intrinsic/innate/
能量	néngliàng	/energy/capabilities/
拟定	nǐdìng	/to draw up/to draft/to formulate/
逆行	nìxíng	/to go the wrong way/to go against one-way traffic regulation/
年度	niándù	/year (e.g. school year, fiscal year)/annual/
捏	niē	/variant of 捏[nie1]/
拧	níng	/stubborn/
凝固	nínggù	/to freeze/to solidify/to congeal/fig. with rapt attention/
凝聚	níngjù	/to condense/to coagulate/coacervation (i.e. form tiny droplets)/aggregation/coherent/
凝视	níngshì	/to gaze at/to fix one's eyes on/
宁肯	nìngkěn	/would rather.../it would be better.../would prefer/
宁愿	nìngyuàn	/would rather ... (than ...)/
纽扣儿	niǔkòur	button
扭转	niǔzhuǎn	/to reverse/to turn around (an undesirable situation)/(mechanics) torsion/
浓厚	nónghòu	/dense/thick (fog, clouds etc)/to have a strong interest in/deep/fully saturated (color)/
农历	nónglì	/the traditional Chinese calendar/the lunar calendar/
奴隶	núlì	/slave/
挪	nuó	/to shift/to move/
虐待	nüèdài	/to mistreat/to maltreat/to abuse/mistreatment/maltreatment/
哦	o	/sentence-final particle that conveys informality, warmth, friendliness or intimacy/may also indicate that one is stating a fact that the other person is not aware of/
殴打	ōudǎ	/to beat up/to come to blows/battery (law)/
偶像	ǒuxiàng	/idol/
呕吐	ǒutù	/to vomit/
趴	pā	/to lie on one's stomach/to lean forward, resting one's upper body (on a desktop etc)/(Tw) percent/
排斥	páichì	/to reject/to exclude/to eliminate/to remove/to repel/
排除	páichú	/to eliminate/to remove/to exclude/to rule out/
排练	páiliàn	/to rehearse/rehearsal/
排放	páifàng	/to arrange in order/to emit; to discharge (exhaust gas, waste water etc)/(of animals) to ovulate; to discharge semen/
徘徊	páihuái	/to pace back and forth/to dither; to hesitate/(of sales figures etc) to fluctuate/
派别	pàibié	/group; sect; clique; faction; school/
派遣	pàiqiǎn	/to send (on a mission); to dispatch/
攀登	pāndēng	/to climb/to pull oneself up/to clamber/to scale/fig. to forge ahead in the face of hardships and danger/
盘旋	pánxuán	/to spiral/to circle/to go around/to hover/to orbit/
畔	pàn	/(bound form) side; edge; boundary/
判决	pànjué	/judgment (by a court of law)/to pass judgment on/to sentence/
庞大	pángdà	/huge; enormous; tremendous/
抛弃	pāoqì	/to abandon/to discard/to renounce/to dump (sb)/
泡沫	pàomò	/foam/(soap) bubble/(economic) bubble/
培育	péiyù	/to train/to breed/
配备	pèibèi	/to allocate/to provide/to outfit with/
配偶	pèi’ǒu	/spouse/
配套	pèitào	/to form a complete set/compatible/matching/complementary/
盆地	péndì	/(geography) basin/depression/
烹饪	pēngrèn	/cooking; culinary arts/
捧	pěng	/to hold or offer with both hands/to sing the praises of/classifier for what can be held in both hands/
劈	pī	/to split in two/to divide/
批发	pīfā	/wholesale/bulk trade/distribution/
批判	pīpàn	/to criticize/critique/CL:個|个[ge4]/
疲惫	píbèi	/beaten/exhausted/tired/
疲倦	píjuàn	/to tire/tired/
皮革	pígé	/leather/CL:張|张[zhang1]/
屁股	pìgu	/buttocks/bottom/butt/back part/
譬如	pìrú	/for example/for instance/such as/
偏差	piānchā	/bias/deviation/
偏见	piānjiàn	/prejudice/bias/
偏僻	piānpì	/remote/desolate/far from the city/
偏偏	piānpiān	/(indicating that sth turns out just the opposite of what one would wish) unfortunately; as it happened/(indicating that sth is the opposite of what would be normal or reasonable) stubbornly; contrarily; against reason/(indicating that sb or a group is singled out) precisely; only; of all people/
片断	piànduàn	/section/fragment/segment/
片刻	piànkè	/short period of time/a moment/
飘扬	piāoyáng	/to wave/to flutter/to fly/
漂浮	piāofú	/to float/to hover/to drift (also fig., to lead a wandering life)/to rove/showy/superficial/
撇	piē	/to throw/to cast/left-slanting downward brush stroke (calligraphy)/
拼搏	pīnbó	/to struggle/to wrestle/
拼命	pīnmìng	/to do one's utmost; with all one's might; at all costs; (to work or fight) as if one's life depends on it/
频繁	pínfán	/frequently/often/
频率	pínlǜ	/frequency/
贫乏	pínfá	/impoverished/lacking/deficient/limited/meager/impoverishment/lack/deficiency/
贫困	pínkùn	/impoverished/poverty/
品尝	pǐncháng	/to taste a small amount/to sample/
品德	pǐndé	/moral character/
品质	pǐnzhì	/character/intrinsic quality (of a person)/quality (of a product or service, or as in "quality of life", "air quality" etc)/
品种	pǐnzhǒng	/breed/variety/CL:個|个[ge4]/
平凡	píngfán	/commonplace/ordinary/mediocre/
平面	píngmiàn	/plane (flat surface)/print media/
平坦	píngtǎn	/level/even/smooth/flat/
平行	píngxíng	/parallel/of equal rank/simultaneous/
平原	píngyuán	/field/plain/CL:個|个[ge4]/
平庸	píngyōng	/mediocre/indifferent/commonplace/
评估	pínggū	/to evaluate/to assess/assessment/evaluation/
评论	pínglùn	/to comment on/to discuss/comment/commentary/CL:篇[pian1]/
屏障	píngzhàng	/barrier/
屏幕	píngmù	/screen (TV, computer or movie)/
坡	pō	/slope/CL:個|个[ge4]/sloping/slanted/
泼	pō	/to splash/to spill/rough and coarse/brutish/
颇	pō	/rather/quite/considerably/oblique/inclined/slanting/Taiwan pr. [po3]/
破例	pòlì	/to make an exception/
迫不及待	pòbùjídài	/impatient (idiom); in a hurry/itching to get on with it/
迫害	pòhài	/to persecute/
魄力	pòlì	/courage/daring/boldness/resolution/drive/
扑	pū	/to throw oneself at/to pounce on/to devote one's energies/to flap/to flutter/to dab/to pat/to bend over/
铺	pū	/plank bed/place to sleep/shop/store/(old) relay station/
普及	pǔjí	/to spread extensively/to generalize/widespread/popular/universal/ubiquitous/pervasive/
朴实	pǔshí	/plain/simple/guileless/down-to-earth/sincere and honest/
朴素	pǔsù	/plain and simple/unadorned/simple living/not frivolous/
瀑布	pùbù	/waterfall/
期望	qīwàng	/to have expectations/to earnestly hope/expectation/hope/
期限	qīxiàn	/time limit/deadline/allotted time/
欺负	qīfu	/to bully/
欺骗	qīpiàn	/to deceive/to cheat/
凄凉	qīliáng	/desolate (place)/
奇妙	qímiào	/fantastic; wonderful/
旗袍	qípáo	/Chinese-style dress/cheongsam/
旗帜	qízhì	/ensign/flag/
齐全	qíquán	/complete/comprehensive/
齐心协力	qíxīn-xiélì	/to work with a common purpose (idiom); to make concerted efforts/to pull together/to work as one/
歧视	qíshì	/to discriminate against/discrimination/
起草	qǐcǎo	/to make a draft/to draw up (plans)/
起初	qǐchū	/originally; at first; at the outset/
起伏	qǐfú	/to move up and down/to undulate/ups and downs/
起哄	qǐhòng	/to heckle/rowdy jeering/to create a disturbance/
起码	qǐmǎ	/at the minimum; at the very least/
起源	qǐyuán	/origin/to originate/to come from/
启程	qǐchéng	/to set out on a journey/
启示	qǐshì	/to reveal/to enlighten/enlightenment/revelation/illumination/moral (of a story etc)/lesson/
启事	qǐshì	/announcement (written, on billboard, letter, newspaper or website)/to post information/a notice/
启蒙	qǐméng	/to instruct the young/to initiate/to awake sb from ignorance/to free sb from prejudice or superstition/primer/enlightened/the Enlightenment/Western learning from the late Qing dynasty/
乞丐	qǐgài	/beggar/
企图	qǐtú	/to attempt/to try/attempt/CL:種|种[zhong3]/
岂有此理	qǐyǒu-cǐlǐ	/how can this be so? (idiom); preposterous/ridiculous/absurd/
器材	qìcái	/equipment/material/
器官	qìguān	/(physiology) organ; apparatus/
气概	qìgài	/lofty quality/mettle/spirit/
气功	qìgōng	/qigong, a traditional Chinese system of cultivating vital energy 氣|气[qi4] through coordinated breathing, movement and meditation/
气魄	qìpò	/spirit/boldness/positive outlook/imposing attitude/
气色	qìsè	/complexion/
气势	qìshì	/imposing manner/loftiness/grandeur/energetic looks/vigor/
气味	qìwèi	/odor; scent/
气象	qìxiàng	/meteorological feature/CL:個|个[ge4]/meteorology/atmosphere/ambience/scene/
气压	qìyā	/atmospheric pressure/barometric pressure/
气质	qì zhì	/personality traits; temperament; disposition/aura; air; feel; vibe/refinement; sophistication; class/
迄今为止	qìjīn-wéizhǐ	/so far/up to now/still (not)/
掐	qiā	/to pick (flowers)/to pinch/to nip/to pinch off/to clutch/(slang) to fight/
恰当	qiàdàng	/appropriate/suitable/
恰到好处	qiàdàohǎochù	/it's just perfect/it's just right/
恰巧	qiàqiǎo	/by chance; as chance would have it/
洽谈	qiàtán	/to discuss/
牵	qiān	/to lead along/to pull (an animal on a tether)/(bound form) to involve/to draw in/
牵扯	qiānchě	/to involve; to implicate/to be interrelated/
牵制	qiānzhì	/to control/to curb/to restrict/to impede/to pin down (enemy troops)/
千方百计	qiānfāng-bǎijì	/lit. thousand ways, a hundred plans (idiom); by every possible means/
签署	qiānshǔ	/to sign (an agreement)/
迁就	qiānjiù	/to yield to; to adapt to; to accommodate oneself to (sth)/
迁徙	qiānxǐ	/to migrate/to move/
谦逊	qiānxùn	/humble/modest/unpretentious/modesty/
前景	qiánjǐng	/foreground/vista/(future) prospects/perspective/
前提	qiántí	/premise/precondition/prerequisite/
潜力	qiánlì	/potential; latent capacity/
潜水	qiánshuǐ	/to dive/to go under water/(in an online forum) to lurk/
潜移默化	qiányí-mòhuà	/imperceptible influence/to influence secretly/
谴责	qiǎnzé	/to denounce/to condemn/to criticize/condemnation/criticism/
强制	qiángzhì	/to force; to compel; to coerce/forced; compulsory/Taiwan pr. [qiang3 zhi4]/
抢劫	qiǎngjié	/to rob/looting/
抢救	qiǎngjiù	/to rescue/
强迫	qiǎngpò	/to compel/to force/
桥梁	qiáoliáng	/bridge (lit. and fig.)/
翘	qiào	/to stick up/to rise on one end/to tilt/
窍门	qiàomén	/a trick/an ingenious method/know-how/the knack (of doing sth)/
锲而不舍	qiè’érbùshě	/to chip away at a task and not abandon it (idiom); to chisel away at sth/to persevere/unflagging efforts/
切实	qièshí	/feasible/realistic/practical/earnestly/conscientiously/
亲密	qīnmì	/intimate/close/
亲热	qīnrè	/affectionate; intimate; warmhearted/to show affection for/(coll.) to get intimate with sb/
侵犯	qīnfàn	/to infringe on/to encroach on/to violate/to assault/
侵略	qīnlüè	/to invade/invasion/
钦佩	qīnpèi	/to admire/to look up to/to respect sb greatly/
勤俭	qínjiǎn	/hardworking and frugal/
勤劳	qínláo	/hardworking/industrious/diligent/
清澈	qīngchè	/clear; limpid/
清晨	qīngchén	/early morning/
清除	qīngchú	/to clear away/to eliminate/to get rid of/
清洁	qīngjié	/clean/to clean/
清理	qīnglǐ	/to clear up/to tidy up/to dispose of/
清晰	qīngxī	/clear; distinct/
清醒	qīngxǐng	/clear-headed/sober/awake/
清真	qīngzhēn	/Islamic/Muslim/halal (of food)/clean/pure/
倾听	qīngtīng	/to listen attentively/
倾向	qīngxiàng	/trend/tendency/orientation/
倾斜	qīngxié	/to incline/to lean/to slant/to slope/to tilt/
晴朗	qínglǎng	/sunny and cloudless/
情报	qíngbào	/information; intelligence/
情节	qíngjié	/circumstances/plot; storyline/
情理	qínglǐ	/reason/sense/
情形	qíngxíng	/circumstances/situation/CL:個|个[ge4]/
请柬	qǐngjiǎn	/invitation card/written invitation/
请教	qǐngjiào	/to ask for guidance/to consult/
请示	qǐngshì	/to ask for instructions/
请帖	qǐngtiě	/invitation card/written invitation/
丘陵	qiūlíng	/hills/
区分	qūfēn	/to differentiate/to draw a distinction/to divide into categories/
区域	qūyù	/area/region/district/
屈服	qūfú	/to surrender/to succumb/to yield/(as a transitive verb) to defeat/to prevail over/
曲折	qūzhé	/winding/(fig.) complicated/
驱逐	qūzhú	/to expel/to deport/banishment/
渠道	qúdào	/irrigation ditch/(fig.) channel/means/
取缔	qǔdì	/to suppress; to crack down on; to prohibit/
曲子	qǔzi	/poem for singing/tune/music/CL:支[zhi1]/
趣味	qùwèi	/fun; interest; delight/taste; liking; preference/
圈套	quāntào	/trap; snare; trick/
全局	quánjú	/overall situation/
全力以赴	quánlìyǐfù	/to do at all costs/to make an all-out effort/
权衡	quánhéng	/to consider/to weigh (a matter)/to balance (pros and cons)/
权威	quánwēi	/authority/authoritative/power and prestige/
拳头	quántou	/fist/clenched fist/CL:個|个[ge4]/competitive (product)/
犬	quǎn	/dog/Kangxi radical 94/
缺口	quēkǒu	/nick/jag/gap/shortfall/
缺席	quēxí	/to be absent/
缺陷	quēxiàn	/defect; flaw/
瘸	qué	/lame/
确保	quèbǎo	/to ensure; to guarantee/
确立	quèlì	/to establish/to institute/
确切	quèqiè	/definite/exact/precise/
确信	quèxìn	/to be convinced/to be sure/to firmly believe/to be positive that/definite news/
群众	qúnzhòng	/mass/multitude/the masses/
染	rǎn	/to dye/to catch (a disease)/to acquire (bad habits etc)/to contaminate/to add color washes to a painting/
嚷	rǎng	/to shout/to bellow/to make a big deal of sth/to make a fuss about sth/
让步	ràngbù	/to concede/to give in/to yield/a concession/(linguistics) concessive/
饶恕	ráoshù	/to forgive/to pardon/to spare/
扰乱	rǎoluàn	/to disturb/to perturb/to harass/
惹祸	rěhuò	/to stir up trouble/to invite disaster/
热泪盈眶	rèlèi-yíngkuàng	/eyes brimming with tears of excitement (idiom)/extremely moved/
热门	rèmén	/popular; hot; in vogue/
人道	réndào	/human sympathy/humanitarianism/humane/the "human way", one of the stages in the cycle of reincarnation (Buddhism)/sexual intercourse/
人格	réngé	/personality/integrity/dignity/
人工	réngōng	/artificial/manpower/manual work/
人家	rénjiā	/other people/sb else/he, she or they/I, me (referring to oneself as "one" or "people")/
人间	rénjiān	/the human world/the earth/
人士	rénshì	/person/figure/public figure/
人为	rénwéi	/artificial/man-made/having human cause or origin/human attempt or effort/
人性	rénxìng	/human nature/humanity/human/the totality of human attributes/
人质	rénzhì	/hostage/
仁慈	réncí	/benevolent/charitable/kind/kindly/kindness/merciful/
忍耐	rěnnài	/to endure/to bear with/to exercise patience/to restrain oneself/patience/endurance/
忍受	rěnshòu	/to bear; to endure/
认定	rèndìng	/to maintain (that sth is true)/to determine (a fact)/determination (of an amount)/of the firm opinion/to believe firmly/to set one's mind on/to identify with/
认可	rènkě	/to approve/approval/acknowledgment/OK/
任命	rènmìng	/to appoint/(job) appointment/CL:紙|纸[zhi3]/
任性	rènxìng	/willful/headstrong/unruly/
任意	rènyì	/any/arbitrary/at will/at random/
任重道远	rènzhòng-dàoyuǎn	/a heavy load and a long road/fig. to bear heavy responsibilities through a long struggle (cf Confucian Analects, 8.7)/
仍旧	réngjiù	/still (remaining)/to remain (the same)/yet/
日新月异	rìxīn-yuèyì	/daily renewal, monthly change (idiom)/every day sees new developments/rapid progress/
日益	rìyì	/day by day/more and more/increasingly/more and more with each passing day/
融化	rónghuà	/to melt/to thaw/to dissolve/to blend into/to combine/to fuse/
融洽	róngqià	/harmonious/friendly relations/on good terms with one another/
溶解	róngjiě	/to dissolve/
容貌	róngmào	/one's appearance/one's aspect/looks/features/
容纳	róngnà	/to hold/to contain/to accommodate/to tolerate (different opinions)/
容器	róngqì	/receptacle/vessel/(computing) container/
容忍	róngrěn	/to put up with/to tolerate/
荣幸	róngxìng	/honored (to have the privilege of ...)/
荣誉	róngyù	/honor/credit/glory/(honorable) reputation/honorary/
揉	róu	/to knead/to massage/to rub/
柔和	róuhé	/gentle/soft/
儒家	rújiā	/Confucian school, founded by Confucius 孔子[Kong3 zi3] (551-479 BC) and Mencius 孟子[Meng4 zi3] (c. 372-c. 289 BC)/
弱点	ruòdiǎn	/weak point/failing/
若干	ruògān	/a certain number or amount/how many?/how much?/
撒谎	sāhuǎng	/to tell lies/
散文	sǎnwén	/prose/essay/
散布	sànbù	/to disseminate/
散发	sànfā	/to distribute/to emit/to issue/
丧失	sàngshī	/to lose/to forfeit/
骚扰	sāorǎo	/to disturb/to cause a commotion/to harass/
嫂子	sǎozi	/(coll.) older brother's wife; sister-in-law/
刹车	shāchē	/to brake (when driving)/to stop/to switch off/to check (bad habits)/a brake/
啥	shá	/dialectal equivalent of 什麼|什么[shen2 me5]/also pr. [sha4]/
筛选	shāixuǎn	/to filter/
山脉	shānmài	/mountain range/CL:條|条[tiao2]/
闪烁	shǎnshuò	/flickering/twinkling/evasive/vague (of speech)/
擅长	shàncháng	/to be good at; to be expert in/
擅自	shànzì	/without permission/
商标	shāngbiāo	/trademark/logo/
伤脑筋	shāngnǎojīn	/to be a real headache/to find sth a real headache/to beat one's brains/
上级	shàngjí	/higher authorities/superiors/CL:個|个[ge4]/
上进	shàngjìn	/to make progress/to do better/fig. ambitious to improve oneself/to move forwards/
上任	shàngrèn	/to take office/previous (incumbent)/predecessor/
上瘾	shàngyǐn	/to get into a habit/to become addicted/
上游	shàngyóu	/upper reaches (of a river)/upper level/upper echelon/upstream/
尚且	shàngqiě	/(not) even/yet/still/
捎	shāo	/to bring sth to sb/to deliver/
梢	shāo	/tip of branch/
哨	shào	/a whistle/sentry/
奢侈	shēchǐ	/luxurious/extravagant/
舌头	shétou	/tongue/CL:個|个[ge4]/enemy soldier captured for the purpose of extracting information/
设立	shèlì	/to set up; to establish/
设想	shèxiǎng	/to imagine/to assume/to envisage/tentative plan/to have consideration for/
设置	shèzhì	/to set up; to install/
社区	shèqū	/community/neighborhood/
涉及	shèjí	/to involve; to relate to; to concern; to touch upon/
摄氏度	shèshìdù	/°C (degrees Celsius)/
深奥	shēn’ào	/profound/abstruse/recondite/profoundly/
深沉	shēnchén	/deep/profound/(of a person) reserved/undemonstrative/(of a voice, sound etc) deep/low-pitched/
深情厚谊	shēnqíng-hòuyì	/deep friendship/
申报	shēnbào	/to report (to the authorities)/to declare (to customs)/
绅士	shēnshì	/gentleman/
呻吟	shēnyín	/to moan; to groan/
神经	shénjīng	/nerve/mental state/(coll.) unhinged/nutjob/
神奇	shénqí	/magical/mystical/miraculous/
神气	shénqì	/expression/manner/vigorous/impressive/lofty/pretentious/
神圣	shénshèng	/divine/hallow/holy/sacred/
神态	shéntài	/appearance/manner/bearing/deportment/look/expression/mien/
神仙	shénxiān	/Daoist immortal/supernatural entity/(in modern fiction) fairy, elf, leprechaun etc/fig. lighthearted person/
审查	shěnchá	/to examine/to investigate/to censor out/censorship/
审理	shěnlǐ	/to hear (a case)/
审美	shěnměi	/esthetics/appreciating the arts/taste/
审判	shěnpàn	/a trial/to try sb/
渗透	shèntòu	/(lit. and fig.) to permeate/to seep into/(of a product, idea etc) to penetrate (in a population)/(of hostile forces) to infiltrate/(chemistry) osmosis/
慎重	shènzhòng	/cautious/careful/prudent/
生存	shēngcún	/to exist/to survive/
生机	shēngjī	/opportunity to live; hope of success/vigor; vitality/
生理	shēnglǐ	/physiology/
生疏	shēngshū	/unfamiliar/strange/out of practice/not accustomed/
生态	shēngtài	/ecology/
生物	shēngwù	/organism/living creature/life form/biological/CL:個|个[ge4]/
生肖	shēngxiào	/one of the twelve animals symbolic of the earthly branches 地支[di4 zhi1]/animal from the Chinese zodiac/
生效	shēngxiào	/to take effect/to go into effect/
生锈	shēngxiù	/to rust/to grow rusty/to corrode/oxidization/
生育	shēngyù	/to give birth to; to bear/fertility/
牲畜	shēngchù	/farm animal; livestock/
声明	shēngmíng	/to state/to declare/statement/declaration/CL:項|项[xiang4],份[fen4]/
声势	shēngshì	/fame and power/prestige/influence/impetus/momentum/
声誉	shēngyù	/reputation/fame/
省会	shěnghuì	/provincial capital/
盛产	shèngchǎn	/to produce in abundance/to be rich in/
盛开	shèngkāi	/blooming/in full flower/
盛情	shèngqíng	/great kindness/magnificent hospitality/
盛行	shèngxíng	/to be in vogue; to be popular; to be prevalent/
胜负	shèngfù	/victory or defeat/the outcome of a battle/
失事	shīshì	/(of a plane, ship etc) to have an accident (plane crash, shipwreck, vehicle collision etc)/to mess things up/
失误	shīwù	/lapse/mistake/to make a mistake/fault/service fault (in volleyball, tennis etc)/
失踪	shīzōng	/to be missing/to disappear/unaccounted for/
师范	shīfàn	/teacher-training/pedagogical/normal (school, e.g. Beijing Normal University)/
施加	shījiā	/to exert (effort or pressure)/
施展	shīzhǎn	/to use fully/to put to use/
尸体	shītǐ	/dead body/corpse/carcass/CL:具[ju4]/
拾	shí	/to pick up/to collate or arrange/ten (banker's anti-fraud numeral)/
十足	shízú	/ample/complete/hundred percent/a pure shade (of some color)/
识别	shíbié	/to distinguish; to discern; to identify; to recognize/
时常	shícháng	/often/frequently/
时而	shí’ér	/occasionally/from time to time/
时光	shíguāng	/time/era/period of time/
时机	shíjī	/opportunity; opportune moment/
时事	shíshì	/current trends; the present situation; how things are going/
实惠	shíhuì	/tangible benefit/material advantages/cheap/economical/advantageous (deal)/substantial (discount)/
实力	shílì	/strength/
实施	shíshī	/to implement/to carry out/
实事求是	shíshìqiúshì	/lit. to seek truth from facts (idiom)/fig. to be practical and realistic/
实行	shíxíng	/to implement/to carry out/to put into practice/
实质	shízhì	/substance/essence/
石油	shíyóu	/oil/petroleum/
使命	shǐmìng	/mission/long-term task to which one devotes oneself/a calling/
是非	shìfēi	/right and wrong/quarrel/
试图	shìtú	/to attempt/to try/
试验	shìyàn	/experiment/test/CL:次[ci4],個|个[ge4]/to experiment/experimental/
势必	shìbì	/to be bound to/undoubtedly will/
势力	shìlì	/power/influence/a force (military, political etc)/
世代	shìdài	/for many generations/generation/era/age/
示范	shìfàn	/to demonstrate/to show how to do sth/demonstration/a model example/
示威	shìwēi	/to demonstrate (as a protest)/a demonstration/a military show of force/
示意	shìyì	/to hint/to indicate (an idea to sb)/
释放	shìfàng	/to release/to set free/to liberate (a prisoner)/to discharge/
事故	shìgù	/accident/CL:樁|桩[zhuang1],起[qi3],次[ci4]/
事迹	shìjì	/deed/past achievement/important event of the past/
事件	shìjiàn	/event/happening/incident/CL:個|个[ge4]/
事态	shìtài	/situation/existing state of affairs/
事务	shìwù	/(political, economic etc) affairs/work/transaction (as in a computer database)/
事项	shìxiàng	/matter/item/
事业	shìyè	/undertaking/project/activity/(charitable, political or revolutionary) cause/publicly funded institution, enterprise or foundation/career/occupation/CL:個|个[ge4]/
适宜	shìyí	/suitable/appropriate/
视力	shìlì	/vision/eyesight/
视频	shìpín	/video/
视线	shìxiàn	/line of sight/
视野	shìyě	/field of view/(fig.) outlook; perspective/
逝世	shìshì	/to pass away/to die/
收藏	shōucáng	/to collect (works of art, dolls, antiques etc); to put away for safekeeping; (Internet) to bookmark/a collection/
收缩	shōusuō	/to pull back/to shrink/to contract/(physiology) systole/
收益	shōuyì	/earnings/profit/
收音机	shōuyīnjī	/radio/CL:臺|台[tai2]/
手法	shǒufǎ	/technique/trick/skill/
手势	shǒushì	/gesture; sign; signal/
手艺	shǒuyì	/craftmanship/workmanship/handicraft/trade/
首要	shǒuyào	/the most important/of chief importance/
首饰	shǒushì	/jewelry/head ornament/
守护	shǒuhù	/to guard/to protect/
受罪	shòuzuì	/to endure/to suffer/hardships/torments/a hard time/a nuisance/
授予	shòuyǔ	/to award/to confer/
书法	shūfǎ	/calligraphy/handwriting/penmanship/
书籍	shūjí	/books/works/
书记	shūjì	/secretary (chief official of a branch of a socialist or communist party)/clerk/scribe/
书面	shūmiàn	/in writing/written/
舒畅	shūchàng	/happy; entirely free from worry/
疏忽	shūhū	/to neglect/to overlook/negligence/carelessness/
疏远	shūyuǎn	/to drift apart/to become estranged/to alienate/estrangement/
竖	shù	/to erect/vertical/vertical stroke (in Chinese characters)/
束	shù	/to bind/bunch/bundle/classifier for bunches, bundles, beams of light etc/to control/
束缚	shùfù	/to bind; to tie up; to fetter; to shackle/
树立	shùlì	/to set up/to establish/
数额	shù’é	/amount/sum of money/fixed number/
耍	shuǎ	/to play with/to wield/to act (cool etc)/to display (a skill, one's temper etc)/
衰老	shuāilǎo	/to age/to deteriorate with age/old and weak/
衰退	shuāituì	/to decline/to fall/to drop/to falter/a decline/recession (in economics)/
率领	shuàilǐng	/to lead/to command/to head/
涮火锅	shuànhuǒguō	/see 涮鍋子|涮锅子[shuan4 guo1 zi5]/
双胞胎	shuāngbāotāi	/twin/CL:對|对[dui4]/
爽快	shuǎngkuài	/refreshed/rejuvenated/frank and straightforward/
水利	shuǐlì	/water conservancy/irrigation works/
水龙头	shuǐlóngtóu	/faucet/tap/
水泥	shuǐní	/cement/CL:袋[dai4]/
瞬间	shùnjiān	/in an instant; in a flash/
司法	sīfǎ	/judicial/(administration of) justice/
司令	sīlìng	/commanding officer/
思念	sīniàn	/to think of/to long for/to miss/
思索	sīsuǒ	/to think deeply/to ponder/
思维	sīwéi	/(line of) thought/thinking/
私自	sīzì	/private; personal/secretly; without explicit approval/
斯文	sīwen	/refined/educate/cultured/intellectual/polite/gentle/
死亡	sǐwáng	/to die/death/
四肢	sìzhī	/the four limbs of the body/
寺庙	sìmiào	/temple/monastery/shrine/
肆无忌惮	sìwújìdàn	/absolutely unrestrained/unbridled/without the slightest scruple/
饲养	sìyǎng	/to raise/to rear/
耸	sǒng	/to excite/to raise up/to shrug/high/lofty/towering/
艘	sōu	/classifier for ships/Taiwan pr. [sao1]/
苏醒	sūxǐng	/to come to/to awaken/to regain consciousness/
俗话	súhuà	/common saying/proverb/
塑造	sùzào	/to model; to mold/(fig.) to create (a character, a market, an image etc)/(fig.) (literature) to portray (in words)/
素食	sùshí	/vegetarian food/to eat a vegetarian diet/
素质	sùzhì	/inner quality/basic essence/
诉讼	sùsòng	/lawsuit/
算数	suànshù	/to count numbers/to keep to one's word/to hold (i.e. to remain valid)/to count (i.e. to be important)/
随即	suíjí	/immediately/presently/following which/
随意	suíyì	/as one wishes/according to one's wishes/at will/voluntary/conscious/
岁月	suìyuè	/years/time/
隧道	suìdào	/tunnel/
损坏	sǔnhuài	/to damage/to injure/
索性	suǒxìng	/you might as well (do it)/simply/just/
索取	suǒqǔ	/to ask/to demand/
塌	tā	/to collapse/to droop/to settle down/
踏实	tāshi	/firmly-based/steady/steadfast/to have peace of mind/free from anxiety/Taiwan pr. [ta4 shi2]/
塔	tǎ	/old variant of 塔[ta3]/
台风	táifēng	/typhoon/
太空	tàikōng	/outer space/
泰斗	tàidǒu	/(abbr. for 泰山北斗[Tai4 Shan1 Bei3 dou3]) distinguished figure/doyen/revered authority/
瘫痪	tānhuàn	/paralysis/be paralyzed (body, transportation, etc)/
贪婪	tānlán	/avaricious/greedy/rapacious/insatiable/avid/
贪污	tānwū	/to be corrupt/corruption/to embezzle/
摊	tān	/to spread out/vendor's stand/
弹性	tánxìng	/flexibility/elasticity/
坦白	tǎnbái	/honest/forthcoming/to confess/
探测	tàncè	/to probe; to survey/
探索	tànsuǒ	/to explore; to probe/
探讨	tàntǎo	/to investigate/to probe/
探望	tànwàng	/to visit/to call on sb/to look around/
叹气	tànqì	/to sigh/to heave a sigh/
倘若	tǎngruò	/if; supposing; in case/
掏	tāo	/variant of 掏[tao1]/
滔滔不绝	tāotāobùjué	/(idiom) to produce a torrent of words; to talk on and on/
陶瓷	táocí	/pottery and porcelain/ceramics/
陶醉	táozuì	/to be infatuated with; to be drunk with; to be enchanted with; to revel in/
淘汰	táotài	/to wash out/(fig.) to cull/to weed out/to eliminate/to die out/to phase out/
讨好	tǎohǎo	/to get the desired outcome/to win favor by fawning on sb/to curry favor with/a fruitful outcome to reward one's labor/
特长	tècháng	/personal strength/one's special ability or strong points/
特定	tèdìng	/special; specific; designated; particular/
特意	tèyì	/specially/intentionally/
提拔	tíbá	/to promote to a higher job/to select for promotion/
提炼	tíliàn	/to extract (ore, minerals etc)/to refine/to purify/to process/
提示	tíshì	/to point out/to remind (sb of sth)/to suggest/suggestion/tip/reminder/notice/
提议	tíyì	/proposal/suggestion/to propose/to suggest/
题材	tícái	/subject matter/
体裁	tǐcái	/genre/style/form of writing/
体积	tǐjī	/volume/bulk/CL:個|个[ge4]/
体谅	tǐliàng	/to empathize/to allow (for sth)/to show understanding/to appreciate/
体面	tǐmiàn	/dignity; prestige; face/honorable; creditable/(of sb's appearance) presentable; respectable/
体系	tǐxì	/system/setup/CL:個|个[ge4]/
天才	tiāncái	/talent/gift/genius/talented/gifted/
天伦之乐	tiānlúnzhīlè	/family love and joy/domestic bliss/
天然气	tiānránqì	/natural gas/
天生	tiānshēng	/nature/disposition/innate/natural/
天堂	tiāntáng	/paradise/heaven/
天赋	tiānfù	/gift/innate skill/
天文	tiānwén	/astronomy/
田径	tiánjìng	/track and field (athletics)/
田野	tiányě	/field/open land/CL:片[pian4]/
舔	tiǎn	/to lick/to lap/
挑剔	tiāoti	/picky/fussy/
条款	tiáokuǎn	/clause (of contract or law)/CL:項|项[xiang4]/
条理	tiáolǐ	/arrangement/order/tidiness/
条约	tiáoyuē	/treaty/pact/CL:個|个[ge4]/
调和	tiáohé	/harmonious/to mediate; to reconcile/mediation/to compromise/to mix; to blend/blended/to season/seasoning/to placate/
调剂	tiáojì	/to adjust/to balance/to make up a medical prescription/
调节	tiáojié	/to adjust/to regulate/to harmonize/to reconcile (accountancy etc)/
调解	tiáojiě	/to mediate/to bring parties to an agreement/
调料	tiáoliào	/condiment/seasoning/flavoring/
挑拨	tiǎobō	/to incite disharmony/to instigate/
挑衅	tiǎoxìn	/to provoke/provocation/
跳跃	tiàoyuè	/to jump/to leap/to bound/to skip/
停泊	tíngbó	/to anchor/anchorage/mooring (of a ship)/
停顿	tíngdùn	/to halt/to break off/pause (in speech)/
停滞	tíngzhì	/stagnation/at a standstill/bogged down/
亭子	tíngzi	/pavilion/
挺拔	tǐngbá	/tall and straight/
通货膨胀	tōnghuòpéngzhàng	/inflation/
通俗	tōngsú	/common/everyday/average/
通讯	tōngxùn	/communications/news story/dispatch/CL:個|个[ge4]/
通用	tōngyòng	/to use anywhere, anytime (card, ticket etc)/to be used by everyone (language, textbook etc)/(of two or more things) interchangeable/
通缉	tōngjī	/to order the arrest of sb as criminal/to list as wanted/
铜	tóng	/copper (chemistry)/see also 紅銅|红铜[hong2 tong2]/CL:塊|块[kuai4]/
同胞	tóngbāo	/born of the same parents/sibling/fellow citizen/compatriot/
同志	tóngzhì	/comrade/(slang) homosexual/CL:個|个[ge4]/
童话	tónghuà	/children's fairy tales/
统筹兼顾	tǒngchóujiāngù	/an overall plan taking into account all factors/
统计	tǒngjì	/statistics/to count/to add up/
统统	tǒngtǒng	/totally/
统治	tǒngzhì	/to rule (a country)/to govern/rule/regime/
投机	tóujī	/congenial; agreeable/to speculate; to profiteer/
投票	tóupiào	/to vote/vote/
投诉	tóusù	/complaint/to complain; to register a complaint (esp. as a customer)/
投降	tóuxiáng	/to surrender/
投掷	tóuzhì	/to throw sth a long distance/to hurl/to throw at/to throw (dice etc)/to flip (a coin)/
透露	tòulù	/to leak out/to divulge/to reveal/
秃	tū	/bald (lacking hair or feathers)/barren; bare; denuded/blunt (lacking a point)/(of a piece of writing) unsatisfactory; lacking something/
突破	tūpò	/to break through/to make a breakthrough/to surmount (an obstacle)/(sports) to break through the opponent's defense/
图案	tú’àn	/design; pattern/
徒弟	túdì	/apprentice/disciple/
途径	tújìng	/way; means; channel/
涂抹	túmǒ	/to paint/to smear/to apply (makeup etc)/to doodle/to erase/to obliterate/
土壤	tǔrǎng	/soil/
吞吞吐吐	tūntūntǔtǔ	/to hum and haw (idiom); to mumble as if hiding sth/to speak and break off, then start again/to hold sth back/
团结	tuánjié	/to unite/unity; solidarity/united/
团体	tuántǐ	/group/organization/team/CL:個|个[ge4]/
团圆	tuányuán	/to have a reunion/
推测	tuīcè	/speculation/to conjecture/to surmise/to speculate/
推翻	tuīfān	/to overthrow/
推理	tuīlǐ	/reasoning/inference/to infer/to deduce/
推论	tuīlùn	/to infer/inference/corollary/reasoned conclusion/
推销	tuīxiāo	/to market/to sell/
脱离	tuōlí	/to separate oneself from/to break away from/diastasis (medicine)/abscission/abjunction (botany)/
拖延	tuōyán	/to delay/to put off/to procrastinate/
托运	tuōyùn	/to consign (goods)/to check through (baggage)/
妥当	tuǒdang	/appropriate/proper/ready/
妥善	tuǒshàn	/appropriate; proper/
妥协	tuǒxié	/to compromise/to reach terms/a compromise/
椭圆	tuǒyuán	/oval/ellipse/elliptic/
唾弃	tuòqì	/to spurn/to disdain/
挖掘	wājué	/to excavate/to dig/to unearth/
娃娃	wáwa	/baby/small child/doll/
瓦解	wǎjiě	/to collapse; to disintegrate; to crumble/to disrupt; to break up/
哇	wa	/replaces 啊[a5] when following the vowel "u" or "ao"/
歪曲	wāiqū	/to distort/to misrepresent/
外表	wàibiǎo	/external/outside/outward appearance/
外行	wàiháng	/layman/amateur/
外界	wàijiè	/the outside world/external/
外向	wàixiàng	/extroverted (personality)/(economics etc) export-oriented/
丸	wán	/ball/pellet/pill/
完备	wánbèi	/faultless/complete/perfect/to leave nothing to be desired/
完毕	wánbì	/to finish/to end/to complete/
玩弄	wánnòng	/to play with/to toy with/to dally with/to engage in/to resort to/
玩意儿	wányìr	/erhua variant of 玩意[wan2 yi4]/
顽固	wángù	/stubborn; obstinate/
顽强	wánqiáng	/tenacious/hard to defeat/
挽回	wǎnhuí	/to retrieve/to redeem/
挽救	wǎnjiù	/to save/to remedy/to rescue/
惋惜	wǎnxī	/to regret/to feel that it is a great pity/to feel sorry for sb/
万分	wànfēn	/very much/extremely/one ten thousandth part/
往常	wǎngcháng	/usual/customary/
往事	wǎngshì	/past events/former happenings/
妄想	wàngxiǎng	/to attempt vainly/a vain attempt/delusion/
微不足道	wēibùzúdào	/negligible; insignificant/
微观	wēiguān	/micro-/subatomic/
威风	wēifēng	/might/awe-inspiring authority/impressive/
威力	wēilì	/might/formidable power/
威望	wēiwàng	/prestige/
威信	wēixìn	/prestige/reputation/trust/credit with the people/
危机	wēijī	/crisis/CL:個|个[ge4]/
违背	wéibèi	/to go against/to be contrary to/to violate/
维持	wéichí	/to keep; to maintain; to preserve/
维护	wéihù	/to defend/to safeguard/to protect/to uphold/to maintain/
维生素	wéishēngsù	/vitamin/
唯独	wéidú	/only/just (i.e. it is only that...)/all except/unique/
为难	wéinán	/to feel embarrassed or awkward/to make things difficult (for someone)/to find things difficult (to do or manage)/
为期	wéiqī	/(to be done) by (a certain date)/lasting (a certain time)/
委托	wěituō	/to entrust/to trust/to commission/
委员	wěiyuán	/committee member/
伪造	wěizào	/to forge/to fake/to counterfeit/
喂（叹词）	wèi	hey
未免	wèimiǎn	/unavoidably/can't help/really/rather/
畏惧	wèijù	/to fear/to dread/foreboding/
卫星	wèixīng	/satellite/moon/CL:顆|颗[ke1]/
慰问	wèiwèn	/to express sympathy, greetings, consolation etc/
蔚蓝	wèilán	/azure/sky blue/
温带	wēndài	/temperate zone/
温和	wēnhé	/lukewarm/
文凭	wénpíng	/diploma/
文物	wénwù	/cultural relic/historical relic/CL:件[jian4],個|个[ge4]/
文献	wénxiàn	/document/
文雅	wényǎ	/elegant/refined/
文艺	wényì	/literature and art/
问世	wènshì	/to be published/to come out/
窝	wō	/nest/pit or hollow on the human body/lair/den/place/to harbor or shelter/to hold in check/to bend/classifier for litters and broods/
乌黑	wūhēi	/jet-black/dark/
污蔑	wūmiè	/to slander/to smear/to tarnish/
诬陷	wūxiàn	/to entrap/to frame/to plant false evidence against sb/
无比	wúbǐ	/incomparable/matchless/
无偿	wúcháng	/free; no charge; at no cost/
无耻	wúchǐ	/without any sense of shame/unembarrassed/shameless/
无动于衷	wúdòngyúzhōng	/aloof/indifferent/unconcerned/
无非	wúfēi	/only/nothing else/
无精打采	wújīngdǎcǎi	/dispirited and downcast (idiom); listless/in low spirits/washed out/
无赖	wúlài	/hoodlum/rascal/rogue/rascally/scoundrelly/
无理取闹	wúlǐqǔnào	/to make trouble without reason (idiom); to be deliberately provocative/
无能为力	wúnéngwéilì	/impotent (idiom)/powerless/helpless/
无辜	wúgū	/innocent/innocence/not guilty (law)/
无穷无尽	wúqióngwújìn	/endless/boundless/infinite/
无微不至	wúwēibúzhì	/in every possible way (idiom); meticulous/
无忧无虑	wúyōuwúlǜ	/carefree and without worries (idiom)/
无知	wúzhī	/ignorant/ignorance/
舞蹈	wǔdǎo	/dance (performance art)/dancing/
武器	wǔqì	/weapon/arms/CL:種|种[zhong3]/
武侠	wǔxiá	/martial arts chivalry (Chinese literary, theatrical and cinema genre)/knight-errant/
武装	wǔzhuāng	/arms/equipment/to arm/military/armed (forces)/
侮辱	wǔrǔ	/to insult/to humiliate/dishonor/
务必	wùbì	/must/to need to/to be sure to/
误差	wùchā	/difference/error/inaccuracy/
误解	wùjiě	/to misunderstand/misunderstanding/
物业	wùyè	/property/real estate/abbr. for 物業管理|物业管理[wu4 ye4 guan3 li3], property management/
物美价廉	wùměijiàlián	/good quality and cheap/a bargain/
物资	wùzī	/goods/supplies/
溪	xī	/variant of 溪[xi1]/
膝盖	xīgài	/knee/(Internet slang) to kneel down (in admiration)/
熄灭	xīmiè	/to stop burning/to go out (of fire)/to die out/extinguished/
昔日	xīrì	/former days/in the past/
牺牲	xīshēng	/to sacrifice one's life/to sacrifice (sth valued)/beast slaughtered as a sacrifice/
夕阳	xīyáng	/sunset/the setting sun/
媳妇	xífu	/daughter-in-law/wife (of a younger man)/young married woman/young woman/
习俗	xísú	/custom/tradition/local tradition/convention/
袭击	xíjī	/attack (esp. surprise attack)/raid/to attack/
喜闻乐见	xǐwénlèjiàn	/to love to hear and see (idiom)/well received/to one's liking/
喜悦	xǐyuè	/happy/joyous/
系列	xìliè	/series/set/
细胞	xìbāo	/cell (biology)/
细菌	xìjūn	/bacterium/germ/
细致	xìzhì	/delicate/fine/careful/meticulous/painstaking/
霞	xiá	/rose-tinted sky or clouds at sunrise or sunset/
狭隘	xiá’ài	/narrow/tight/narrow minded/lacking in experience/
狭窄	xiázhǎi	/narrow/
峡谷	xiágǔ	/canyon/gill/ravine/
下属	xiàshǔ	/subordinate/underling/
先进	xiānjìn	/sophisticated; advanced (technology etc)/meritorious; exemplary (deeds etc)/
先前	xiānqián	/before; previously/
鲜明	xiānmíng	/(of colors) bright; fresh and clear/clear-cut; distinct/
掀起	xiānqǐ	/to lift; to raise (a lid etc)/(of a storm) to surge; to stir up (waves etc)/(fig.) to trigger; set off (a wave of popularity, a controversy etc)/
纤维	xiānwéi	/fiber/CL:種|种[zhong3]/
弦	xián	/bow string/string of musical instrument/watchspring/chord (segment of curve)/hypotenuse/CL:根[gen1]/
嫌	xián	/to dislike/suspicion/resentment/enmity/abbr. for 嫌犯[xian2 fan4], criminal suspect/
嫌疑	xiányí	/suspicion/to have suspicions/
闲话	xiánhuà	/casual conversation/chat/gossip/to talk about (whatever comes to mind)/
贤惠	xiánhuì	/variant of 賢慧|贤慧[xian2 hui4]/
衔接	xiánjiē	/to link up; to connect; to join/
显著	xiǎnzhù	/outstanding/notable/remarkable/statistically significant/
现场	xiànchǎng	/the scene (of a crime, accident etc)/(on) the spot/(at) the site/
现成	xiànchéng	/ready-made/readily available/
现状	xiànzhuàng	/current situation/
宪法	xiànfǎ	/constitution (of a country)/CL:部[bu4]/
陷害	xiànhài	/to entrap/to set up/to frame (up)/to make false charges against/
陷入	xiànrù	/to sink into/to get caught up in/to land in (a predicament)/
陷阱	xiànjǐng	/pitfall/snare/trap/
馅儿	xiànr	/erhua variant of 餡|馅[xian4]/
线索	xiànsuǒ	/trail/clues/thread (of a story)/
相差	xiāngchà	/to differ/
相等	xiāngděng	/equal/equally/equivalent/
相辅相成	xiāngfǔxiāngchéng	/to complement one another (idiom)/
相应	xiāngyìng	/to correspond/answering (one another)/to agree (among the part)/corresponding/relevant/appropriate/(modify) accordingly/
镶嵌	xiāngqiàn	/to inlay/to embed/to set (e.g. a jewel in a ring)/tiling/tesselation/
乡镇	xiāngzhèn	/village/township/
想方设法	xiǎngfāngshèfǎ	/to think up every possible method (idiom); to devise ways and means/to try this, that and the other/
响亮	xiǎngliàng	/loud and clear; resounding/
响应	xiǎngyìng	/to respond to/answer/CL:個|个[ge4]/
巷	xiàng	/lane/alley/
向导	xiàngdǎo	/guide/
向来	xiànglái	/always (previously)/
向往	xiàngwǎng	/to yearn for/to look forward to/
相声	xiàngsheng	/comic dialogue/sketch/crosstalk/
消除	xiāochú	/to eliminate/to remove/
消毒	xiāodú	/to disinfect; to sterilize/
消防	xiāofáng	/firefighting/fire control/
消耗	xiāohào	/to use up/to consume/
消灭	xiāomiè	/to put an end to/to annihilate/to cause to perish/to perish/annihilation (in quantum field theory)/
销毁	xiāohuǐ	/to destroy (by melting or burning)/to obliterate/
小心翼翼	xiǎoxīnyìyì	/cautious and solemn (idiom); very carefully/prudent/gently and cautiously/
效益	xiàoyì	/benefit/effectiveness/efficiency/
肖像	xiàoxiàng	/portrait (painting, photo etc)/(in a general sense) representation of a person/likeness/
潇洒	xiāosǎ	/confident and at ease/free and easy/
携带	xiédài	/to carry (on one's person)/to support (old)/Taiwan pr. [xi1 dai4]/
协会	xiéhuì	/an association/a society/CL:個|个[ge4],家[jia1]/
协商	xiéshāng	/to consult with/to talk things over/agreement/
协调	xiétiáo	/to coordinate/to harmonize/to fit together/to match (colors etc)/harmonious/concerted/
协议	xiéyì	/agreement/pact/protocol/CL:項|项[xiang4]/
协助	xiézhù	/to provide assistance/to aid/
屑	xiè	/bits/fragments/crumbs/filings/trifling/trivial/to condescend to/
谢绝	xièjué	/to refuse politely/
泄露	xièlòu	/to leak (information); to divulge/also pr. [xie4 lou4]/
泄气	xièqì	/to leak (gas)/to be discouraged/to despair/(disparaging) pathetic/to vent one's anger/(of a tire) to be flat/
新陈代谢	xīnchéndàixiè	/metabolism (biology)/the new replaces the old (idiom)/
新郎	xīnláng	/bridegroom; groom/
新娘	xīnniáng	/bride/
新颖	xīnyǐng	/lit. new bud/fig. new and original/
心得	xīndé	/what one has learned (through experience, reading etc)/knowledge/insight/understanding/tips/CL:項|项[xiang4],個|个[ge4]/
心灵	xīnlíng	/bright/smart/quick-witted/heart/thoughts/spirit/
心态	xīntài	/attitude (of the heart)/state of one's psyche/way of thinking/mentality/
心疼	xīnténg	/to love dearly/to feel sorry for sb/to regret/to grudge/to be distressed/
心血	xīnxuè	/heart's blood/expenditure (for some project)/meticulous care/
心眼儿	xīnyǎnr	/one's thoughts/mind/intention/willingness to accept new ideas/baseless suspicions/
心甘情愿	xīngānqíngyuàn	/delighted to (do sth, idiom)/perfectly happy to do/most willing to do/
辛勤	xīnqín	/hardworking; industrious/
欣慰	xīnwèi	/to be gratified/
欣欣向荣	xīnxīnxiàngróng	/(idiom) flourishing/thriving/
薪水	xīnshui	/salary/wage/
信赖	xìnlài	/to trust/to have confidence in/to have faith in/to rely on/
信念	xìnniàn	/faith/belief/conviction/
信仰	xìnyǎng	/to believe in (a religion)/firm belief/conviction/
信誉	xìnyù	/prestige/distinction/reputation/trust/
腥	xīng	/fishy (smell)/
兴隆	xīnglóng	/prosperous/thriving/flourishing/
兴旺	xīngwàng	/prosperous/thriving/to prosper/to flourish/
行政	xíngzhèng	/administration/(attributive) administrative; executive/
形态	xíngtài	/shape/form/pattern/morphology/
刑事	xíngshì	/criminal; penal/
性感	xìnggǎn	/sex appeal/eroticism/sexuality/sexy/
性命	xìngmìng	/life/
性能	xìngnéng	/function; performance; behavior/
兴高采烈	xìnggāocǎiliè	/happy and excited (idiom)/in high spirits/in great delight/
兴致勃勃	xìngzhìbóbó	/to become exhilarated (idiom); in high spirits/full of zest/
胸怀	xiōnghuái	/one's bosom (the seat of emotions)/breast/broad-minded and open/to think about/to cherish/
胸膛	xiōngtáng	/chest/
汹涌	xiōngyǒng	/to surge up violently (of ocean, river, lake etc)/turbulent/
凶恶	xiōng’è	/variant of 兇惡|凶恶, fierce/ferocious/fiendish/frightening/
凶手	xiōngshǒu	/murderer/assassin/
雄厚	xiónghòu	/substantial; robust; ample; abundant/
雄伟	xióngwěi	/grand/imposing/magnificent/majestic/
修复	xiūfù	/to restore; to renovate/(computing) to repair (a corrupted file etc)/
修建	xiūjiàn	/to build/to construct/
修养	xiūyǎng	/accomplishment/training/self-cultivation/
羞耻	xiūchǐ	/(a feeling of) shame/
绣	xiù	/to embroider; embroidery/
嗅觉	xiùjué	/sense of smell/
虚假	xūjiǎ	/false/phony/pretense/
虚荣	xūróng	/vanity/
虚伪	xūwěi	/false/hypocritical/artificial/sham/
需求	xūqiú	/requirement/to require/(economics) demand/
须知	xūzhī	/key information/instructions/it must be borne in mind/
许可	xǔkě	/to allow/to permit/
酗酒	xùjiǔ	/heavy drinking/to get drunk/to drink to excess/
畜牧	xùmù	/to raise animals/
序言	xùyán	/preface; introductory remarks; preamble; prelude/
喧哗	xuānhuá	/hubbub/clamor/to make a racket/
宣誓	xuānshì	/to swear an oath (of office)/to make a vow/
宣扬	xuānyáng	/to publicize; to advertise; to spread far and wide/
悬挂	xuánguà	/to suspend/to hang/(vehicle) suspension/
悬念	xuánniàn	/suspense in a movie, play etc/concern for sb's welfare/
悬殊	xuánshū	/vastly different; poles apart/
悬崖峭壁	xuányáqiàobì	/sheer cliffs and precipitous rock faces (idiom)/
旋律	xuánlǜ	/melody/
旋转	xuánzhuǎn	/to rotate/to revolve/to spin/to whirl/
选拔	xuǎnbá	/to select the best/
选举	xuǎnjǔ	/to elect/election/CL:次[ci4],個|个[ge4]/
选手	xuǎnshǒu	/athlete/contestant/
炫耀	xuànyào	/dazzling/to show off; to flaunt/
削	xuē	/to pare/to reduce/to remove/Taiwan pr. [xue4]/
削弱	xuēruò	/to weaken/to impair/to cripple/
学说	xuéshuō	/theory/doctrine/
学位	xuéwèi	/academic degree/place in school/
雪上加霜	xuěshàngjiāshuāng	/(idiom) to make matters even worse/to add insult to injury/
血压	xuèyā	/blood pressure/
熏陶	xūntáo	/to seep in/to influence/to nurture/influence/training/
循环	xúnhuán	/to cycle/to circulate/circle/loop/
循序渐进	xúnxùjiànjìn	/in sequence, step by step (idiom); to make steady progress incrementally/
巡逻	xúnluó	/to patrol (police, army or navy)/
寻觅	xúnmì	/to look for/
压迫	yāpò	/to oppress/to repress/to constrict/oppression/stress (physics)/
压岁钱	yāsuìqián	/money given to children as a gift on Chinese New Year's Eve/
压缩	yāsuō	/to compress; compression/
压抑	yāyì	/to constrain or repress emotions/oppressive/stifling/depressing/repression/
压榨	yāzhà	/to press/to squeeze/to extract juice, oil etc by squeezing/
压制	yāzhì	/to suppress/to inhibit/to stifle/
亚军	yàjūn	/second place (in a sports contest)/runner-up/
鸦雀无声	yāquèwúshēng	/lit. crow and peacock make no sound/absolute silence (idiom); not a single voice can be heard/absolute silence/
烟花爆竹	yānhuābàozhú	/fireworks (i.e. pyrotechnic devices, not the display they produce)/
淹没	yānmò	/to submerge/to drown/to flood/to drown out (also fig.)/
延期	yánqī	/to delay/to extend/to postpone/to defer/
延伸	yánshēn	/to extend/to spread/
延续	yánxù	/to continue/to go on/to last/
严寒	yánhán	/bitter cold/severe winter/
严禁	yánjìn	/to strictly prohibit/
严峻	yánjùn	/grim/severe/rigorous/
严厉	yánlì	/severe/strict/
严密	yánmì	/strict/tight (organization, surveillance etc)/
沿海	yánhǎi	/coastal/
言论	yánlùn	/expression of opinion/views/remarks/arguments/
炎热	yánrè	/blistering hot/sizzling hot (weather)/
岩石	yánshí	/rock/
演变	yǎnbiàn	/to develop; to evolve/
演习	yǎnxí	/(military, firefighting etc) (verb and noun) drill; exercise; maneuver/
演绎	yǎnyì	/(of a story etc) to unfold; to play out/to develop (a technique etc)/to enact/(logic) to deduce; to infer/
演奏	yǎnzòu	/to perform on a musical instrument/
掩盖	yǎngài	/to conceal/to hide behind/to cover up/
掩护	yǎnhù	/to screen/to shield/to cover/protection/cover/CL:面[mian4]/
掩饰	yǎnshì	/to cover up/to conceal/to mask/to gloss over/
眼光	yǎnguāng	/gaze/insight/foresight/vision/way of looking at things/
眼色	yǎnsè	/signal made with one's eyes/meaningful glance/
眼神	yǎnshén	/expression or emotion showing in one's eyes/meaningful glance/wink/eyesight (dialect)/
验收	yànshōu	/to inspect and accept/acceptance/
验证	yànzhèng	/to inspect and verify/experimental verification/to validate (a theory)/to authenticate/
厌恶	yànwù	/to loathe/to hate/disgusted with sth/
氧气	yǎngqì	/oxygen/
样品	yàngpǐn	/sample; specimen/
摇摆	yáobǎi	/to sway/to wobble/to waver/
摇滚	yáogǔn	/rock 'n' roll (music)/to rock/to fall off/
遥控	yáokòng	/to direct operations from a remote location/to remotely control/
遥远	yáoyuǎn	/distant; remote/
谣言	yáoyán	/rumor/
要点	yàodiǎn	/main point/essential/
要命	yàomìng	/to cause sb's death/extremely; terribly/(used in complaining about sth) to be a nuisance/
要素	yàosù	/essential factor/key constituent/
耀眼	yàoyǎn	/to dazzle/dazzling/
野蛮	yěmán	/barbarous/uncivilized/
野心	yěxīn	/ambition/wild schemes/careerism/
液体	yètǐ	/liquid/
一流	yīliú	/top quality/front ranking/
依旧	yījiù	/as before; still/
依据	yījù	/according to/basis/foundation/
依靠	yīkào	/to rely on sth (for support etc); to depend on/
依赖	yīlài	/to depend on; to be dependent on/
依托	yītuō	/to rely on/to depend on/support/
衣裳	yīshang	/(coll.) clothes/
一度	yídù	/for a time/at one time/one time/once/
一贯	yíguàn	/consistent/constant/from start to finish/all along/persistent/
一目了然	yímùliǎorán	/obvious at a glance (idiom)/
一向	yíxiàng	/a period of time in the recent past/(indicating a period of time up to the present) all along; the whole time/
遗产	yíchǎn	/heritage/legacy/inheritance/bequest/CL:筆|笔[bi3]/
遗传	yíchuán	/heredity/to inherit (a trait)/to pass on (to one's offspring)/
遗留	yíliú	/to leave behind/to hand down/
遗失	yíshī	/to lose; to leave behind (inadvertently)/
疑惑	yíhuò	/to doubt/to distrust/unconvincing/to puzzle over/misgivings/suspicions/
仪器	yíqì	/instrument; apparatus/CL:臺|台[tai2]/
仪式	yíshì	/ceremony/
以便	yǐbiàn	/so that/so as to/in order to/
以免	yǐmiǎn	/in order to avoid/so as not to/
以往	yǐwǎng	/in the past; formerly/
以至	yǐzhì	/down to/up to/to such an extent as to .../also written 以至於|以至于[yi3 zhi4 yu2]/
以致	yǐzhì	/to such an extent as to/down to/up to/
亦	yì	/also/
翼	yì	/wing/area surrounding the bullseye of a target/to assist/one of the 28 constellations of Chinese astronomy/old variant of 翌/
一帆风顺	yìfānfēngshùn	/propitious wind throughout the journey (idiom)/plain sailing/to go smoothly/have a nice trip!/
一举两得	yìjǔliǎngdé	/one move, two gains (idiom); two birds with one stone/
一如既往	yìrújìwǎng	/(idiom) just as in the past; as before; continuing as always/
一丝不苟	yìsībùgǒu	/not one thread loose (idiom); strictly according to the rules/meticulous/not one hair out of place/
异常	yìcháng	/unusual; abnormal/extremely; exceptionally/
意料	yìliào	/to anticipate; to expect/expectations/
意识	yìshí	/consciousness/awareness/to be aware/to realize/
意图	yìtú	/intent/intention/to intend/
意味着	yìwèizhe	/to signify/to mean/to imply/
意向	yìxiàng	/intention/purpose/intent/inclination/disposition/
意志	yìzhì	/will; willpower; determination/
毅力	yìlì	/perseverance/willpower/
毅然	yìrán	/firmly/resolutely/without hesitation/
阴谋	yīnmóu	/to conspire; to plot/a conspiracy; a plot/
音响	yīnxiǎng	/sound/acoustics/audio/hi-fi system/stereo sound system/abbr. for 組合音響|组合音响[zu3 he2 yin1 xiang3]/
隐蔽	yǐnbì	/to conceal/to hide/covert/under cover/
隐患	yǐnhuàn	/a danger concealed within sth/hidden damage/misfortune not visible from the surface/
隐瞒	yǐnmán	/to conceal/to hide (a taboo subject)/to cover up the truth/
隐私	yǐnsī	/secrets/private business/privacy/
隐约	yǐnyuē	/vague/faint/indistinct/
引导	yǐndǎo	/to guide/to lead (around)/to conduct/to boot/introduction/primer/
引擎	yǐnqíng	/engine (loanword)/CL:臺|台[tai2]/
引用	yǐnyòng	/to quote; to cite/to recommend; to appoint/(computing) reference/
饮食	yǐnshí	/eating and drinking/food and drink; diet/
婴儿	yīng’ér	/infant/baby/CL:個|个[ge4]/lead (Pb)/
英明	yīngmíng	/wise/brilliant/
英勇	yīngyǒng	/heroic/gallant/valiant/
迎面	yíngmiàn	/directly; head-on (collision)/in one's face (of wind)/
盈利	yínglì	/profit/gain/to make profits/
应酬	yìngchou	/to engage in social activities; to socialize/dinner party; banquet; social engagement/
应邀	yìngyāo	/at sb's invitation/on invitation/
拥护	yōnghù	/to endorse; to support/
拥有	yōngyǒu	/to have; to possess/
庸俗	yōngsú	/vulgar/tacky/tawdry/
勇于	yǒngyú	/to dare to/to be brave enough to/
永恒	yǒnghéng	/eternal/everlasting/fig. to pass into eternity (i.e. to die)/
涌现	yǒngxiàn	/to emerge in large numbers/to spring up/to emerge prominently/
踊跃	yǒngyuè	/to leap/to jump/eager/enthusiastically/
用户	yònghù	/user/consumer/subscriber/customer/
优胜劣汰	yōushèngliètài	/survival of the fittest (idiom)/
优先	yōuxiān	/to have priority; to take precedence/
优异	yōuyì	/exceptional; outstandingly good/
优越	yōuyuè	/superior/superiority/
忧郁	yōuyù	/sullen; depressed; melancholy; dejected/
油腻	yóunì	/greasy food; oily food/(of food) greasy; oily; fatty/(neologism c. 2017) (of a middle-aged man) obnoxious; pretentious; vulgar/
油漆	yóuqī	/oil paints/lacquer/to paint/CL:層|层[ceng2]/
犹如	yóurú	/similar to; like/
有条不紊	yǒutiáobùwěn	/regular and thorough (idiom); methodically arranged/
幼稚	yòuzhì	/young/childish/puerile/
诱惑	yòuhuò	/to entice/to lure/to induce/to attract/
愚蠢	yúchǔn	/silly/stupid/
愚昧	yúmèi	/ignorant; uneducated/ignorance/
舆论	yúlùn	/public opinion/
渔民	yúmín	/fisherman/fisher folk/
与日俱增	yǔrìjùzēng	/to increase steadily/to grow with each passing day/
羽绒服	yǔróngfú	/down-filled garment/
宇宙	yǔzhòu	/universe/cosmos/
愈	yù	/variant of 愈[yu4]/to heal/
预料	yùliào	/to forecast/to anticipate/expectation/
预期	yùqī	/to expect/to anticipate/
预算	yùsuàn	/budget/
预先	yùxiān	/beforehand; in advance/
预言	yùyán	/to predict/prophecy/
预兆	yùzhào	/omen/sign (of sth yet to occur)/prior indication/to foreshadow/
玉	yù	/jade/
欲望	yùwàng	/desire; longing; appetite; craving/
寓言	yùyán	/fable/CL:則|则[ze2]/
冤枉	yuānwang	/to accuse wrongly/to treat unjustly/injustice/wronged/not worthwhile/
元首	yuánshǒu	/head of state/
元素	yuánsù	/element (key component of sth)/(chemistry) element/(math.) element (member of a set)/
元宵节	yuánxiāojié	/Lantern Festival, the final event of the Spring Festival 春節|春节, on 15th of first month of the lunar calendar/
圆满	yuánmǎn	/satisfactory; consummate; perfect/
原告	yuángào	/complainant/plaintiff/
原理	yuánlǐ	/principle/theory/
原始	yuánshǐ	/first/original/primitive/original (document etc)/
原先	yuánxiān	/originally/original/former/
缘故	yuángù	/reason/cause/
园林	yuánlín	/gardens; park; landscape garden/
源泉	yuánquán	/fountainhead/well-spring/water source/fig. origin/
约束	yuēshù	/to restrict/to limit to/to constrain/restriction/constraint/
乐谱	yuèpǔ	/a musical score/sheet music/
岳母	yuèmǔ	/wife's mother, mother-in-law/
熨	yùn	/an iron/to iron/
蕴藏	yùncáng	/to hold in store/to contain (untapped reserves etc)/
运算	yùnsuàn	/to perform calculations/(mathematical) operation/
运行	yùnxíng	/(of celestial bodies etc) to move along one's course/(fig.) to function; to be in operation/(of a train service etc) to operate; to run/(of a computer) to run/
酝酿	yùnniàng	/(of alcohol) to ferment/(of a crisis) to be brewing/to mull over (an issue)/to hold exploratory discussions/
孕育	yùnyù	/to be pregnant/to produce offspring/to nurture (a development, school of thought, artwork etc)/fig. replete with (culture etc)/
砸	zá	/to smash/to pound/to fail/to muck up/to bungle/
杂技	zájì	/acrobatics/CL:場|场[chang3]/
杂交	zájiāo	/to hybridize/to crossbreed/promiscuity/
咋	zǎ	/loud noise/shout/suddenly/
灾难	zāinàn	/disaster; catastrophe/
栽培	zāipéi	/to grow/to cultivate/to train/to educate/to patronize/
宰	zǎi	/to slaughter; to butcher; to kill (animals etc)/(coll.) to fleece; to rip off; to overcharge/(bound form) to govern; to rule/(bound form) (a title for certain government officials in ancient China)/
在意	zàiyì	/to care about/to mind/
再接再厉	zàijiēzàilì	/to continue the struggle (idiom); to persist/unremitting efforts/
攒	zǎn	/to collect/to hoard/to accumulate/to save/
赞叹	zàntàn	/to exclaim in admiration/
赞助	zànzhù	/to support/to assist/to sponsor/
暂且	zànqiě	/for now; for the time being; temporarily/
糟蹋	zāotà	/to waste/to defile/to abuse/to insult/to defile/to trample on/to wreck/also pr. [zao1 ta5]/
遭受	zāoshòu	/to suffer; to sustain (loss, misfortune)/
遭殃	zāoyāng	/to suffer a calamity/
遭遇	zāoyù	/to meet with/to encounter/(bitter) experience/
造型	zàoxíng	/to model; to shape/appearance; style; design; form; pose/
噪音	zàoyīn	/rumble/noise/static (in a signal)/
责怪	zéguài	/to blame/to rebuke/
贼	zéi	/thief/traitor/wily/deceitful/evil/extremely/
增添	zēngtiān	/to add/to increase/
赠送	zèngsòng	/to present as a gift/
渣	zhā	/slag (in mining or smelting)/dregs/
扎	zhā	/(of troops) to be stationed (at)/Taiwan pr. [zha2]/
扎实	zhāshi	/variant of 扎實|扎实[zha1 shi5]/
眨	zhǎ	/to blink/to wink/
诈骗	zhàpiàn	/to defraud/to swindle/to blackmail/
摘要	zhāiyào	/summary/abstract/
债券	zhàiquàn	/bond/debenture/
沾光	zhānguāng	/to bask in the light/fig. to benefit from association with sb or sth/reflected glory/
瞻仰	zhānyǎng	/to revere/to admire/
斩钉截铁	zhǎndīngjiétiě	/lit. to chop the nail and slice the iron (idiom)/fig. resolute and decisive; unhesitating; categorical/
展示	zhǎnshì	/to reveal; to display; to show; to exhibit/
展望	zhǎnwàng	/outlook/prospect/to look ahead/to look forward to/
展现	zhǎnxiàn	/to unfold before one's eyes; to emerge; to reveal; to display/
崭新	zhǎnxīn	/brand new/
战斗	zhàndòu	/to fight/to engage in combat/struggle/battle/CL:場|场[chang2],次[ci4]/
战略	zhànlüè	/strategy/
战术	zhànshù	/tactics/
战役	zhànyì	/military campaign/
占据	zhànjù	/to occupy; to hold/
占领	zhànlǐng	/to capture; to seize; to occupy by force/
章程	zhāngchéng	/rules/regulations/constitution/statute/articles of association (of company)/articles of incorporation/charter (of a corporation)/by-laws/
障碍	zhàng’ài	/barrier/obstruction/hindrance/impediment/obstacle/
帐篷	zhàngpeng	/tent/CL:頂|顶[ding3],座[zuo4]/
招标	zhāobiāo	/to invite bids/
招收	zhāoshōu	/to hire/to recruit/
朝气蓬勃	zhāoqìpéngbó	/full of youthful energy (idiom); vigorous/energetic/a bright spark/
着迷	zháomí	/to be fascinated/to be captivated/
沼泽	zhǎozé	/marsh/swamp/wetlands/glade/
照样	zhàoyàng	/as before/(same) as usual/in the same manner/still/nevertheless/
照耀	zhàoyào	/to shine/to illuminate/
遮挡	zhēdǎng	/to shelter/to shelter from/
折腾	zhēteng	/to toss from side to side (e.g. sleeplessly)/to repeat sth over and over again/to torment sb/to play crazy/to squander (time, money)/
折	zhé	/variant of 折[zhe2]/to fold/
折磨	zhémó	/to torment; to torture/
真理	zhēnlǐ	/truth/CL:個|个[ge4]/
真相	zhēnxiàng	/the truth about sth; the actual facts/
真挚	zhēnzhì	/sincere/sincerity/
珍贵	zhēnguì	/precious/
珍稀	zhēnxī	/rare/precious and uncommon/
珍珠	zhēnzhū	/pearl/CL:顆|颗[ke1]/
侦探	zhēntàn	/detective/to do detective work/
斟酌	zhēnzhuó	/to consider/to deliberate/to fill up a cup to the brim/
枕头	zhěntou	/pillow/
阵地	zhèndì	/(military) position/front/
阵容	zhènróng	/troop arrangement/battle formation/lineup (of a sports team etc)/
镇定	zhèndìng	/calm/unperturbed/cool/
镇静	zhènjìng	/calm/cool/
振奋	zhènfèn	/to stir oneself up/to raise one's spirits/to inspire/
振兴	zhènxīng	/to revive; to revitalize; to invigorate; to re-energize/
震撼	zhènhàn	/to shake/to shock/to stun/shocking/stunning/shock/
震惊	zhènjīng	/to shock/to astonish/
争端	zhēngduān	/dispute/controversy/conflict/
争夺	zhēngduó	/to fight over/to contest/to vie over/
争气	zhēngqì	/to work hard for sth/to resolve on improvement/determined not to fall short/
争先恐后	zhēngxiānkǒnghòu	/striving to be first and fearing to be last (idiom); outdoing one another/
争议	zhēngyì	/controversy/dispute/to dispute/
蒸发	zhēngfā	/to evaporate/evaporation/
征服	zhēngfú	/to conquer/to subdue/to vanquish/
征收	zhēngshōu	/to levy (a tax)/to expropriate/
正月	zhēngyuè	/first month of the lunar year/
挣扎	zhēngzhá	/to struggle/
整顿	zhěngdùn	/to tidy up/to reorganize/to consolidate/to rectify/
正当	zhèngdāng	/honest/reasonable/fair/sensible/
正负	zhèngfù	/positive and negative/
正规	zhèngguī	/regular/according to standards/
正经	zhèngjing	/decent/honorable/proper/serious/according to standards/
正气	zhèngqì	/healthy atmosphere; moral spirit/unyielding integrity; probity/(TCM) vital energy (resistance to diseases)/
正义	zhèngyì	/justice/righteousness/just/righteous/
正宗	zhèngzōng	/orthodox school/fig. traditional/old school/authentic/genuine/
政策	zhèngcè	/policy/CL:個|个[ge4]/
政权	zhèngquán	/regime/political power/
证实	zhèngshí	/to confirm (sth to be true)/to verify/
证书	zhèngshū	/credentials/certificate/
郑重	zhèngzhòng	/serious/solemn/earnest/conscientious/
症状	zhèngzhuàng	/symptom (of an illness)/
之际	zhī jì	/during/at the time of/
枝	zhī	/branch/classifier for sticks, rods, pencils etc/
支撑	zhīchēng	/to prop up/to support/strut/brace/
支出	zhīchū	/to spend; to pay out/expenses; expenditure/
支流	zhīliú	/tributary (river)/
支配	zhīpèi	/to control/to dominate/to allocate/
支援	zhīyuán	/to provide assistance/to support/to back/
支柱	zhīzhù	/mainstay/pillar/prop/backbone/
知觉	zhījué	/perception/consciousness/
知足常乐	zhīzúchánglè	/satisfied with what one has (idiom)/
脂肪	zhīfáng	/fat (in the body, in a plant, or in food)/
直播	zhíbō	/(TV, radio) to broadcast live/live broadcast/(Internet) to livestream/(agriculture) direct seeding/
直径	zhíjìng	/diameter/
值班	zhíbān	/to work a shift/on duty/
殖民地	zhímíndì	/colony/
职能	zhínéng	/function/role/
职位	zhíwèi	/position; post; job/
职务	zhíwù	/post/position/job/duties/
执行	zhíxíng	/to implement/to carry out/to execute/to run/
执着	zhízhuó	/to be strongly attached to/to be dedicated/to cling to/(Buddhism) attachment/
侄子	zhízi	/brother's son; nephew/
指标	zhǐbiāo	/(production) target; quota/index; indicator/sign; signpost/(computing) pointer/
指定	zhǐdìng	/to appoint/to assign/to indicate clearly and with certainty/designated/
指甲	zhǐjia	/fingernail/
指令	zhǐlìng	/order/command/instruction/
指南针	zhǐnánzhēn	/compass/
指示	zhǐshì	/to point out/to indicate/to instruct/directives/instructions/CL:個|个[ge4]/
指望	zhǐwàng	/to count on; to hope for/prospect; hope/
指责	zhǐzé	/to criticize/to find fault with/to denounce/
治安	zhì’ān	/law and order/public security/
治理	zhìlǐ	/to govern/to administer/to manage/to control/governance/
制裁	zhìcái	/to punish/punishment/sanctions (incl. economic)/
制服	zhìfú	/to subdue/to check/to bring under control/(in former times) what one is allowed to wear depending on social status/uniform (army, party, school etc)/livery (for company employees)/CL:套[tao4]/
制约	zhìyuē	/to restrict/condition/
制止	zhìzhǐ	/to curb/to put a stop to/to stop/to check/to limit/
致辞	zhìcí	/to express in words or writing/to make a speech (esp. short introduction, vote of thanks, afterword, funeral homily etc)/to address (an audience)/same as 致詞|致词/
致力	zhìlì	/to work for/to devote one's efforts to/
致使	zhìshǐ	/to cause/to result in/
智力	zhìlì	/intelligence/intellect/
智能	zhìnéng	/intelligent/able/smart (phone, system, bomb etc)/
智商	zhìshāng	/IQ (intelligence quotient)/
滞留	zhìliú	/(of a person) to remain in (a place) (due to circumstances that prevent one leaving); to be stranded/(of sth that would typically dissipate, e.g. floodwater, pollutants) to remain; to linger/
志气	zhìqì	/ambition/resolve/backbone/drive/spirit/
忠诚	zhōngchéng	/devoted/loyal/fidelity/loyalty/
忠实	zhōngshí	/faithful/
终点	zhōngdiǎn	/the end/end point/finishing line (in a race)/destination/terminus/CL:個|个[ge4]/
终究	zhōngjiū	/in the end/after all is said and done/
终身	zhōngshēn	/lifelong/all one's life/marriage/
终止	zhōngzhǐ	/to stop; to terminate/
中断	zhōngduàn	/to cut short/to break off/to discontinue/to interrupt/
中立	zhōnglì	/neutral/neutrality/
中央	zhōngyāng	/central/middle/center/central authorities (of a state)/
衷心	zhōngxīn	/heartfelt/wholehearted/cordial/
种子	zhǒngzi	/seed/CL:顆|颗[ke1],粒[li4]/
种族	zhǒngzú	/race/ethnicity/
种植	zhòngzhí	/to plant; to grow (a crop); to cultivate/
肿瘤	zhǒngliú	/tumor/
重心	zhòngxīn	/center of gravity/central core/main part/
众所周知	zhòngsuǒzhōuzhī	/see 眾所周知|众所周知[zhong4 suo3 zhou1 zhi1]/
州	zhōu	/prefecture/(old) province/(old) administrative division/state (e.g. of US)/oblast (Russia)/canton (Switzerland)/
舟	zhōu	/boat/
粥	zhōu	/congee/gruel/porridge/CL:碗[wan3]/
周边	zhōubiān	/periphery/rim/surroundings/all around/perimeter/peripheral (computing)/spin-offs/
周密	zhōumì	/careful/thorough/meticulous/dense/impenetrable/
周年	zhōunián	/anniversary/annual/
周期	zhōuqī	/period/cycle/
周折	zhōuzhé	/twists and turns/vicissitude/complication/difficulty/effort/CL:番[fan1]/
周转	zhōuzhuǎn	/to rotate/to circulate (cash, stock etc)/turnover/circulation/cash flow/
皱纹	zhòuwén	/wrinkle/CL:道[dao4]/
昼夜	zhòuyè	/day and night/period of 24 hours/continuously, without stop/
株	zhū	/tree trunk/stump (tree root)/a plant/classifier for trees or plants/strain (biology)/to involve others (in shady business)/
诸位	zhūwèi	/(pron) everyone/Ladies and Gentlemen/Sirs/
逐年	zhúnián	/year after year/with each passing year/over the years/
拄	zhǔ	/to lean on/to prop on/
主办	zhǔbàn	/to organize/to host (a conference or sports event)/
主导	zhǔdǎo	/leading/dominant/prevailing/to lead/to direct/to dominate/
主管	zhǔguǎn	/in charge/responsible for/person in charge/manager/
主流	zhǔliú	/main stream (of a river)/fig. the essential point/main viewpoint of a matter/mainstream (culture etc)/
主权	zhǔquán	/sovereignty/
主义	zhǔyì	/-ism/ideology/
嘱咐	zhǔfù	/to urge; to exhort/
住宅	zhùzhái	/residence; dwelling; abode/
注射	zhùshè	/injection/to inject/
注视	zhùshì	/to look attentively at; to closely watch; to gaze at/
注释	zhùshì	/variant of 注釋|注释[zhu4 shi4]/
注重	zhùzhòng	/to pay attention to/to emphasize/
助理	zhùlǐ	/assistant/
助手	zhùshǒu	/assistant; helper/
著作	zhùzuò	/to write/literary work/book/article/writings/CL:部[bu4]/
驻扎	zhùzhā	/to station/to garrison (troops)/
铸造	zhùzào	/to cast (pour metal into a mold)/
拽	zhuài	/to pull/to tug at (sth)/
专长	zhuāncháng	/specialty/special knowledge or ability/
专程	zhuānchéng	/specifically/specially (for that purpose)/
专利	zhuānlì	/patent/sth uniquely enjoyed (or possessed etc) by a certain group of people/monopoly/
专题	zhuāntí	/specific topic (addressed by a book, lecture, TV program etc)/article, report or program etc on a specific topic/
砖	zhuān	/brick/CL:塊|块[kuai4]/
转达	zhuǎndá	/to pass on/to convey/to communicate/
转让	zhuǎnràng	/to transfer (ownership, rights etc)/
转移	zhuǎnyí	/to shift; to relocate; to transfer/(fig.) to shift (attention); to change (the subject etc)/(medicine) to metastasize/
转折	zhuǎnzhé	/shift in the trend of events/turnaround/plot shift in a book/turn in the conversation/
传记	zhuànjì	/biography/CL:篇[pian1],部[bu4]/
装备	zhuāngbèi	/equipment/to equip/to outfit/
装卸	zhuāngxiè	/to load or unload/to transfer/to assemble and disassemble/
庄严	zhuāngyán	/solemn; dignified; stately/
庄重	zhuāngzhòng	/grave/solemn/dignified/
庄稼	zhuāngjia	/farm crop/
幢	zhuàng	/classifier for buildings/carriage curtain (old)/
壮观	zhuàngguān	/spectacular/magnificent sight/
壮丽	zhuànglì	/magnificence/magnificent/majestic/glorious/
壮烈	zhuàngliè	/brave/heroic/
追悼	zhuīdào	/to mourn; to pay last respects/
追究	zhuījiū	/to investigate/to look into/
坠	zhuì	/to fall/to drop/to weigh down/
准则	zhǔnzé	/norm/standard/criterion/
琢磨	zhuómó	/to ponder/to mull over/to think through/Taiwan pr. [zhuo2 mo2]/
着手	zhuóshǒu	/to put one's hand to it/to start out on a task/to set out/
着想	zhuóxiǎng	/to give thought (to others)/to consider (other people's needs)/also pr. [zhao2 xiang3]/
着重	zhuózhòng	/to put emphasis on; to stress/
卓越	zhuóyuè	/outstanding/surpassing/distinguished/splendid/
资本	zīběn	/capital (economics)/
资产	zīchǎn	/property/assets/
资深	zīshēn	/veteran (journalist etc)/senior/highly experienced/
资助	zīzhù	/to subsidize/to provide financial aid/subsidy/
姿态	zītài	/attitude/posture/stance/
滋味	zīwèi	/taste/flavor/feeling/
滋润	zīrùn	/moist/humid/to moisten/to provide moisture/comfortably off/
子弹	zǐdàn	/bullet/CL:粒[li4],顆|颗[ke1],發|发[fa1]/
自卑	zìbēi	/to have low self-esteem/to abase oneself/
自发	zìfā	/spontaneous/
自力更生	zìlìgēngshēng	/regeneration through one's own effort (idiom)/self-reliance/
自满	zìmǎn	/complacent/self-satisfied/
自主	zìzhǔ	/independent/to act for oneself/autonomous/
踪迹	zōngjì	/tracks/trail/footprint/trace/vestige/
宗教	zōngjiào	/religion/
宗旨	zōngzhǐ	/objective/aim/goal/
棕色	zōngsè	/brown/
总而言之	zǒng’éryánzhī	/in short/in a word/in brief/
总和	zǒnghé	/sum/
纵横	zònghéng	/lit. warp and weft in weaving; vertically and horizontal/length and breadth/criss-crossed/able to move unhindered/abbr. for 合縱連橫|合纵连横[He2 zong4 Lian2 heng2], School of Diplomacy during the Warring States Period (475-221 BC)/
走廊	zǒuláng	/corridor/aisle/hallway/passageway/veranda/
走漏	zǒulòu	/to leak (information, secrets etc)/to smuggle and evade tax/to suffer shrinkage (partial loss of goods due to theft etc)/
走私	zǒusī	/to smuggle/to have an illicit affair/
揍	zòu	/to hit; to beat (sb)/(coll.) to smash (sth)/
租赁	zūlìn	/to rent; to lease; to hire/
足以	zúyǐ	/sufficient to.../so much so that/so that/
阻碍	zǔ’ài	/to obstruct/to hinder/to block/obstruction/hindrance/
阻拦	zǔlán	/to stop/to obstruct/
阻挠	zǔnáo	/to thwart/to obstruct (sth)/
祖父	zǔfù	/father's father/paternal grandfather/
祖国	zǔguó	/motherland/
祖先	zǔxiān	/ancestors; forebears/(biology) ancestral species; ancient species from which present-day species evolved/
钻研	zuānyán	/to study meticulously/to delve into/
钻石	zuànshí	/diamond/CL:顆|颗[ke1]/
嘴唇	zuǐchún	/lip/CL:片[pian4]/
罪犯	zuìfàn	/criminal/
尊严	zūnyán	/dignity/sanctity/honor/majesty/
遵循	zūnxún	/to follow; to abide by; to comply with/
做主	zuòzhǔ	/see 作主[zuo4 zhu3]/
座右铭	zuòyòumíng	/motto/maxim/
作弊	zuòbì	/to practice fraud/to cheat/to engage in corrupt practices/
作废	zuòfèi	/to become invalid/to cancel/to delete/to nullify/
作风	zuòfēng	/style/style of work/way/
作息	zuòxī	/to work and rest/
