为I做E	wéi i zuò e	Being the Introverts’ Extrovert. e.g.  introverts talk about the times they’ve been forced into social activity by the lack of a natural extrovert in their friend group.  is also having a homosexual connotation as the slang parodizes the homophonous gay term "為愛做一.”
小孩哥/姐	xiǎohái gē / jiě	Little Big Kids. preternaturally mature kids whose life skills, attitudes, and fearlessness are spooking their elders.
特种兵式旅游	tèzhǒngbīng shì lǚyóu	special forces tourism. Cash-strapped Chinese college students have embraced “special forces tourism” as they finally see the country after three years of pandemic restrictions. Usually setting off on Friday night or early Saturday morning, they’ll quickly run through the major attractions at their destination before rushing back to the classroom on Monday morning.
Gap Day	gap   day	Gap Day. Instead of gap years, young people are simply taking "gap days," from a whole day to just a few hours, and making a deal of it
反向育儿	fǎnxiàng yùér	reverse parenting. While past generations of parents in China maintained a serious demeanor and relied on punishments as a form of discipline, the post-’90s generation is embracing a different approach: When their kids lay on the floor in an ice cream store, parents do the same. If the children throw away a toy, parents throw away others too. Some even go to extremes: putting their kids’ studies on hold to play video games for hours on end, just as their children desired.
早F晚E	zǎo f wǎn e	Fighting in the Morning, Emo in the Evening. Waking up dedicated to “fighting” for a better life, by bedtime they’re so exhausted they just want to lie down and listen to sad music.
早C晚A	zǎo c wǎn a	a popular skincare routine involving the application of vitamin C in the morning and vitamin A at night, and which is sometimes also used to mean “coffee in the morning, alcohol at night.”. 
脆皮大学生	cuìpí dàxuéshēng	crispy skin college students. Literally meaning “crispy skin college students,” the #脆皮大学生 tag has become a playful hangout for the country’s less physically gifted college students
白人饭	báirén fàn	White People’s Food. hastily put together and pre-made meals commonly associated with white people, but also save time and money
电子呕吐物	diànzǐ ǒutùwù	Cyber Vomit. a stew of teary posts, harsh lessons, and extended essays about life’s ups and downs.
显眼包	xiǎn yǎn bāo	Class Clown; Literally meaning “eye-catching,”. xiǎn yǎn bāo
猫奴	māo nú	n. Cat+slave. This Internet slang term is a playful nickname for cat owners because they sweat and toil to serve their pet cats. It is often used self-mockingly by cat owners.
铲屎官	chǎn shǐ guān	n. Scoop+poo+official. The poo-scooping official. This Internet slang term is a playful nickname for cat owners because that’s what they do for their pet cats every day.  It is often used self-mockingly and rather proudly by cat owners.
漫改	màn gǎi	Short for 漫畫改編 [màn huà gǎi biān] “adapted from comics / manga.”. 
国漫	guó màn	n. 國産漫畫 [guó chǎn màn huà] “domestic comics”. 
上头姐妹	shàng tóu jiě mèi	n. Intoxicated sisters. 
上头	shàng tóu	means “(of alcohol) to go to one’s head. ” Intoxicated sisters refer to female fans who are so psyched about the sweet romantic scenes in Internet novels, idol dramas and online photos that they simply go bananas!
甜宠	tián chǒng	“sweet and pampering” idol dramas which are replete with sweet romantic scenes where the male lead would do anything for the female lead. 
追星	zhuī xīng	v. To chase stars. To be a fan.
菊外人	jú wài rén	n. Ju+outside+person. The outsiders. People who don’t know who Wang Ju (trainee on Produce 101 (China)) is but have been surrounded by messages about voting for Wang Ju. 
根本停不下来	gēn běn tíng bú xià lái	<Expression> Absolutely can’t stop. This expression is often used to describe how one can’t stop doing what he or she enjoys.
出圈	chū quān	v. Outside+circle. (Of an idol’s popularity) to exceed the niche of his or her fans. To become well-known even among nonfans.
zqsg <Acronym> 真情实感	zhēn qíng shí gǎn	Sincere feelings. Out of genuine feelings. This acronym is often used to inform the reader that the writer is being honest and sincere.
xswl <Acronym> 笑死我了	xiào sǐ wǒ le	Laughing to death, LOL, LMFAO. 
271	èr qī yī	<Acronym> 愛奇藝 [ài qí yì] iQiyi, a Chinese online video platform. 
dbq <Acronym> 对不起	duì bù qǐ	Sorry.. 
bhys <Acronym> 不好意思	bù hǎo yì si	Excuse me. 
sjb <Acronym> 神经病	shén jīng bìng	Crazy.. 
djll <Acronym> 顶级流量	dǐng jí liú liàng	Top-level web traffic. This Internet slang term refers to the enormous web traffic that popular idols can generate.
拍砖	pāi zhuān	v. To hit with a brick. To lambaste someone online as if hitting him or her with bricks.
轻拍	qīng pāi	v. To hit gently. Often included in sentences like “Please hit lightly,” this Internet slang term is often used as a request for mild, constructive criticism from other Internet users when one expresses an opinion that’s potentially controversial. The equivalent in English would be “Don’t be too harsh.”
这是。。。被黑得最惨的一次	zhè shì…beì hēi de zuì cǎn de yí cì	<Expression> This is the time when… was roasted/humiliated most seriously. This expression is often used humorously to refer to an often unexpected embarrassing situation where someone or an organization is caught in, especially when they are unintentionally put down.
原著党	yuán zhù dǎng	n. The original work party. Fans of the original works, especially fans of the original Internet novels which are adapted into TV dramas or movies
G点	G diǎn	n. G-spot. This Internet slang term metaphorically refers to things that make one elated. It’s often used sarcastically.
技术宅	jì shù zhái	n. Technology+otaku. An introverted or indoorsy geek.
聊骚	liáo sāo	v. Chat+sex appeal. (rizz?) This Internet slang term refers to flirting with or hitting on someone.
自带BGM	Zì dài BGM	v. To possess one’s own background music. This Internet slang term describes a person who is so unique and impressive that when he or she comes up, you could hear music playing on the background. This slang term comes from the fact that important TV or movie characters tend to have their signature background music.
彩虹屁	cǎi hóng pì	n. Rainbow fart. This Internet slang term refers to the fans’ flamboyant compliments on their idols’ appearance, character, work, etc. that may sound exaggerated to outsiders.
大猪蹄子	dà zhū tí zi	Big pig’s foot. Trotter. This Internet slang term refers to an unwelcome man, especially a man who is not sensitive to women’s emotional needs, a fickle man who turns cold to a woman after they become a couple, or a man who is a playboy. The meme went popular in August, 2018 as a generic complaint about men’s shortcomings.
已婚少女	yǐ hūn shào nǚ	n. Married teenage girl. A married woman who still looks, thinks, and/or behaves like a teenage girl. This Internet slang term is often used by married women to describe themselves, because they want to maintain their youthful appearance or mentality.
暴击	bào jī	n. <Gaming> critical hit. Attack that will create greater harm than the displayed data. This Internet slang term is often used to describe a jeering remark that is potentially hurtful or an unexpected situation that someone doesn’t want to encounter.
反差萌	fǎn chā méng	n. Contrast+cuteness. This Internet slang term comes from the Japanese ACG subculture and refers to the adorableness accentuated by the contrast between a character’s sex and gender, age and appearance, biological age and psychological age, identity and personality, past personality and current personality, public persona and true personality, etc.
偶遇	ǒu yù	n. Planned “chance encounter. ” This Internet slang term is often used to tease fans who visit a place where they know the idol will be so that they can “bump into” the idol.
一方有难，八方点赞	yì fāng yǒu nàn, bā fāng diǎn zàn	<Expression> When one region is in trouble, likes come from all sides. This expression is adapted from 一方有難，八方支援 [yì fāng yǒu nàn, bā fāng zhī yuán] “When a disaster strikes an area, help comes from all sides.” Often used satirically, this expression mocks friends or notorious celebrities who are in trouble.
你国	nǐ guó	n. Your country. China. This Internet slang term is often used negatively and satirically, implying one’s unwillingness to side with the government on an issue.
撩	liāo	v. Tantalize/tease/lift up. To flirt with someone.
楼主	lóu zhǔ	n. Building owner. This Internet slang term refers to the person who starts a thread in an online forum, because a string of threads looks like a building and the author of the first post of that string is the “owner”.
西皮	xī pí	n. West+leather. Couple. This Internet slang term mimics the pronunciation of CP.
人设已崩	rén shè yǐ bēng	Character design+already+collapse. [Often of a celebrity] image is ruined, usually because of his or her own inappropriate behavior.
王之蔑视	wáng zhī miè shì	n. The King’s contempt. This Internet slang term is often used to describe one’s righteous expression of contempt, usually coupled with a picture or emoji of the same caption.
封印	fēng yìn	v. Seal+stamp. To cast a spell on something so that it can’t function properly.  This Internet slang term comes from Chinese Internet fantasy novels.
很迷	hěn mí	adj. Very strange, weird, or baffling. 
领盒饭	lǐng hé fàn	v. To receive [one’s] boxed lunch. This Internet slang term describes a character exiting from a drama or movie because of death or other reasons. The term comes from the custom that actors get paid and receive boxed lunches on their last filming day.
黄桑	huáng sāng	n. yellow+mulberry. Emperor. This Internet slang term is a comical way of saying 皇上 [huáng shàng] “Your majesty the emperor” with a Cantonese accent.
怼天怼地	duǐ tiān duǐ dì	v. Diss+sky+diss+ground. To lash out at one’s opponents or detractors fearlessly. This Internet slang term is often used positively to praise one’s courage and eloquence.
作天作地	zuō tiān zuō dì	v. Overreact+sky+overreact+ground. To make a scene. To behave impudently and piss other people off.
吧啦吧啦	bā lā bā lā	v. To chatter away. This Internet slang term mimics the English word “blah blah blah.”
人民币玩家	rén mín bì wán jiā	n. RMB gamers. Gamers who pay significantly more than the average gamers to get an edge or have their characters look stunning in games.
叫兽	jiào shòu	n. Roaring+beast. Depraved professors. This Internet slang term and 教授 [jiào shòu] “professors” are homophones. It is a cynical nickname for scholars who mislead the public with irresponsible comments or sexually harass the students. Their credibility is jeopardized by their own ignorance or depravity.
软妹	ruǎn meì	n. Soft+sister. Young women who are very feminine. Borrowed from the Japanese ACG culture, this Internet slang term is a little sexist
物料	wù liào	n. Marketing materials that fans use to root for their idols at concerts, art shows, variety shows, etc. 
笑著活下去	xiào zhe huó xià qù	<Expression> Live on with a hearty laugh. This expression is often used humorously or ironically to hang in there despite adversity or humiliation.
刮锅底笑	guā guō dǐ xiào	n. Scratch or brush the bottom of a wok+laugh. [Wallace Chung’s] chortle that sounds like the sound of scratching the bottom of a wok. This Internet slang term is used lovingly by the fans to describe Wallace Chung’s famous guffaw.
陌上人如玉，公子世无双	mò shàng rén rú yù, gōng zǐ shì wú shuāng	<Expression> Back then when they meet on the road, the woman was beautiful like a jade, while the young man was so dashing that he was unrivaled in the whole world. Now this expression is widely misinterpreted and used to praise one’s incredibly wonderful (male) idol.
定一个小目标	dìng gè xiǎo mù biāo	<Expression> Set a small goal. This expression became popular in Chen Luyu’s 2016 interview with Chinese real estate tycoon Wang Jianlin where Wang said, “To become the richest person in the world, you need to set a small, feasible goal first, such as making 100 million RMB first.” The expression has been widely quoted to describe goal setting in different areas of one’s life. Sometimes sarcasm is involved.
表情管理	biǎo qíng guǎn lǐ	n. Facial expression management. This Internet slang term refers to celebrities’ management of their facial expressions in public, especially in regards to maintaining an upbeat, pleasant personal image despite how they feel inside. This term describes the emotional labor that celebrities undertake.
脱饭	tuō fàn	v.  To extract [from]+fandom. To stop being someone’s fan.
凉凉	liáng liáng	adj./v. Cool, chilled. Originally the title of the theme song of the 2017 Chinese TV drama Eternal Love, this Internet slang term is now widely used humorously to describe someone or something that went downhill or became a complete failure.
赛高	sài gāo	adj. Competition+high. The highest, the best, awesome. This Internet slang term comes from the Japanese ACG culture.
粉头	fěn tóu	n. Fan+head. Leader of the fans.
雾草	wù cǎo	n. Fog+glass. This Internet slang term is a euphemism for 我操 [wǒ cào] “I fuck” because of the similar pronunciation.
居老师	jū lǎo shī	n. Teacher Ju. This Internet slang term is a nickname for Chinese actor Zhu Yilong who is most well-known for his role in the popular web series Guardian. 居 [jū] is the pronunciation of his surname 朱 [zhū] Zhu in the Wuhan dialect, his hometown dialect.
精致	jīng zhì	adj. Exquisite, delicate, refined, elegant. This Internet slang term is often used to describe someone who cares about his or her appearance. He or she is passionate about skin care, cosmetics, and dressing stylishly.
漫威	màn wēi	n. Comics+power. Marvel Comics.
入画	rù huà	v. Enter+picture. To be captured by the camera or the video camera.
镇魂女孩	zhèn hún nǚ hái	n. Guardian Girls. Female fans of Guardian, a Chinese web drama adapted from the fantasy novel of the same name.
定档	dìng dǎng	v. [Of a movie or TV show] is set to be released or aired. 
擦妈	cā mā	n. Mother Swipe. This Internet slang term is a nickname for American entertainer Christina Aguilera because her initials are CA. The Chinese character 擦 [cā] means “to swipe.” 
母职惩罚	mǔ zhí chěng fá	n. Mother’s role+punishment. Punishment caused by fulfilling the role of a mother. This Internet slang term refers to the disadvantages that a woman has at home and work because of her role as a mother—such as more unpaid housework, discrimination in job search, lower income, and fewer career advancement opportunities.
地表最强	dì biǎo zuì qiáng	adj. The strongest on the face of the earth. 
花路	huā lù	n. Flower+road. Borrowed from Korean pop culture, this Internet slang term is widely used by fans to wish their idols good luck—a smooth and successful career path.
氪金	kè jīn	v. Krypton+gold. To pay online. This Internet slang term was originally used in gaming but is now applied to various online payments.
可盐可甜	kě yán kě tián	adj. Can+salt+can+sweet. Able to be cool and imposing as well as gentle and adorable. This Internet slang term is used to describe celebrities who are able to display a wide range of styles.
微博沦陷	wēi bó lún xiàn	v. [Someone’s] Weibo account+occupied. [Someone’s, usually a celebrity’s] Weibo account is inundated with Internet users’ comments. This Internet slang term is often used to describe the situation where a celebrity grabbed the headlines and then another celebrity related to him or her suddenly received a large number of comments on social media.
low	lōu	adj. Showing poor quality or taste or moral standards. Usually written with the lowercase “l”, this word means tacky, tasteless, or immoral.
入手	rù shǒu	v. Enter+hand. To have bought [something].
谁还不是小公主咋的	shuí hái bú shì xiǎo gōng zhǔ zǎ di	<Expression> Who is not a little princess. So what? This expression means “Everybody can be a little princess. ”  It is funny because 咋的 [zǎ di] is typical in northeastern dialects. The expression sounds like an aggressive retort uttered by a northeastern Chinese man.
6 (=666)	liù (liù liù liù)	adj. <Gaming terminology> Awesome. Skillful. Adept.. This Internet slang term is used to praise someone’s skill at something.
一丢丢	yì diū diū	n. A little. This Internet slang term is a cute alternative to 一点点 [yì diǎn dian] “a little.” It comes from Shanxi dialects.
灵魂舞者	líng hún wǔ zhě	n. Soul+dancer. Soul dancer. This Internet slang term describes a person who botches a dance but exudes boundless confidence.
处女脸	chù nǚ liǎn	n. Virgin+face. Virgin face. This Internet slang term refers to the appearance of the typical female lead in Chinese TV dramas which favor innocent young female characters with little dating experience.
职业假笑	zhí yè jiǎ xiào	n. Professional fake smile. This Internet slang term is used to describe one’s insincere smile.
全靠同行衬托	quán kào tóng háng chèn tuō	<Expression> [This is] entirely thanks to the setoff of industry colleagues [competitors]. The only reason a person or a company is where he/she/it is is because the competitors suck.
尬吹	gà chuī	v. To laud lavishly to the point where even the audience feel embarrassed. This Internet slang term describes some fans’ fulsome praises of their idols in order to convert outsiders.
慈母笑	cí mǔ xiào	n. The smile of a warm and caring mother. This Internet slang term is often used to describe a fan’s indulging smile at the idol or a celebrity’s indulging smile at a co-star.
开画	kāi huà	v. Open+picture. Derived from Japanese, this Internet slang term refers to the first showing of a movie in theaters.
自带热搜体质	zì dài rè sōu tǐ zhì	<Expression> Self-contained “trending-search” body type. This expression is often used to describe a celebrity who easily attracts public attention on social media.
扣	kòu	v. To knock. This Internet slang term means to click or press [a button or key on digital devices].
厂牌	chǎng pái	n. Factory+plaque. Label, a company that produces recorded music.
汤老湿	tāng lǎo shī	n. Dirty Teacher Tang. This Internet slang term is a ludicrous nickname for English actor, producer, and former model Tom Hardy.
老湿	lǎo shī	n. Always+wet. Teacher. This Internet slang term and 老師 [lǎo shī] “teacher” are homophones, but it is often used to refer to a lecherous male teacher.
低分飘过	dī fēn piāo guò	v. To float by with a low score. To narrowly pass an exam with a low score.
塞皇	sài huáng	n. Emperor Sai. This Internet slang term is a nickname for South African and American actress and film producer Charlize Theron.
冬叔	dōng shū	n. Uncle Dong. This Internet slang term is a nickname for Chinese actress Zhou Dongyu.
冲鸭	chōng yā	v. Run+duck. This Internet slang is a cute alternative to 沖呀  [chōng ya] “Run, go go go,” a way of encouraging people to cheer up or work hard.
聊天终结者	liáo tiān zhōng jié zhě	n. Chatting+terminator. A person with whom it is hard to maintain normal conversations because he or she is aloof or keeps committing faux pas.
硬核	yìng hé	adj. Hardcore. This Internet slang term is often used to describe someone or something that is tough, cool, unconventional, or unbelievable.
sk <Acronym> 生快	shēng kuài	short for 生日快樂 [shēng rì kuài lè] “Happy Birthday”. 
养成系	yǎng chéng xì	n. Cultivate/develop+series. The developing type. This Internet slang term describes a type of idols that sharpen their skills with the support of their fans along the way. They tend to start out as young trainees and grow with the fans.
粉丝滤镜	fěn sī lǜ jìng	n. Fan filter. Rose-tinted glasses. This Internet slang term describes the phenomenon of seeing only the good things in one’s idols because you are infatuated with them.
求生欲	qiú shēng yù	n. The will to live. This Internet slang term is often used to describe men’s will to please their intimate partners through sweet talk. It is a sexist term that reflects the stereotype of women being easily offended.
太阳女神	tài yáng nǚ shén	Goddess Sun. This Internet slang term is an affectionate nickname for Chinese entertainer Xie Na. 
三石弟弟	sān shí dì dì	n. Three-stone Brother. This Internet slang term is an affectionate nickname for Chinese actor Wu Lei because the character Lei (磊 [lěi]) consists of three stones (石 [shí]). 
pyq: Acronym for 朋友圈	péng yǒu quān	“circle of friends. ” 1) Friends; 2) The Moments page of WeChat. 
蛙哥	wā gē	n. Frog+brother. Brother frog. This Internet slang term is a tongue-in-cheek mutation of 五阿哥 [wǔ à gē] The fifth brother who was Prince Rong or Yongqi of the Qing dynasty. It became a nickname for actor Alec Su or Su Yongpeng who played the role of Prince Rong on My Fair Princess or Princess Return Pearl in 1998. If you say  五阿哥 [wǔ à gē] fast enough and with a Taiwanese Mandarin accent as Alec Su did, it will sound like 蛙哥 [wā gē].
度娘	dù niáng	n. Lady Baidu. Baidu. This Internet slang term comes from a cartoonized girl image that represents Chinese search engine Baidu.
盛世美颜	shèng shì měi yán	n. Prosperous era+beautiful face. Incredibly gorgeous good looks. This Internet slang term is often used to describe idols, but sometimes it is used sarcastically.
我就笑笑不说话	wǒ jiù xiào xiào bù shuō huà	<Expression> I’ll just smirk and say nothing. This expression is often used to show contempt.
史上最。。。	shǐ shàng zuì	n. The most…in history. This Internet slang term is often used as hyperbole.
初心	chū xīn	n. Original+heart. 1) The original aspiration. This Internet slang term originated from Zen Mind, Beginner’s Mind by Shunryū Suzuki and described the immense enthusiasm one initially had about a goal. The enthusiasm might taper off, thus the caveat 不忘初心 [bú wàng chū xīn] “Do not forget your original aspiration.”  2) The first idol you liked.
高甜	gāo tián	adj. Highly sweet. This Internet slang term positively describes how intimate and affectionate a couple is.
NTR <Acronym>	NTR	This acronym is short for the Japanese phrase “Ne To Ra Re” (寝取られ). It means someone else slept with one’s date or partner.
公开处刑	gōng kāi chǔ xíng	<Expression> Public penalization. This expression is used to shame a person who is not as good looking as the friend he or she shows up with. Appearing with someone better looking than you are is like being openly punished. Not a nice expression.
本命	běn mìng	n. Honmei. True feeling. This Internet slang term comes from the Japanese phrase “hon mei choco” (本命チョコ — true feeling chocolate — the chocolate given by women on Valentine’s Day to men whom the giver has romantic feelings for). In China, it often refers to your favorite star.
站台	zhàn tái	v. Stand+stage. To campaign for [someone/something]. This Internet slang term is often used in sentences like “A person appeared at the event to root for someone/something.”
配一脸	pèi yì liǎn	n. Match+a+face. [Of two things or two people] looking great together, totally compatible.
四字弟弟	sì zì dì di	n. Four-character little brother. This Internet slang term is an affectionate nickname for Chinese entertainer Yiyang Qianxi aka Jackson Yee.
不按套路出牌	bú àn tào lù chū fā	<Expression> Not dealing the cards by the rules. Not playing by the rules of the game.
承包	chéng bāo	v. To contract for. This Internet slang term is often used to describe your attraction to an idol or love interest or his or her good qualities. You like it so much that you want to be possessive.
声控	shēng kòng	n. Voice+freak. One who is easily attracted to people (of the opposite sex) with nice voices.
娇嗔	jiāo chēn	v./n./adj. To protest coquettishly. This Internet slang term is often used humorously to describe the feminine side of a man.
红红火火恍恍惚惚	hóng hóng huǒ huǒ huǎng huǎng hū hū	<Expression> Ablaze+dazzled. This expression means laughing out loud and mimics the sound of laughter. It is the funny result of entering eight consecutive h’s using the Pinyin input method.
摩擦摩擦	mó cā mó cā	v. Friction friction. This expression comes from the widely ridiculed 2014 song “My Skating Shoes” by Pang Mailang. It is now often a euphemism for having sex.
一步两步， 是魔鬼的步伐	yī bù liǎng bù, shì mó guǐ de bù fá	<Expression> One step, two steps, [it] is the gate of a devil. This expression comes from the widely ridiculed 2014 song “My Skating Shoes” by Pang Mailang. It is often used to describe clumsy and uncoordinated walking or dancing steps.
全程无尿点	quán chéng wú niào diǎn	<Expression> There is not a thing [in this drama/movie/performance] that makes me want to use the restroom. This expression is often used to praise a drama/movie/performance that’s so captivating that people don’t feel bored at all.
嫉妒使我质壁分离	jì dù shǐ wǒ zhì bì fēn lí	<Expression> Jealousy made me undergo plasmolysis. Jealousy contorted my face and made me ugly. This expression is often used when you see your idol flirt with the opposite sex in a TV drama or movie.
风骚走位	fēng sāo zǒu weì	n. Flirtatious+walk. <Gaming> This Internet slang term originally referred to the control of the movement of video game characters to avoid attacks or elimination.  It also refers to people’s comic walking movement.
土味情话	tǔ weì qíng huà	n. Crude and unsophisticated+words of love. Corny terms of endearment.
糯	nuò	adj. Glutinous, sticky. Soft, gentle. This Internet slang term is often used to describe a man’s loving, gentle, buttery, and endearing voice.
搬运	bān yùn	v. To transport. This Internet slang term means to download videos, articles, photos, etc. and then repost  them on another website.
手控	shǒu kòng	n. Hand+freak. A person who is easily attracted to people with beautiful hands.
颜狗	yán gǒu	n. Face+dog. A person who is easily attracted to good-looking people or stars, sometimes to the extent of ignoring their weaknesses.
肉体饭	ròu tǐ fàn	n. Body+fan. A fan who adores the idol’s body or figure, compared to other fans who adores the idol’s face, voice, hands, etc.
能打	néng dǎ	adj. Can+fight. Competitive. This Internet slang term is often used to describe an entertainer’s appearance, acting, singing, fashion, etc.
啾咪	jiū mī	This Internet slang term is widely used in “啾咪^. <” by Taiwanese entertainers to act cute. The body language includes winking and the deaf’s gesture meaning “I love you.”
卓伟视角	zhuó wěi shì jiǎo	n. Zhuo Wei’s perspective. [Seen from] Zhuo Wei’s perspective. Zhuo Wei is a Chinese paparazzo. This Internet slang term is used to describe a photo or video shot from a distance.
赛金花	sài jīn huā	n. Surpass+gold flower. Surpass the gold flower. This Internet slang term is an affectionate nickname for American comedian, writer, political commentator, actor, and television host Seth Meyers.
秒懂	miǎo dǒng	v. Second+know. To understand within a second. To understand instantly.
没眼看	méi yǎn kàn	<Expression> [Having] no eyes to see. Can’t stand looking at [something embarrassing, shocking, or disgusting].
愿你出走半生，归来仍是少年	yuàn nǐ chū zǒu bàn shēng, guī lái réng shì shào nián	<Expression> May you remain a teenager even after leaving home half a life time. This expression is often used to encourage people to be ageless at heart.
沙雕	shā diāo	adj./n. Sand+sculpture. This Internet slang term is a euphemism for 傻屌 [shǎ diǎo] “stupid+penis” or “stupid, stupid-ass.”
流量才是王道	liú liáng cái shì wáng dào	<Expression> Web traffic is the rule. This expression became popular as the ability to drive traffic to the website is considered very important.
是有多。。。	shì yǒu duō…	<Expression>  Is so… This expression is often used  in the sentence “…is so…” It is often said in disbelief. 
口耐	kǒu nài	adj. Mouth+resistant. Lovely. Cute. This Internet slang term is 可爱 [kě ài] “lovely, cute” and mimics the Taiwanese Mandarin accent.
然鹅	rán é	interj. But, nevertheless. This Internet slang term is an alternative to 然而 [rán ér] and mimics the Cantonese accent.
怨念	yuàn niàn	n. Grudges, complaints. 
寄己	jì jǐ	n. Self. This Internet slang term is an alternative to 自己 [zì jǐ] “self, oneself” and mimics the Cantonese accent. 
大表哥	dà biǎo gē	n. The eldest cousin brother. This Internet slang term is an affectionate nickname for British actor Dan Stevens, because of his role on Downton Abbey.
禁欲	jìn yù	adj. Forbidden+desire. Stolid, showing little emotion or animation.
小言	xiǎo yán	n. Romantic fiction. 
官宣	guān xuān	n. Official announcement. This Internet slang term is often used to describe official announcements in the entertainment industry.
槽点满满	cáo diǎn mǎn mǎn	<Expression> Problems worth criticizing or teasing about+full. Full of problems that are worth criticizing or teasing about.
狗粮猝不及防	gǒu liáng cù bù jí fáng	<Expression> Dog food+unexpected. The unexpected public displays of affection.
元气	yuán qì	n. Vigor, strength, enthusiasm. 
老板	lǎo bǎn	n. Boss. This Internet slang term is often used to refer to one’s idols, especially those who have companies or personal studios. 
首先你要有个。。。	shǒu xiān nǐ yào yǒu gè…	<Expression> First you need to have a…This expression is commonly used to throw cold water on people who are planning or fantasizing about something nice. 
自干五	zì gàn wǔ	n. Self+do+five. The self-motivated 50 Cent Party. Self-motivated Internet commentators who defend the government. This Internet slang term is related to 五毛黨 [wǔ máo dǎng] “The 50 Cent Party.”
五毛党	wǔ máo dǎng	n. The 50 Cent Party. Internet  commentators who are rumored to be hired by Chinese authorities in an attempt to manipulate public opinion to the benefit of the government.
老鹿蹒跚	lǎo lù pán shān	<Expression> An old deer staggers. This expression describes the reaction of unmarried people in their late 20s or older to their crushes. As opposed to 小鹿亂撞 [xiǎo lù luàn zhuàng] “A fawn rushes impetuously, an idiom that describes a young person’s restless state due to fear or strong emotions [upon seeing his or her crush],” this expression pokes fun at older unmarried people’s reluctance to be emotionally invested in the love interest for fear of getting hurt.
老夫的少女心	lǎo fū de shào nǚ xīn	n. The old man’s (referring to oneself, regardless of the actual gender) teenage-girl heart. The gentle, dreamy, and girl side of me.
一本正经地胡说八道	yì běn zhèng jīng di hú shuō bā dào	<Expression> Talking nonsense with a straight face. This expression is often used humorously to mock oneself or to dismiss other people’s arguments.
不能同意更多	bù néng tóng yì gèng duō	<Expression> Can’t agree more. 
不转不是中国人	bù zhuǎn bú shì zhōng guó rén	<Expression> [You are] not a Chinese national if you don’t repost this article. This coercive expression is often used in nationalistic WeChat article titles.
标题党	biāo tí dǎng	n. Title+party. Clickbait titles. Sensational article titles whose main purpose is to attract clicks or reads. Such titles may not be very relevant to content of the articles.
是中国人就转	shì zhōng guó rén jiù zhuǎn	<Expression> Repost it if you are a Chinese national. This coercive expression is often used in nationalistic WeChat article titles.
卷西	juǎn xī	n. Curly+west. Curly West. This Internet slang term is an affectionate nickname for American actor Jesse Eisenberg.
钢铁直男	gāng tiě zhí nán	n. Steel+iron+straight+male. Iron straight men. This Internet slang term refers to heterosexual men who constantly fail to grasp their female partners’ emotional needs.
激情小短片	jī qíng xiǎo duǎn pian	n. Passionate little short films. Adult videos. Porn videos.
520	wǔ èr líng	n. This Internet slang term means “I love you” because “520” sounds like 我愛你 [wǒ ài nǐ] “I love you. ” May 20 is a day for confessing one’s love.
踩	cǎi	v. To stomp. This Internet slang term means 1) to visit a web page and 2) to oppose someone’s opinion.
秒删	miǎo shān	v. Second+delete. To delete within seconds. To delete swiftly. This Internet slang term is often used to describe celebrities’ quick deletion of their Weibo posts. To their chagrin, those posts are often screencropped by Internet users before deletion and prompted more discussions due to instant deletion.
爆款	bào kuǎn	n. Hot item. An item that sells well or incredibly popular.
死宅	sǐ zhái	n. Die-hard otaku. A person who is extremely indoorsy, often because of a passion about gaming and watching movies or TV dramas.
中央空调	zhōng yāng kōng tiáo	n. Central air conditioning and heating system. This Internet slang term refers to a man who behaves like a casanova while claiming to be in a committed relationship.
傻麅子	shǎ páo zi	n. Silly roe deer. A kind of roe deer found in north China. This Internet slang term refers to the roe deer. It is also a nickname for singer and actor Lu Han.
吐血	tù xiě	v. To vomit blood. This Internet slang term is used to describe one’s shock, anger, or embarrassment.
众人皆醉我独醒	zhòng rén jiē zuì wǒ dú xǐng	<Expression> Everyone is drunk and only I am sober. This expression is quoted from a poem by Li Bai from the Tang dynasty, but now it is often used to describe a self-important person sarcastically.
脑子瓦特了	nǎo zi wǎ tè le	[wǎ tè] <Expression> Brain+Watt. [Your] brain is broken. You are out of your mind. You are stupid. This expression comes from the Shanghainese dialect.
黑出翔	hēi chū xiáng	<Expression> Black+out+shit. To eloquently roast a person to the point where the person shitted his or her pants.
糟了，是心动的感觉	zāo le, shì xīn dòng de gǎn jué	<Expression> Shit! [It’s] the feeling of falling in love. This expression is often used humorously to describe an unexpected attraction to someone or something.
糊	hú	v./adj. Of or like paste. (Of a performer or show) be completely unsuccessful; fail totally.
得罪造型师	dé zuì zào xíng shī	<Expression> (Of a celebrity) offending the stylist. This expression is often used to comment on celebrity fashion disasters.
皮一下很开心	pí yí xià hěn kāi xīn	<Expression> [Of someone] deriving pleasure from being naughty. This expression is often used to comment on the intention of someone’s pranks or cheeky remarks.
总攻	zǒng gōng	n. Attack all around. A person who launches an all-around attack. A person who takes charge of the situation and is able to make others obey him or her. This Internet slang term comes from the Japanese ACG culture, especially Boy’s Love-themed works. The term is often used positively to describe a natural leader.
总攻本攻	zǒng gōng běn gōng	n. Attack all around+oneself. This Internet slang term has the same meaning as 總攻 [zǒng gōng]. It is often used to emphasize the leadership role in a group or a romantic relationship that one possesses.
歪个楼	wāi gè lóu	<Expression> Slant the building. Let me digress. 樓 [lóu] as an Internet slang term refers to a post and its replies in online discussions. When you want to digress, you use this expression as a reminder to other Internet users.
现充	xiàn chōng	adj./n. Reality+fulfilling. This Internet slang term comes from the Japanese Internet slang term “リア充” and refers to people who live a fulfilling life without ACG (Anime, Comic and Games) or the Internet.
史诗级	shǐ shī jí	adj. Epic poem-level. This Internet slang term means reaching a very high degree.
鹅厂	é chǎng	n. Goose+factory. Penguin factory. Tencent. This Internet slang term refers to Tencent whose logo is a penguin.
亲亲抱抱举高高	qīn qīn bào bào jǔ gāo gāo	<Expression> Kiss and hug and raise above the head [to show affection]. This expression is often used to describe one’s love for pets or loved ones.
肥宅	féi zhái	adj./n. Fat+indoorsy. 1) Fat and inactive. 2) A fat and indoorsy person who prefers watching movies or TV dramas or playing video games instead of going out. This Internet slang term is often used to describe oneself.
自戳双目	zì chuō shuāng mù	<Expression> To poke one’s own eyes. To blind oneself (because you can’t bear seeing something) . This expression is often used to comment on artworks that are visually appalling or extremely shoddy.
紧脏	jǐn zāng	adj. Tight+dirty. Nervous. This Internet slang term means 緊張 [jǐn zhāng] “nervous.” It mimics the Taiwanese Mandarin accent.
干得漂亮	gàn de piào liang	<Expression> Well done! This expression is sometimes used to praise well-executed pranks or repartee. 
我们家	wǒ men jiā	n./adj. […Of] our home. This Internet slang term is often used before a star’s name. Fans often use the term to describe their idolset and/or the fan group they belong to.
救救孩子	jiù jiù hái zi	<Expression> Save the child. This expression is often used when asking for help. “The child” refers to oneself.
司姬	sī jī	n. Female driver. A female who is skilled in things such as gaming and telling dirty jokes. This Internet slang term is the female version of 老司機 [lǎo sī jī].
陈大发	chén dà fā	n. Chen+make a big fortune. Chen Dafa. This Internet slang term is a nickname for Taiwanese actress Ivy Chen or Chen Yihan. She gave the nickname to herself. It is a nickname given to her by her, because she thought it was a funny nickname.
装完逼就跑	zhuāng wán bī jiù pǎo	<Expression> Fleeing immediately after showing off or acting like I’m better than I really am. This expression is often used for self-mockery.
皮	pí	adj. Naughty. 
某宝	mǒu bǎo	n. Some+treasure. This Internet slang term is a euphemism for Taobao. It is often used sarcastically or humorously without openly advertising the Alibaba shopping site.
尬舞	gà wǔ	v. Awkward+dance. Dance clumsily or awkwardly, often for comical effect.
嫁给了爱情的模样	jià gěi le ài qíng de mú yàng	<Expression> The appearance of being married to love. This expression is often use to celebrate a couple’s love. Their happiness are attributed to the fact that they are deeply in love.
昂	áng	interj. This interjection is often used to indicate confusion with a meaning similar to “What?” Also, it can be used at the end of a sentence to emphasize one’s statement. 
灭霸	miè bà	n. Destroy+tyrant. Thanos. Thanos is a fictional character appearing in American comic books published by Marvel Comics.
壮士	zhuàng shì	n. Hero, fighter. This Internet slang term is used humorously to address a fellow Internet user. Sarcasm is sometimes applied.
隐形贫困人口	yǐn xíng pín kùn rén kǒu	n. The invisible poverty-stricken population, people whose consumption exceeds their income. 
脱粉	tuō fěn	v. Break away from+fan. To stop being [a celebrity’s] fan.
抖腿党	dǒu tuǐ dǎng	n. The leg-shaking gang. People with jittery legs while sitting.
戾气	lì qì	n. Evil tendencies. This Internet slang term refers to the antisocial inclinations that people display online or offline.
结石姐	jié shí jiě	n. Sister Calculus. Here, “calculus” means a concretion of minerals formed within the body, especially in the kidney or gallbladder. This Internet slang term is a nickname for Jessie J because 結石 [jié shí] “calculus” sounds like “Jessie.”
好看的皮囊千篇一律，有趣的灵魂万里挑一	hǎo kàn de pí náng qiān piān yí lǜ, yǒu qù de líng hún wàn lǐ tiāo yī	<Expression> Good looks follow a fixed pattern, but it’s rare to find an interesting soul. This expression became popular in 2017.
耐撕	nài sī	adj. Able to endure tearing. 1) Nice; 2) resilient. This Internet slang term was made popular by Chinese reality TV show Keep Running which is famous for its game of “tearing name tags.”
磨人的小妖精	mó rén de xiǎo yāo jing	<Expression> Bothersome little elf. This expression is often said by a domineering male lead to his titillating young girlfriend in Internet novels. It is often followed by “what should I do with you?”
举高高	jǔ gāo gāo	v. Hoist+high+high. To hoist [often one’s intimate partner] with both hands above one’s head to show affection. This Internet slang term is often used humorously to express one’s love.
送你上热评	sòng nǐ shàng rè píng	<Expression> Send you to [the section of] hot comments [which are often automatically stuck to the top]. This expression is often used to express one’s approval of a comment on a social media post because it is well-written or funny. The Internet users who use this expression usually click “like” on the comment too to make it pinned to the top of the comment section.
送你上墙	sòng nǐ shàng qiáng	<Expression> Send you onto the wall. Send you to [the section of] hot comments [which are often automatically placed at the top]. This expression is often used to express one’s approval of a comment on a social media post because it is well-written or funny. The Internet users who use this expression usually click “like” on the comment too to make it pinned to the top of the comment section.
QAQ <Emoticon>	QAQ	The emoticon looks like a sad face with a gaping mouth and a pair of teary eyes. It is often used to express sadness.
流弊	liú bì	adj. Cool, awesome. The original meaning of the word is “the harmful effect of something,” but as an Internet slang term, it is an alternative way of saying 牛逼 [niú bī].
整段垮掉	zhěng duàn kuǎ diào	<Expression> The whole segment collapses. [Of a person or performance] to fail completely. This expression was first made popular by singer Xue Zhiqian aka Joker Xue on the variety TV show The Mars Intelligence Agency. It is often used to tease others or oneself.
犬系男	quǎn xì nán	n. Doglike man. A doglike man is athletic, outgoing, fun-loving, and a bit needy. This slang term comes from Japanese and is often used to label a type of boyfriends.
狼系男	láng xì nán	n. Wolflike man. A wolflike man is calm, domineering, committed, and a bit hard to control. This slang term is often used to label a type of boyfriends.
猫系男	māo xì nán	n. Catlike man. A catlike man is independent, artistic, gentle, and a bit effeminate. This slang term comes from Japanese. This slang term is often used to label a type of boyfriends.
奶凶奶凶	nǎi xiōng nǎi xiōng	<Expression> Adorably mad. This expression describe the way a cute little child or a young person whose appearance or personality resembles a cute little child’s gets mad. You think it is cute not scary when such a person gets mad.
小狼狗	xiǎo láng gǒu	n. Little wolfdog. A woman’s young, dashing, and responsible boyfriend.
一本正经地胡说八道	yì běn zhèng jǐng de hú shuō bā dào	<Expression> Talking nonsense with a straight face. 
这种男友不分留著过年么	zhè zhǒng nán yǒu bù fēn liú zhe guò nián ma	<Expression> [You don’t] break up with such a boyfriend. Are you saving him for the next Chinese New Year? This expression is often used to criticize a man who physically or emotionally abuses his girlfriend.
炒CP	chǎo CP	v. Hype+CP [Couple]. [Of the media] to hype two entertainers of either opposite sexes or the same sex as a couple, often for business purposes. Many TV dramas, films, and reality TV shows like pairing up entertainers to attract public attention.
这位同学，我装逼的时候，请你不要说话	zhè weì tóng xué, wǒ zhuāng bī de shí hou, qǐng nǐ bú yào shuō huà	<Expression> This fellow student, when I am acting all snotty, please don’t talk [to give me away]. Hey dude, don’t stop me when I’m bragging.
神同步	shén tóng bù	n. Magic simultaneity. This Internet slang term is often used to describe the situation where people display the same body language.
粑粑	bǎ bá	n. Poo. Dad. This Internet slang term means “dad”. It mimics the Taiwanese Mandarin accent.
麻麻	mǎ má	n. Sackcloth. Mom. This Internet slang term means “mom”. It mimics the Taiwanese Mandarin accent.
杏红	xìng hóng	n. Apricot pink, yellowish pink. This Internet slang term is an affectionate nickname for Ashin or Chen Hsin-hung or Chen Xinhong, the vocalist of the Taiwanese band Mayday. The nickname and his Chinese first name are semi-homophones.
新专	xīn zhuān	n. New album. This Internet slang term is short for 新專輯 [xīn zhuān jí].
咆哮教主	páo xiào jiào zhǔ	n. Roaring hierarch. This Internet slang term is a nickname for Taiwanese actor Steve Ma because of his hysterical acting style at the early stages of his career.
咆哮体	páo xiào tǐ	n. Roaring style. This Internet slang term refers to an Internet writing style which is replete with exclamation marks and expressions like 有木有 [yǒu mù yǒu] “Correct?” to strongly express one’s thought.
腿玩年	tuǐ wán nián	<Expression> Leg+play+year. This expression is short for “I can play with her legs for a whole year.” It is adapted from the line “Look at that pair of legs. I can play with them for a whole night”, said by a gangster to an undercover police officer’s girlfriend, in the movie “Century of the Dragon.” This expression is a typical example of the male gaze.
天命圈	tiān mìng quān	n. Mandate of Heaven+Circle. Safe zone. This Internet slang term originated from the game Knives Out.
小透明	xiǎo tòu míng	n. Little+transparent. Nobody. This Internet slang term is often used by fans who don’t have a large presence in the fandom to describe themselves.
秀	xiù	adj. Flamboyant, showy, conspicuous. This Internet slang term is often used sarcastically.
姨母笑	yí mǔ xiào	n. Aunt+smile. The smile of an aunt. This Internet slang term is often used by female fans to describe their affectionate and indulgent smile at their male idol.
毒唯	dú wéi	n. Poison+only. Fans who like only one member of an idol group and exhibit hostility against the other members of the group.
地图炮	dì tú pào	n. map+cannon. Discrimination against people from a certain region.
种子	zhǒng zi	n. Seed. Torrent file. As an Internet slang term it often refers to a torrent file. In the BitTorrent file distribution system, a torrent file is a computer file that contains metadata about files and folders to be distributed, and usually also a list of the network locations of trackers, which are computers that help participants in the system find each other and form efficient distribution groups. A torrent file does not contain the content to be distributed; it only contains information about those files, such as their names, sizes, folder structure, and cryptographic hash values for verifying file integrity.
退散	tuì sàn	v. Retreat+dispel. Go away. This Internet slang term comes from the Japanese word “逃げ去る.” It is often used to drive away something or someone unwanted.
土偶	tǔ ǒu	n. Indigenous & Unrefined+idol. Indigenous & Unrefined Idol. This Internet slang term is a nickname for Idol Producer, a Chinese reality boy group survival show produced by iQiyi.  The show was criticized for copying Produce 101 illegally.
土创	tǔ chuàng	n. Indigenous & Unrefined+create. Indigenous & Unrefined Create. This Internet slang term is a nickname for Produce 101, a Chinese reality television show spinoff of the South Korean television show Produce 101. The Chinese name of the show is literally Create 101. The show was criticized for the caliber of its contestants as well the quality of production.
洗白	xǐ bái	v. Wash+white. <ACG Terminology> This term originally described the situation where an ostensibly negative character suddenly turned into a positive character. Now it means “[of people or organizations] to get rid of a bad reputation by disseminating positive but embellished stories about themselves.”
洗地	xǐ dì	v. Wash+floor. This Internet slang term is from the 2004 movie “Kung Fu Hustle” where a Deadly Axe Gang leader asked the members to clean the blood on the floor after a gang fight. The term means to whitewash, to cover up or gloss over scandals, vices or crimes.
斯巴达	sī bā dá	adj. Sparta. Crazy. [Of a person] going nuts. This Internet slang term comes from the video “This Is Sparta,” a parody of the movie Meet the Spartans (2008).
煞笔	shā bǐ	n. While the original meaning of the word is “ending of a piece of writing;concluding line of an article,” as an Internet slang term, it means “jackass. ” It is a euphemism for SB/傻逼 [shǎ bī].
不喜勿喷	bù xǐ wù pēn	<Expression> If you don’t like [what I’m saying], don’t rant [against me]. This expression is often used before expressing one’s opinion online.
何老师	hé lǎo shī	n. Teacher He. This Internet slang term is a nickname for He Jiong, a Chinese television host, singer, actor, director and a former Arabic lecturer in Beijing Foreign Studies University.
陈老师	chén lǎo shī	n. Teacher Chen. This Internet slang term is a nickname for Hong Kong actor Edison Chan aka Chen Guanxi and Taiwanese singer-songwriter Cheer Chen aka Chen Qizhen.
脑斧	nǎo fǔ	n. Brain+ax. Tiger. This Internet slang term mimics the pronunciation of 老虎 [lǎo hǔ] “tiger” with accents that do not differentiate between “h” and “f” in Pinyin.
战斗民族	zhàn dòu mín zú	n. Fighting+ethnic group. The fighting nation. Russia, Russian people. This Internet slang term emphasizes Russians’ gallantry and the mind-boggling humor resulting from their bravery. It is often used humorously.
意不意外？惊不惊喜？	yì bú yì wài? jīng bù jīng xǐ?	<Expression> Was that unexpected? Were you pleasantly surprised? This expression is often used humorously to comment on a surprising plot twist or an unexpected turn of events. 
炸裂	zhà liè	adj. Explode+shatter. [Of one’s acting, singing, writing, etc.] awesome, breathtaking.
招黑体质	zhāo hēi tǐ zhì	n. Beckon+black+body type. The criticism-inducing body type. This Internet slang term is often used to describe celebrities who are easy targets for criticism or vilification by Internet users. It is often used by celebrities for self abasement.
双标狗	shuāng biāo gǒu	n. Double standard+dog. A double-standard dog. This Internet slang term is a derogatory term for people who are considered practicing a double standard.
建国后不许成精	jiàn guó hòu bù xǔ chéng jīng	<Expression> [Of someone or an animal] forbidden to become a goblin after the foundation of the People’s Republic of China. This expression came from a 2015 rumor that the State Administration of Press, Publication, Radio, Film and Television of the People’s Republic of China forbade the animal roles in animated series, TV shows, and films set in China after October 1, 1949 to become a goblin or spirit. Now the expression is often used to describe an incredibly smart animal that behaves like human beings or an amusingly adorable person.
女权癌	nǚ quán ái	n. Feminism+cancer. Feminist cancer. This Internet slang term is a derogatory term for feminists. It is often used by people who loathe feminism and feminists.
女权婊	nǚ quán biǎo	n. Feminism+bitch. Feminist bitch. This Internet slang term is a derogatory term for feminists. It is often used by people who loathe feminism and  feminists.
中华田园女权	zhōng huá tián yuán nǚ quán	n. Chinese rural feminism. Adapted from 中華田園貓 [zhōng huá tián yuán māo] “Chinese rural cat” and 中華田園狗 [zhōng huá tián yuán gǒu] “Chinese rural dog,” this Internet slang term is a derogatory term for Chinese feminists. It is often used by people who assume that Chinese feminists advocate for women’s rights but evade women’s responsibilities. They also often oppose Chinese feminists’ communication style.
跳戏	tiào xì	v. Jump+drama. [Of an actor or actress] to give unconvincing performance. The reasons vary. It could be because the viewers are accustomed to seeing the actor or actress cast in a different type of role, because the performer’s previous acting in a similar role left a deeper impression on the audience, or because the storyline is problematic.
越努力，越幸运	yuè nǔ lì, yuè xìng yùn	<Expression> The harder you work, the luckier you are. This inspirational expression recently became more popular as the slogan of Idol Producer, a Chinese reality boy group survival show produced by iQiyi.
Gay蜜	Gay mì	n. Gay+honey. [A woman’s] best gay friend. This Internet slang term is often used positively to describe a woman’s sophisticated and compassionate homosexual guy friend.
菇凉	gū liáng	n. Mushroom+cold. Girl. This Internet slang term is 姑娘 [gū niáng] “girl” in the Lanzhou dialect. It is often used for humorous effect.
课代表	kè dài biǎo	n. Class representative. This Internet slang term refers to people who are good at explaining a hot topic for other Internet users. Internet users often call for a “class representative” humorously when they want to understand a complicated issue so that they don’t have to read about it on their own.
渣渣辉	zhā zhā huī	n. Trashy+Hui. Trashy Hui. This Internet slang term is a nickname for Hong Kong actor Nick Cheung Ka Fai or Zhang Jiahui because that’s the way he pronounced his name in Mandarin.
社会我X哥/姐	shè huì wǒ X gē/jiě	<Expression> Society+my+X+brother. My worldly-wise brother/sister X [X is usually one of the characters in the person’s Chinese name]. This expression is often followed by 人狠話不多 [rén hěn huà bù duō] “tough and laconic” to tease someone who puts on airs or pretends to be sophisticated or street-smart.
社会	shè huì	adj. Worldly, sophisticated, street-smart. This Internet slang term is often used sarcastically.
谢耳朵	xiè ěr duo	n. Xie+ear. Xie Ear. This Internet slang term combines the Chinese last name Xie and the word ear. It is an affectionate nickname for American actor Jim Parsons and his role Sheldon Lee Cooper in The Big Bang Theory.
大清早亡了	dà qīng zǎo wáng le	<Expression> The Qing dynasty is long gone. This expression is often used to comment on outmoded and backward ideas redolent of the Qing dynasty. Internet users often lambaste dictatorship and misogyny using this expression.
马杀鸡	mǎ shā jī	n. Horse+kill+chicken. Massage. This Internet slang term mimics the pronunciation of the English word “massage.” It is also a funny translation of the Japanese word  マッサージ “masaji/masachi.”
确认过眼神	què rèn guò yǎn shén	<Expression> Confirmed the look in [his/her] eyes. I can tell from the look. This expression originally came from JJ Lin aka Lin Junjie’s song “Tales of the Red Cliff,” the theme song of the online game Red Cliff. Now it is used humorously to show one’s certainty about something.
贤者时间 (=贤者模式)	xián zhě shí jiān	n. The virtuous person time = The virtuous person mode.. Derived from the Japanese term 贤者タイム (kenja time—the period after orgasm when a man is free from sexual desire and can think clearly), this Internet slang term refers to the state of feeling peaceful, free from desire, sober-minded or emotionally empty after intensive activities, such as watching a great movie, playing an exciting game, and masturbation.
没节操	méi jié cāo	adj. [Of someone] stooping low and doing unethical things. This Internet slang term is closely related to 節操 [jié cāo] “scruples, moral principles, integrity.”
高光时刻	gāo guāng shí kè	n. Highlight+moment. One’s most glamorous or head-turning moment.
锤哥	chuí gē	n. Hammer+brother. Brother Hammer. This Internet slang term is an affectionate nickname for Australian actor Chris Hemsworth because of his titular role in the movie “Thor.”
脑残粉	nǎo cán fěn	n. Brain-damaged+fan. Stanners. Zealous fans who blindly worship their idols.
暗中观察	àn zhōng guān chá	v. To observe furtively. This Internet slang term is widely seen in stickers to reveal that one is a lurker and to remind others to behave themselves (such as not being too cocky).
这届…不行	zhè jiè…bù xíng	<Expression> This year’s…are not good. This expression is often used to show disapproval of a certain group of people who did not live up to one’s expectation. The expression mimics the tone of voice of Chinese teachers. Chinese teachers at elementary schools and high schools are famous for degrading all their students as the “worst group of students they’ve ever taught.”
智商税	zhì shāng shuì	n. IQ tax. This Internet slang term is often used in the phrase “paid the IQ tax” to describe someone who is gullible.
伟光正	wěi guāng zhèng	adj. Great, honorable, and correct. This Internet slang term is short for 偉大，光榮，正確 [wěi dà, guāng róng, zhèng què], often used sarcastically.
白古	bái gǔ	n. White+Gu. The white Louis Koo. This Internet slang term is the nickname for Hong Kong actor Louis Koo in his untanned era.
黑古	hēi gǔ	n. Black+Gu. The black Louis Koo. This Internet slang term is the nickname for Hong Kong actor Louis Koo after he deliberately got tanned to avoid putting on makeup.
麻竹	má zhú	v. Sweet bamboo. Bookmarked. Saved. This Internet slang term is used when you save a social media post for later perusal. 麻竹 [má zhú] sounds like 碼住 [mǎ zhù] “bookmarked.”
马	mǎ	v. Horse. Bookmarked. This Internet slang term is used when you save a social media post for later perusal. 馬 [mǎ] and 碼 [mǎ ] are homophones.
不服憋著	bù fú biē zhe	<Expression> If you are not convinced, hold it in. This expression is often used to show one’s confidence about one’s ability or argument.
不服来战	bù fú lái zhàn	<Expression> If you are not convinced, come and fight [come argue with me]. This expression is often used to show one’s confidence about one’s argument.
停更	tíng gēng	v. Stop+update. [Of a program, manga series, podcast, etc.] to stop updating.
炸毛	zhà máo	v. Explode+hair. To flip out.
男票	nán piào	n. Male+ticket. Boyfriend. 票 [piào] mimics the Taiwanese Mandarin accent and is short for 朋友 [péng yǒu] “friend(s).”
女票	nǚ piào	n. Female+ticket. Girlfriend. 票 [piào] mimics the Taiwanese Mandarin accent and is short for 朋友 [péng yǒu] “friend(s).”
票圈	piào quān	n. Ticket+circle. 1) Friends. 2) [WeChat] Moments, the WeChat news feeds which demonstrate what your friends are up to lately. 票 [piào] mimics the Taiwanese  Mandarin accent and is short for 朋友 [péng yǒu] “friend(s).”
杠铃般的笑声	gàng líng bān de xiào shēng	<Expression> Barbell-like laughter. Adapted from 銅鈴般的笑聲 [tóng líng bān de xiào shēng] “copper bell-like laughter,” this expression is often used humorously to describe a rowdy’s laughter.
乃们	nǎi men	pronoun. You [guys]. This Internet slang term is used humorously because 乃 [nǎ] is the archaic form of “you.”
艾特	ài tè	v. To tag [someone on social media]. This Internet slang term is often used to precede the name of a person or a group you want to talk to.
咖位	kā weì	n. A celebrity’s status in the entertainment industry. 
C位	C weì	n. C position. The central position [in photo shooting or video taping, which implies the celebrity’s high status].
赶脚	gǎn jiǎo	n./v. Rush+feet. Feelings. While the original meaning of this word is “to hire oneself to transport goods with one’s own donkey, mule, etc.” As an Internet slang term, it means 感覺 [gǎn jué] “feeling” or “to feel.” It mimics the Northeastern accent for humorous effect.
收图	shōu tú	v. Collect+pictures. To save into one’s personal collection the pictures of one’s idol posted by other people on social media.
私货	sī huò	n. Personal+goods. Personal opinion that might not be liked by the readers or viewers.
杠精	gàng jīng	n. Bicker+elf. This Internet slang term is used disapprovingly to describe people addicted to bickering and faultfinding in online discussions. They are aggressive, brash, and always seek to win the argument.
正在提刀赶来的路上	zhèng zài tí dāo gǎn lái de lù shàng	<Expression> [Someone] is carrying a broadsword on his or her way to this place. This expression is used humorously to speculate that someone will be upset about what you are seeing.
寄刀片	jì dāo piàn	v. To mail blades [to the screenwriter]. <ACG> This Internet slang term is often used to imply the audience’s dissatisfaction with the development of a storyline.
这是一道超纲题	zhè shì yí dào chāo gāng tí	<Expression> This is a question that exceeds the scope of the examination guideline. This questions is too hard. This expression is often used humorously to refer to things that are beyond one’s ken or capabilities.
自带滤镜	zì dài lǜ jìng	n. Pre-installed filters. This Internet slang term is often used to describe someone who looks beautiful as if he or she carries filters of his or her own.
撩骚	liáo sāo	v. titillate+sex appeal. This Internet slang term refers to flirting with or hitting on someone.
阿姨粉	ā yí fěn	n. Auntie fans. This Internet slang term refers to female fans who are much older than their male idol. They tend to look at the idol as a cute little nephew.
亲妈粉	qīn mā fěn	n. Birth mother fans. This Internet slang term refers to female fans who are significantly older than their male idol or who are concerned about their idol’s well-being as if they were his mom.
阔以	kuò yǐ	v. Can, able to. This Internet slang term is a humorous phonetic deviation of 可以 [kě yǐ].
保持围笑	bǎo chí wéi xiào	<Expression> Maintain the smile [to mask one’s true feelings]. This expression is often used ironically to reveal that one repressed his or her true feelings under the pressure to maintain good relationships with others. 围笑 [wéi xiào] is a phonetic deviation of 微笑 [wēi xiào] “smile.”
开车	kāi chē	v. To drive a car. To talk dirty. The Internet slang term often describes harmless dirty jokes which probably would not be considered sexual harrassment.
旋转跳跃闭著眼	xuán zhuǎn tiào yuè bì zhe yǎn	<Expression> Spin, jump, with eyes closed. This expression comes from Jolin Tsai’s song “Dancing Diva.” Now it is often used humorously, e.g. 打你打到旋轉跳躍閉著眼 “I will hit you to the point where you spin and jump with your eyes closed.”
皮下	pí xià	n. <ACG> Under the skin. The author of the original post that you reshared or commented on. This Internet slang term stems from cosplay. The character you portray is called “over the skin” and you are called “under the skin.” Now it sometimes refers the official account of an entertainer on social media. Such accounts usually attract a large following and entail numerous reshares and comments.
划掉	huà diào	v. To cross out [a word]. This Internet slang term is often used humorously to correct yourself. You usually insert the Internet slang term between the original word and the correction. The original word shows your true intention while the correction is the result of your self-censorship. E.g. I admire my idol’s appearance, cross that out, talent.
推倒	tuī dǎo	v. To push someone down. To push someone onto the bed, floor, etc. and make love to him or her. This Internet slang term is often used by female Internet users to describe their love for a male idol.
初代	chū dài	adj. [Of someone or something] the first generation. This Internet slang term comes from Japanese.
开心到飞起	kāi xīn dào fēi qǐ	<Expression> [I’m] so happy that I could fly up. 
扶墙	fú qiáng	v. To support myself by holding onto the wall. This Internet slang term describes one’s shock at something that rendered himself or herself unsteady.
扶我上墙	fú wǒ shàng qiáng	<Expression> Help me get onto the wall. Help me become more visible in this online discussion by liking my post.
不扶墙就服你	bù fú qiáng jiù fú nǐ	<Expression> I don’t hold onto the wall; I admire you only. Since 扶 and 服 are homophones, this expression actually means I admire nobody but you. Sometimes it is satirical.
奔现	bēn xiàn	v. Run+reality. [Of people engaging in online dating] to meet in person to see if they like each other offline and want to become a couple.
膨胀	péng zhàng	adj. Big-headed. This Internet slang term is often used in self-mockery.
绿	lǜ	v. Green. To cheat on [one’s partner]. 
网绿	wǎng lǜ	v. Net+green. To be cheated on by one’s partner who has an affair with someone he or she met on the Internet.
今日份	jīn rì fèn	n. Today’s share [of something]. This Internet slang term is used as a cute alternative of “today’s…” or “…of the day.” It looks like a Japanese term but is actually not.
自洽	zì qià	adj. Self-consistent. This Internet slang term stems from Logic and is often used disapprovingly to describe one’s self-justification. The implication is often that the person is actually self-contradictory.
小奶狗	xiǎo nǎi gǒu	n. Little puppy. Toy boy. This Internet slang term refers to a young male that is the love interest of the opposite sex. It is often used to describe a cute young male idol. Some men protest that the term is sexist and degrades men.
白左	bái zuǒ	n./adj. White+leftist. This Internet slang term refers to leftists among the white people in Western countries or people holding similar views. As liberals, they typically sympathize with minority groups like queers and the low-income class. They are also concerned about the environment. The term is sometimes used with contempt because of the assumption that white leftists are often from the upper-middle class and have little experience with the groups they care about.
科恩嫂	kē ēn sǎo	n. Coen+sister-in-law. This Internet slang term is Chinese Internet users’ nickname for Frances McDormand because she is Joel Coen’s wife.
了解一下	liǎo jiě yí xià	<Expression> Get to know it. This expression is used to invite or request someone to learn more about something. A level of sarcasm is present. The humor involved is that this phrase is originally used widely among sales people in sentences like “Do you want to learn more about [a product]?”
村	cūn	The village. This Internet slang term is a nickname that some mainland Chinese students use to describe their universities in the rural or less cosmopolitan parts of the United States.
白起	bái qǐ	n. Bai Qi. One of the main male characters in Love and Producer, a mobile game about dating and relationships.  He is a SWAT officer. His supernatural power is wind field manipulation. This character became popular on China’s social media in December, 2017.
李泽言	lǐ zé yán	n. Li Zeyan, one of the main male characters in Love and Producer, a mobile game about dating and relationships. He is the CEO of Huarui in the financial services industry. His supernatural power is time manipulation. This character became popular on China’s social media in December, 2017.
土木三班陈同学	tǔ mù sān bān chén tóng xué	n. Student Chen from Class 3 of Civil Engineering. This Internet slang term originally comes from a vlogger’s pranks on male gamers who like trolling online. In the prank, vlogger Bei Lala uses a voice changer to pretend to be a Taiwanese girl and requests the target trolls to sing a song for him. After the guy falls for him, he reveals his gender.
陈独秀	chén dú xiù	n. Chen Duxiu. As an Internet slang term, it does not refer to Chen Duxiu, a Chinese revolutionary socialist, educator, philosopher, and author, who co-founded the Chinese Communist Party (with Li Dazhao) in 1921, serving from 1921 to 1927 as its first General Secretary.
诺兰黑	nuò lán hēi	n./adj. Nolan+black. Christopher Nolan detractors. This Internet slang term is used to describe people who dislike Christopher Nolan’s film style.
陪跑	péi pǎo	v. Accompany+run. To be nominated for an award that one is not to win. This Internet slang term often describes an actor or singer who never wins an award that he or she is constantly nominated for.
卖腐	mài fǔ	v. Sell+gayness. To present oneself or a piece of artwork in a way that appeals to an audience that adore homosexuality.
伐木累	fá mù leì	n. Wood+cutting+exhausting. Exhausting to cut wood. This Internet slang term means “family” because of the similar pronunciation.
舔屏向	tiǎn píng xiàng	adj. Lick+screen+direction. (Of a video or article) created to show one’s admiration for a celebrity’s physical appearance.
黑化	hēi huà	v. To become black. (Of one’s public image) to deteriorate as negative news surfaces. This Internet slang term also refers to a good guy turning into a bad guy in a TV show.
大表姐	dà biǎo jiě	n. The eldest cousin sister. This Internet slang term is an affectionate nickname for American actress Jennifer Lawrence and Chinese model Liu Wen.
甜茶	tián chá	n. Sweet tea. This Internet slang term is an affectionate nickname for actor Timothée Chalamet.
古风	gǔ fēng	n. Ancient style. This Internet slang term refers to literature, music, and art that portray or reflect the ancient Chinese style.
次元壁	cì yuán bì	n. Dimension+wall. The boundaries of different fields. This Internet slang term stemmed from 次元 [cì yuán]. It is often used humorously and admirably to describe the unexpected connections between disparate fields.
炸号	zhà hào	v. Explode+account. [Of a Weibo account] to be deactivated permanently for breaking the community regulations of Sina Weibo.
抓马	zhuā mǎ	adj. Dramatic. This Internet slang term sounds like the English word “drama.” It is often used to describe someone who habitually responds to situations in a melodramatic way.
活好不粘人	huó hǎo bù nián rén	<Expression> Good at [lovemaking] and not needy. This expression comes from the hookup culture in China.
三连	sān lián	n. A string of three [things]. This Internet slang term is used to describe a string of three things. For example, 素質三連 [sù zhì sān lián] means “a string of three curse words.”
尬黑	gà hēi	v. Embarrassed+vilify. To slander [a celebrity]. This Internet slang term means to suddenly spread rumors about a celebrity who rarely has scandals. The rumors are usually considered so outlandish that they are embarrassing.
白嫖饭	bái piáo fàn	n. Free+patronize+fan. Fans who patronize [a prostitute] for free. Here “prostitute” actually refers to an idol. This Internet slang term is a pejorative term for fans who are not willing to spend money or take part in social media campaigns for their idols. They only want to enjoy the idols’ works for free without making any contribution to the idols’ careers.
金主	jīn zhǔ	n. Gold+owner. Sponsor. This Internet slang term refers to the sponsor of a TV show or other projects.
爸爸	bà ba	n. Dad. This Internet slang term is a humorous nickname for rich men that you wished to have as your parents so that you could have their money. For example, Jack Ma is widely dubbed Daddy Jack Ma.
地主家的傻儿子	dì zhǔ jiā de shǎ ér zi	n. The landlord’s silly son. This Internet slang term is often used affectionately to describe one’s adorkable male idol.
请开始你的表演	qǐng kāi shǐ nǐ de biǎo yǎn	<Expression> Please start your performance. Originally overused in talent shows by the judges to invite the contestants to start their performances, this expression became popular around the end of 2016. Now it is often used humorously to allow someone to talk or brag.
天菜	tiān cài	n. Heavenly dish. When you say someone is your “heavenly dish,” you mean that person is exactly your type—a person of your dreams.
辣	là	Equivalent to 那 [nà] n. That. This Internet slang term mimics the Hunan accent for comic effect.
腻害	nì hài	n. Awesome. This Internet slang term mimics the Taiwanese Mandarin accent for comic effect.
亲测有效	qīn cè yǒu xiào	<Expression> [I’ve] tested it myself; [it’s] effective. This expression is often used when recommending something.
云吸猫	yún xī māo	n. Cloud+sniff+cat. Related to 吸貓 [xī māo] “raise a pet cat,” this Internet slang term refers to cat lovers’ enjoying the cat pictures posted online by other people.
土酷	tǔ kù	adj. Provincial+cool. This Internet slang term sounds like “too cool.” It refers to the style that accentuates the humor of mundane and unrefined clothes and objects.
挽尊	wǎn zūn	v. To save the dignity [for the original poster]. This Internet slang term is used when you leave the first comment on a post that hasn’t been replied for a long time. The purpose of leaving the comment is to cheer up the neglected original poster.
天仙攻	tiān xiān gōng	n. Fairy+attack. This Internet slang term is the fans’ nickname for actress Liu Yifei or Crystal Liu in 2015. Liu Yifei is famous for her role in The Return of the Condor Heroes as the beautiful and elegant Xiaolongnü. She also dubbed “Sister Fairy.” The new nickname was originally used to express the fans’ admiration for her dashing and slightly masculine look when dressed in suits.
主角光环	zhǔ jué guāng huán	n. Main character+halo. The halo of the main character. This Internet slang term refers to the pattern in games, films and TV shows that the main characters are unusually lucky in adversity.
狗头	gǒu tóu	n. Dog+head. This Internet slang term refers to the emoticons featuring the head of a dog. The emoticon is often used at the end of a sentence to signify that the remark is ironic or sarcastic.
空降	kōng jiàng	v. To descend from the sky. This Internet slang term is often used to describe someone or something that suddenly appears out of the blue. 
世界那么大，我想去看看	shì jiè nà me dà, wǒ xiǎng qù kàn kàn	<Expression> The world is so big; I want to go take a look at it. This expression became famous because it was the resignation letter of Gu Shaoqiang, a teacher from Sichuan, in 2015. Her resignation letter caused a buzz on social media because many people resonated with her yearning for traveling.
斜杠青年	xié gàng qīng nián	n. Slash youth. Young people with multiple careers or identities. [Self-proclaimed] versatile young people. This Internet slang term is often used in self description.
每一个抖腿爱好者的心里. 大概都住著一台缝纫机	měi gè dǒu tuǐ ài hào zhě de xīn lǐ, dà gài dōu zhù zhe yì tái féng rèn jī	<Expression> In the heart of everyone that likes to shake their legs [while sitting] lives a sewing machine. This expression is often used to tease or criticize people with jittery legs while sitting.
诗和远方	shī hé yuǎn fāng	<Expression> Poetry and the far-off land. This expression comes from the quote from Zhang Kequn, musician Gao Xiaosong’s mother, “Life is more than resigning to the mundane affairs in life; it is also about poetry and the far-off land.” This quote became popular among Chinese young people under the pressure of high housing prices in big cities. It is often cited to inspire people to stop fretting over not amassing enough material wealth and instead find a place of inner peace through art and travel.
双标	shuāng biāo	n./adj. Double standard. This Internet slang term is short for 雙重標準 [shuāng chóng biāo zhǔn].
暴露年龄	bào lù nián líng	v. To give away one’s age. This Internet slang term is often used when mentioning something that happened a long time ago and pokes fun at the speaker’s age. It is often used in self-mockery.
塑料花姐妹情	sù liào huā jiě meì qíng	n. Plastic flowers+sisterhood. Vulnerable or insincere female friendship. Fair-weather friendship. This Internet slang term refers to women who appear to be best friends forever but actually scheme against each other in private.
背锅侠	bēi guō xiá	n. Carry+wok+knight. Scapegoat. This Internet slang term derives from 背鍋 [bēi guō].
过气网红	guò qì wǎng hóng	n. Has-been+Internet celebrity. A former Internet celebrity who is no longer popular.
宝妈	bǎo mā	n. Baby+mom. This Internet refers to mothers of young children.
送分题	sòng fēn tí	n. Send+point+problem. Very easy question [on an exam]. This Internet slang term refers to question to which you must know the answer.
送命题	sòng mìng tí	n. Send+life+problem. Dangerous question that could get you killed if you didn’t answer it correctly. This Internet slang term refers to a tricky question raised by someone who expects you to answer it exactly the way he or she wants.
不可描述之事	bù kě miáo shù zhī shì	n. The indescribable thing. Sex.
口嫌体正直	kǒu xián tǐ zhèng zhí	<Expression> Mouth+avoid+body+honest. They say they don’t want it, but their body language says otherwise. Short for the Japanese expression “口が嫌だと言っても体は正直なものだ,” this expression pokes fun at people who deny their true feelings about something. It is often used in a romantic or sexual context, referring to someone who claimed to dislike a date or crush, but their bodily reactions suggest otherwise.
嘴上说不要，身体却很诚实	zuǐ shàng shuō bú yào, shēn tǐ què hěn zhèng zhí	<Expression> Another translation of 口嫌體正直 [kǒu xián tǐ zhèng zhí]: Orally [they] say they don’t want it, but [their] bodies are very honest. 
逃离北上广	táo lí běi shàng guǎng	<Expression> To flee from Beijing, Shanghai, and Guangzhou. This expression describe the phenomenon of white-collar workers quitting their jobs in China’s metropolises, especially Beijing, Shanghai, and Guangzhou, and choose to work and live in second- and third-tier cities instead. They give up the life in first-tier cities often because they can’t afford the apartment prices or bear the air pollution in those metropolises.
鲈鱼	lú yú	n. Bass, any of various North American freshwater fish with lean flesh (especially of the genus Micropterus). This Internet slang term is a derogatory nickname for Chinese talk show host Chen Luyu because of similar pronunciation. Sexism is evident in the use of this term.
土嗨	tǔ hāi	adj. rustic+excited. This Internet slang term was originally used to describe an electronic dance music dilettante who mistakes DJ for electronic dance music. Now it is commonly used to describe Chinese electronic dance music that sound amateurish by international standards. The contempt for unsophisticated composers is quite obvious, judged from the use of the character 土 [tǔ] “uncouth, unsophisticated, rural.”
脑子瓦特	nǎo zi wǎ tè	<Expression> Brain+Watt. The brain is damaged. 瓦特 [wǎ tè] means “damaged” in the Shanghai dialect. This expression is used to lambaste someone. The meaning is similar to “[someone] is going nuts” or “[someone] is stupid.”
装逼犯	zhuāng bī fàn	n. Boast+criminal. Blowhard, barggart, poseur.
地域炮	dì yù pào	n./v. Region+cannon. To berate people from a region on the Internet.
躁起来	zào qǐ lai	<Expression> Get excited. Quoted from the song “Miss Dong” by Song Dongye, this expression is used to encourage people to become excited about something.
好看的皮囊千篇一律，有趣的灵魂万里挑一	hǎo kàn de pí náng qiān piān yí lǜ, yǒu qù de líng hún wàn lǐ tiāo yī	<Expression> Good-looking letter bags all look alike, but interesting souls are one in ten thousand. Good-looking people are similar, but interesting souls are hard to find. This expression is commonly used among fans to describe their idols.
炮总	pào zǒng	n. Cannon+Boss. This Internet slang term is a nickname for British actor Paul Bettany 炮 [pào] sounds like “Paul.”
老白	lǎo bái	n. Old+White. This Internet slang term is a nickname for American actor Bryan Cranston, because 白 [bái] “White” is his last name on Breaking Bad. He gained popularity in China because of his performance on Breaking Bad.
可以说是	kě yǐ shuō shì	<Expression> It can be said that [very adj. ].  You can say it’s [very adj.]This expression became popular in 2017 to express one’s opinion about something or someone.
网瘾少女	wǎng yǐn shào nǚ	Internet addiction+teenage girl. Teenage girl with an addiction to the Internet. This Internet slang term is often used to describe young women who spend way too much time on the Internet, usually because they like watching TV shows or playing mobile games.
我下面给你吃	wǒ xià miàn gěi nǐ chī	<Expression> I will cook some noodles for you to eat. The expression was originally a classic line in Hong Kong TV shows, but in Simplified Chinese, 下面 [xià miàn] “below, down there” and 下麵 [xià miàn] “cook noodles” are both written as the former word, so mainland Internet users have developed a new interpretation of the line: I will let you eat me down there.
脏辫	zāng biàn	n. Dirty+braids. Deadlocks.
床上运动	chuáng shàng yùn dòng	n. On the bed+exercise. Exercise in bed. This Internet slang term is a euphemism for sexual intercourse.
蠢哭	chǔn kū	v. Foolish+cry. (Of behavior) so asinine that it brought me to tears. This Internet slang term is a common quibble about something and someone that does not live up to one’s expectation. Hyperbole is involved in this usage.
网感	wǎng gǎn	n. Web+sense. The level of interactivity with the viewers on the Internet. This Internet slang term is often used as a standard for evaluating TV shows. A TV program with a good web sense has a large fan base on the Internet, satisfies Internet users’ aesthetic needs, and sparks heated discussions on the Internet.
杀马特	shā mǎ tè	adj./n. Kill+horse+special. Smart. The scene people. This Internet slang term mimics the pronunciation of the English word “smart,” but it is used to tease the teenagers and young adults who prefer a fashion style that emphasizes androgyny and bright colors. These young people usually migrated from rural areas to urban areas. They lack higher education and take on low-income jobs in cities. Their fashion choices reflect their need for attention and sense of alienation in the process of urbanization.
洗剪吹	xǐ jiǎn chuīand	n. Wash+cut+blow. This Internet slang term refers to the scene people’s hairstyle as well the scene people as a group.
大吉大利，今晚吃鸡	dà jí dà lì, jīn wǎn chī jī	<Expression> Great luck, great profit; eat chicken tonight. Winner winner, chicken dinner. This expression is from the popular mobile game “Player Unknown’s Battlegrounds.” Now the second part of the slogan has become another way of saying “I have a nice plan for tonight.”
高级脸	gāo jí liǎn	n. High-end face. This Internet slang term refers to the latest beauty trend among Chinese women. A Chinese woman who has a high-end face usually looks a little masculine. She often has the single eyelids, relatively small, long, and wide-set eyes, slightly higher cheekbones, thicker lips, and a chiseled jawline. The above facial features convey an air of aloofness and even frigidity. This trend differs from the traditional standard for female beauty which accentuates femininity and childlike innocence. The Chinese models popular in the West such as Lv Yan, Du Juan, and Liu Wen may have contributed to popularity of this Internet slang term.
男频	nán pín	n. Male+channel. Internet novels that target male readers. Such novels are usually about wars and picking up women.
女频	nǚ pín	n. Female+channel. Internet novels that target female readers. Such novels are usually about love triangles and homosexual love.
补档	bǔ dǎng	v. Repair+document. To re-upload a shared file to the Internet after a previously created link expired. This Internet slang term is often used in the context of sharing movies or videos on the Internet.
第X弹	dì n dàn	n. No. X shot. Derived from the Japanese culture, this Internet slang term is used to introduce a new piece of work (article, illustration, video) in a series.
果粉	guǒ fěn	n. Fruit+fan. Apple fan. This Internet slang term refers to a fan of Apple products.
备胎	bèi tāi	n. Spare tire. Back burner. This Internet slang term refers to  a person to whom one is not presently committed, and with whom one maintains some degree of communication, in order to keep or establish the possibility of future romantic and/or sexual involvement.
周冬雨式凝视	zhōu dōng yǔ shì níng shì	<Expression> Zhou Dongyu’s gaze. This expression teases actress Zhou Dongyu’s relatively large distance between the eyes.
绿光	lǜ guāng	n. Green light. This Internet slang terms comes from Stephanie Sun’s song “Green Light” but is now used to mock people whom were cheated on by their partners.
头顶一片草原	tóu dǐng yí piàn cǎo yuán	<Expression> Carry a tract of grassland on one’s head. This expression is used to describe people whose partners cheat on them multiple times..
岛国	dǎo guó	n. Island nation. This Internet slang term refers to Japan.
科学上网	kē xué shàng wǎng	<Expression> Surf the web scientifically. This expression is a euphemism for accessing the blocked non-Chinese websites using VPNs. A synonym is 翻墻 [fān qiáng].
脑回路清奇	nǎo huí lù qīng qí	<Expression> Brain+loops+refreshing+magical. The unique brain circuits. This expression praises people who think creatively or differently from the majority of the people. Sometimes the expression is used sarcastically.
翻红	fān hóng	v. Flip+red. To become popular again. This Internet slang term is often used to describe the public’s renewed interest in celebrity has-beens.
走肾	zǒu shèn	adj. Walk+kidney. Going through the kidney. Adapted from 走心 [zǒu xīn], this Internet slang term refers to something that causes sexual arousal.
佛系追星	fó xì zhuì xīng	n. Buddhist+sect+chase+stars. The Buddhist fandom. This Internet slang term refers to supporting a celebrity in a calm and peaceful way. A Buddhist fan does not engage in online battles against the fans of other celebrities. He or she is not too emotionally invested in the idol either.
佛系青年	fó xì qīng nián	n. Buddhist+sect+youth. The Buddhist youth. This Internet slang term is often used to describe the Post-’90 who are less ambitious in life.
佛系玩家	fó xì wán jiā	n. Buddhist+sect+gamer. The Buddhist gamer. This Internet slang term refers to gamers who don’t care about their game results.
佛系分手	fó xì fēn shǒu	n. Buddhist+sect+breakup. The Buddhist breakup. This Internet term refers to the painless and peaceful breakup. The couple do not experience nervous breakdowns or hostile retribution.
佛系	fó xì	n. Buddhist+sect. The Buddhist style. This Internet slang term describes the detached and often passive attitude towards life. Sometimes it is used positively to describe a placid demeanor like a Buddhist sage.
社会主义巨婴	shè huì zhǔ yì jù yīng	n. Socialist+gigantic+baby. The gigantic socialist baby. This Internet slang term pokes fun at Chinese adults who are not well-differentiated according the Murray Bowen’s Family Systems Theory. They often submit to authority figures. They are narcissistic, controlling, insecure, anxious, vulnerable, irritable, and depressed. It is possibly the Chinese equivalent of “Generation Snowflake.”
孔雀	kǒng què	n. Peacock. This Internet slang term is Chinese fans’ nickname for the American actor Matt Bomer.
遇见更好的自己	yù jiàn gèng hǎo de zì jǐ	Meet the better self. This expression is a popular slogan to encourage self-improvement.
实锤	qiú chuí	n. Solid+hammer. Irrefutable evidence. This Internet slang term is often used negatively to describe the confirmed scandal.
求锤得锤	qiú chuí dé chuí	. Beg+hammer+get+hammer. This expression means “if you ask for a hammer [evidence], you will get a hammer [evidence].” It is often used before revealing the irrefutable evidence for a rumor.
旁友	páng yǒu	n. Beside+friend. Friend. This Internet slang term is a phonetic deviation of 朋友 [péng yǒu] “friend” and 胖友 [pàng yǒu] “fat friend.”
胖友	pàng yǒu	n. Fat+friend. Friend. This Internet slang term is a phonetic deviation of 朋友 [péng yǒu] “friend.”
撕	sī	v. To tear [the vagina]. Derived from 撕逼 [sī bī] “to have verbal fights online,” This Internet slang term means “to inveigh against [someone].”
米叔	mǐ shū	n. Rice+Uncle. Uncle Mi. This Internet slang term is an affectionate nickname for Indian artist Aamir Khan.
寡姐	guǎ jiě	n. Widow+Sister. Sister [Black] Widow. This Internet slang term is a nickname for American actress Scarlett Johansson.
土肥圆	tǔ féi yuán	adj. Unsophisticated+fat+round. This derogatory Internet slang term is often used in body shaming and self-mockery.
乱入	luàn rù	v. Randon+enter. Derived from the Japanese phrase  “乱入 らんにゅう”, this Internet slang term refers to an unexpected appearance that is often hilarious. It is often used to describe an interruption in a presentation or conversation.
栗子	lì zi	n. Chestnut. Example. This Internet slang term is a funny way of saying 例子 [lì zi] “example” because they are homophones.
斗图	dòu tú	v. Compete+pictures. To bicker or joke using pictures. This Internet slang term refers to having a playful pictorial conversation online.
母上大人	mǔ shàng dà rén	n. Mother+Her Excellency. Derived from the Japanese honorific title ” haha-ue” (ははうえ), this Internet slang term is used humorously to address one’s mother.
父上大人	fù shàng dà rén	n. Father+His Majesty. Derived from the Japanese honorific title “chichi-ue”  (ちちうえ) ,  this Internet slang term is used humorously to address one’s father.
做一个精致的猪猪女孩	zuǒ yí gè jīng zhì de zhū zhū nǚ hái	<Expression> Be a refined piggy girl. This expression scoffs at fangirls who like staying in and binge-watching videos featuring their idols. “Piggy” refers to their physical appearance and lifestyle. Due to the sedentary lifestyle, they are often believed to be overweight. The stereotype is undoubtedly pejorative and hurtful.
卵巢彩票	luǎn cháo cǎi piào	<Expression> The ovarian lottery. This expression is quoted from Warren Buffet who attributed his success to winning the “ovarian lottery.” In China, this Internet slang term is used to lament one’s misfortune of not being born with a silver spoon in his or her mouth.
塘主	táng zhǔ	n. [Fish] pond owner. This Internet slang term is a pejorative nickname for Zhang Han, because his famous line in the TV show Boss & Me:  “I want to let everyone know: This fish pond, is now under your management by contract.” People jeer his role for making a ludicrous confession of love by mentioning a fish pond. The nickname implies discrimination against country people and contempt for Zhang Han.
推特	tuī tè	n. Push+special. This Internet slang term is a nickname for Twitter.
道友	dào yǒu	n. Fellow Taoist priests. This Internet slang term is used humorously to describe people who share your hobbies or values. It is also a euphemism for drug users, because of the stereotype that they are so pale and gaunt that they look like Taoist priests who are believed to become immortals.
我+可能+ v.+的是假+n.	wǒ kě néng v. de shì jiǎ n.	<Expression> I+probably+v+a fake+n.. This sentence structure is often used to quip about something unexpected.
油腻	yóu nì	adj. Oily, greasy. This Internet slang term was made popular by Chinese writer Feng Tang in his article “How to Avoid Becoming a Greasy, Creepy Middle-Aged Man.” The article reminds middle-aged Chinese men not to: get fat, stop learning, stay still, talk about sex in public, be overtly nostalgic, lecture youngsters, cause trouble for others, stop shopping, ignore personal hygiene and grooming, or despise healthy life habits. In that sense, “greasy” describes a person who is indolent, narcissistic, annoying, misogynistic, and/or lewd.
粉丝行为，偶像买单	fěn sī xíng wéi, ǒu xiàng mǎi dān	<Expression> Fans’ behavior+the idol pays the bill. This expression means “the idol pays the price for the fans’ inappropriate behavior.” This caveat reminds the fans to conduct themselves online and offline so their idol’s reputation won’t be tarnished.
开黑	kāi hēi	v. Open+black. <Gaming Terminology> To have audio chats or even face-to-face communication with the other players to have an edge on the opponents in a computer game. The behavior may enhance cooperation and increase the possibility of cheating as well.
目测要火	mù cè yào huǒ	<Expression> Visual estimate+will go viral. By visual estimate, this will go viral. This expression is often used humorously to discuss how likely something will cause a stir on the Internet.
立flag	lì flag	v. To plant a flag. <Gaming terminology> (Of a code segment) to foreshadow the development of an event. As an Internet slang term. it means to make a statement only to find out it is wrong or to make a promise only to break it later. It also means to set a goal that may or may not be reached.
白毛女	bái máo nǚ	n. The white haired girl. This Internet slang term is a humorous moniker for Starbucks. The White Haired Girl is one of the earliest PRC films.
开封菜	kāi fēng cài	n. The Kaifeng cuisine. This Internet slang term is a humorous moniker for KFC, because they share the acronym.
金拱门	jīn gǒng mén	n. The golden arched door. This Internet slang term is the new official Chinese name of McDonald’s.
大清已亡	dà qīng yǐ wáng	<Expression> The Qing dynasty has already perished. This expression is often used to criticize outmoded ways of thinking and behaving, such as authoritarianism and misogyny. 
这盛世如你所愿	zhè shèng shì rú nǐ suǒ yuàn	<Expression> This golden age, as you wished for. This expression is often used sarcastically to express discontent with government misconduct.
吊打	diào dǎ	v. To hang someone up and beat him or her. To lash out on someone.
劳模姐	láo mó jiě	n. Model worker+ sister. Sister model worker. This Internet slang term is an affectionate nickname for Jessica Chastain to show the fans’ admiration for her productivity and the quality of her works.
母胎SOLO	mǔ tāi SOLO	adj. Womb+Solo [performance]. (Of a person) single since birth. Derived from the Korean phrase “모태솔로”, this Internet slang term pokes fun at people who have never been in a relationship so that their lives are like solo performances. It is the latest alternative of 單身狗 [dān shēn gǒu] “single dog.”
嗯嗯	en en	interj. An enthusiastic way of showing confirmation. 
我能怎么办? 我也很绝望啊!	wǒ néng zěn me bàn? wǒ yě hěn jué wàng a	<Expression> What can I do? I am also in despair. This expression is used humorously to express how shocked and helpless one feels. It is often used humorously.
熊本熊	xióng běn xióng	n. Kumamon, a mascot created by the government of Kumamoto Prefecture, Japan in 2010 for a campaign to draw tourists to the region. A number of emojis have been circulated on China’s Internet based on the image of Kumamon.
吸霾	xī mái	v. Sniff+smog. To have to sniff smog constantly because of air pollution. This Internet slang term mimics the word 吸煙 [xī yān] “smoking.”
吸猫	xī māo	v. Sniff+cat. (Of a cat owner) to sniff the cat. This Internet slang term is often used by cat owners to describe their love for cats. They can’t help hugging and playing with the cats as soon as they see them, and they even like sniffing the smell of cats. The term mimics the word 吸煙 [xī yān] “smoking.”
抖S	dǒu s	adj./n. Shake+S. Seriously sadistic. A seriously sadistic person. Derived from the Japanese wordドS in the ACG subculture, this Internet slang term refers to the tendency to derive pleasure, especially sexual gratification, from inflicting pain, suffering, or humiliation on others.
抖M	dǒu m	adj./n. Shake+M. Seriously masochistic. A seriously masochistic person. Derived from the Japanese wordドM in the ACG subculture, this Internet slang term refers to the tendency to derive sexual gratification from one’s own pain or humiliation.
强排	qiáng pái	v. Strongly+stand [behind you]. To strongly agree with [you]. To strongly support [you].
爱无能	ài wú néng	n. Inability to love. This Internet slang term refers to some people’s inability to enter a relationship. The reasons vary. Some people are traumatized by past relationships, some are too narcissistic to love others, some are afraid of commitment, some repress their feelings too much…Some people attribute their singledom to their inability to love.
解锁技能	jiě suǒ jì néng	v. Unlock+skill. To pick up a new skill.
黑花	hēi huā	n. Black+flower. Hey Wow. This Internet slang term is the name of Wallace Chung’s stuffed panda doll aka his “daughter.” Wallace Chung later developed spin-offs like caps, shoes, dolls, backpacks, etc. based on the image of Hey Wow.
黑草	hēi cǎo	n. Black+grass. This Internet slang term refers to Wallace Chung’s male fans.
带节奏	dài jié zòu	v. Lead+rhythm. <Gaming terminology> To instigate a fight. This Internet slang term is originally used to describe a gamer who determines the strategies for the whole team in a group video or computer game. Now it is used to describe an Internet user who misleads others with wrong information or offensive language in online discussions and instigates verbal fights among groups holding opposing views.
照骗	zhào piàn	n. Photo+deception. [Inaccurate] photo. This Internet slang term refers to a photo that does not truthfully reflect a person’s appearance. It is usually over-photoshopped. This term and 照片 [zhào piàn/pian] are homophones.
猪精女孩	zhū jīng nǚ hái	n. <Fandom Terminology> Pig spirit+girl. This sexist Internet slang term originally referred to female fans who eat a lot like pigs and feel so good about themselves and therefore are annoying to others. Now it also refers to fat, ugly women with a histrionic personality. Sometimes it is used for self-mockery.
逆天改命	nì tiān gǎi mìng	<Expression> Defy heaven and change one’s destiny. This expression comes from the TV series Fighter of the Destiny. The protagonist Chen Changsheng is plagued with an incurable illness, fated not to live past the age of twenty. He is therefore determined to find the magic stone that will change his fate.
割	gē	v. Cut. This Internet slang term is widely used on The Encyclopedia of Awkwardness, a Chinese humor website, to indicate the transition from background information to the main part of the joke. 
抖机灵	dǒu jī ling	<Expression> Shake+cleverness. Make a wisecrack. This expression is used slightly negatively to describe people who quip to show off how witty they are.
断眉	duàn méi	n. Broken eyebrow. This Internet slang term is an affectionate nickname for Charlie Puth.
囧雪诺	jiǒng xuě nuò	n. Awkward+Snow. This Internet slang term is an affectionate nickname for Jon Snow, a character in Game of Thrones, because of 囧 [jiǒng] sounds like “Jon.”
妈卖批	mā mài pī	<Expletive>This is a sexist expletive phrase from the Chongqing dialect. It means “Your mom is a prostitute.” The alternatives are mmp [pinyin acronym] and X賣批 [mā mài pī].
娘炮	niáng pào	n. & adj. An effeminate man. Dander. This Internet slang term is a sexist term to describe metrosexuals and men with feminine qualities.
群嘲	qún cháo	v. Group+mock. (Of a group of people) to laugh at someone.
E神	E shén	n. E+deity. A nickname for Eason Chan, a Hong Kong singer, because it sounds like “Eason.”
神经病啊	shén jīng bìng a	<Expression> [One of Xue Zhiqian’s pet phrases] Neurotic! This expression means “Are you crazy?” or “Are you nuts?”. 
我不要面子的啊	wǒ bú yào miàn zi de a	[One of Xue Zhiqian’s pet phrases] [You think] I don’t want face?! This expression means “You think I don’t want a good reputation?”. 
整段垮掉	zhěng duàn kuǎ diào	[One of Xue Zhiqian’s pet phrases] The whole segment collapses. This expression means “Epic fail!”
高仿号	gāo fǎng hào	n. High+imitate+account. Weibo accounts that pretend to be owned by celebrities in order to attract followers. Such accounts often steal celebrities’ pictures and imitate their writing styles. Oversharing is another common weakness among those fake accounts. When an celebrity posts weibos too often or displays qualities that are little known to the public on Weibo, their fans will also quip that those celebrities’ weibo accounts are fakes.
霸气侧漏	bà qì cè lòu	<Expression> Swag+side leakage [as of sanitary towels]. This expression humorously describes a person’s excessive domineering presence or pompous display of expertise or fortune that makes people around him or her slightly uncomfortable.
犀利	xī lì	adj. Incisive. This Internet slang term is often used to describe a piercing glance, a sharp-witted person, or an accurate and cutting remark.
犀利哥	xī lì gē	n. Brother Incisive. A homeless man called Cheng Guorong who was dubbed “Brother Incisive” on China’s Internet in 2010 for his piercing gaze and outlandish outfits.
放飞自我	fàng fēi zì wǒ	<Expression> Allow oneself to take off. This Internet slang term is used humorously to describe someone who behaves with careless abandon. It can be either positive or negative.
喜大普奔	xǐ dà pǔ bēn	<Expression> [Of news, etc. ] so thrilling that everyone is rejoicing and spreading the word. This expression is an acronym combining the first characters of four idioms:
喜闻乐见	xǐ wén lè jiàn	Love to see and hear. 
大快人心	dà kuài rén xīn	[usually of the punishment of an evil-doer] Most gratifying to the people. 
普天同庆	pǔ tiān tóng qìng	The whole world or nation rejoices. 
奔走相告	bēn zǒu xiāng gào	Run around spreading the news. 
围笑	wéi xiào	v. & n. Surround+smile. Smile. This Internet slang term, an alternative of 微笑 [wēi xiào] “smile” because they sound alike, mimics the Taiwanese Mandarin accent.
戏精	xì jīng	n. Drama+spirit. An attention-seeking person with a histrionic display of emotions and/or opinions. This Internet slang term is sometimes used humorously.
颜即正义	yán jì zhèng yì	<Expression> Appearance is justice. This expression is used to humorously defend one’s preference for nice-looking people, to the dismay of plain-looking people and those who are against body shaming. The expression is sometimes used sarcastically.
皮皮虾，我们走	pí pí xiā, wǒ men zǒu	<Expression> Mantis shrimp, let’s go. This expression is used humorously to show discontent and threaten to exit the online conversation.
锁场	suǒ chǎng	v. To lock the auditorium. This Internet slang term describes the phenomenon that ardent fans purchase one to two movie tickets for each movie auditorium where their idols’ movie is scheduled to be screened, in order to give theatrical exhibitors the false impression that their idols’ movies are very popular so that the movie would be screened at more movie theaters.
把我炸出来	bǎ wǒ zhà chū lái	<Expression> Bomb me out. This expression is often used in sentences like “this question/word/picture bombed me out” meaning that the question/word/picture evokes one’s desire to speak up on the Internet.
情怀	qíng huái	n. Sentiment. This Internet slang term is used to describe one’s passion about something bigger than oneself. Sometimes it is used sarcastically.
不忘初心	bú wàng chū xīn	<Expression> Do not forget the original aspiration. This expression is used to remind oneself or to commend others for sticking to one’s beliefs or dreams.
丧	sàng	adj./v. To vegetate due to deep frustration. This Internet slang became popular in 2016 following Internet memes like 葛優癱 [gě yōu tān] “the Ge You slouch”, 廢柴 [fèi chái] “trashy firewood, douchebags”, 生無所戀 [shēng wú suǒ liàn] “There is nothing in life to long for”, Pepe the Frog, etc. Analysts attribute the popularity of this Internet slang term to the post-90s‘ [people born between 1990 and 1999] pessimism about social mobility amidst a host of social problems such as air pollution, the skyrocketing housing prices, and workplace stress.
丧文化	sàng wén huà	n. The subculture of vegetating. This Internet slang term refers to a collection of beliefs and behaviors that enable the working-class youth in China to express their pessimism about life and their future.
小确丧	xiǎo què sàng	n. Little+definite+frustration. A sarcastic antonym of 小确幸 [xiǎo què xìng] “Little definite happiness,” this Internet slang term was originally the title of an Internet pop song. Now it is used to describe the working-class youth’s certainty about daily nuisances and the drudgery of work.
打Call	dǎ call	v. To root for [someone or something]. This Internet slang term originated from Wotagei or otagei, which refers to a type of dancing and cheering gestures performed by wota, fans of Japanese idol singers (and thus seen as Akiba-kei), involving jumping, clapping, arm-waving and chanting slogans.
女司机	nǚ sī jī	n. Female driver. This Internet slang term indicates the prejudice that female drivers have poor driving skills.
马路杀手	mǎ lù shā shǒu	n. Road+killer. This Internet slang term refers to poor drivers. Female drivers are often unfairly labeled as road killers.
扎心了，老铁	zhā xīn le, lǎo tiě	<Expression> It smarts, buddy. This expression is adapted from the Northeastern Chinese dialect. 紮心 [zhā xīn] means “pierce my heart” while 老鐵 [lǎo tiě] is a slang term for “good friend.” This expression became popular at the beginning of 2017 and is often used humorously.
手欠	shǒu qiàn	adj. Hand+lacking. This Internet slang term is used to blame oneself or others for clicking on a link that is regrettable, such as seeing or buying something regrettable online.
尬聊	gà liáo	v. Embarrassment+chat. To have an awkward and hilarious conversation usually because the people don’t see eye to eye.
小仙女	xiǎo xiān nǚ	n. Little+nymph. 小姐姐 [xiǎo jiě jiě] n. Little+older sister. Both Internet slang terms are used to address or describe girls and young women. These two newly-coined terms have probably rendered 美眉/MM [měi méi] “pretty girl” obsolete…[允悲] 
还有这种操作	hái yǒu zhè zhǒng cāo zuò	<Gaming terminology> Expression. This gambit exists?! An equivalent of “Didn’t see this coming.” This expression recently replaced 黑人問號 [hēi rén wèn hào] to express one’s confusion, amazement, or shock.
黑人问号	hēi rén wèn hào	n. Black person+question marks. This Internet slang term derives from pictures of Nicholas Aaron “Nick” Young, an NBA player for the Los Angeles Lakers, with question marks added. This meme is used when you are perplexed, shocked, or speechless. 
站队	zhàn duì	v. Stand+queue. To take sides.
砸简历	zá jiǎn lì	Smash+resumes. Expression. Smash [us with your] resumes. This Internet slang term is used by employers on social media to invite job applicants to email resumes to them.
推送	tuī sòng	v. Push+send. Recommend+send [articles]. This Internet slang term is widely by organizations on Weibo and WeChat to notify the subscribers or followers of the latest articles.
绿绿	lǜ lǜ	n. Green green. This Internet slang term refers to the Muslims, because green is an important color in the Muslim world.
翻墙	fān qiáng	v. To climb over a wall. This Internet slang term means to climb over the Great Firewall of China, a censorship and surveillance project that blocks potentially unfavorable incoming data from foreign countries. The purpose is to access blocked overseas websites.
墙内	qiáng nèi	adj. On this side of the wall. This Internet slang term refers to the Internet environment affected by the Great Firewall.
墙外	qiáng wài	adj. On the other side of the wall. This Internet slang term refers to the Internet environment unaffected by the Great Firewall.
虐腹	nüè fù	v. Abuse+abdomen. To do intense ab workouts, especially to develop a visible Adonis belt or a V-shaped core.
爱笑的女孩运气不会太差	ài xiào de nǚ hái yùn qi bú huì tài chà	: Girls who like laughing usually don’t have bad luck. 
撒狗粮	sǎ gǒu liáng	v. To pour dog food. (Of a couple) to show affection toward each other online or offline, which may trigger envy, jealousy, and self-pity among single people.
回忆杀	huí yì shā	n. Memory+kill. In the Japanese comic book series Naruto, killing scenes tend to begin with flashbacks of incidents from the past. As an Internet slang term, it refers to the emotional reminiscing about the past.
摸头杀	mō tóu shā	n. Gently caress and stroke the head+kill. Originating from the Japanese manga trope of a guy caressing a gloomy girl’s head to comfort her, this Internet slang term is now regarded as a favorable flirting or titillating technique (effective only when used by one’s love interest or idol).
少女心	shào nǚ xīn	n. Teen girl’s heart. A person with a teen girl’s heart is girly, dreamy, sensitive, vigorous, and sentimental. This Internet slang term is often used positively to describe a person who unapologetically adores girly toys and longs for romantic chance encounters with male celebrities like a moony teenage fangirl. This term sometimes runs the risk of perpetuating gender stereotypes about girls and teenagers.
三岁	sān suì	n. Three-year-old. This Internet slang term is often coupled with someone’s last name. It became popular first when used to describe Hong Kong actor Francis Ng aka Wu Zhenyu when he appeared with his son on the reality TV show Where Are We Going, Dad in 2014. Netizens dubbed him “Wu Three-Year-Old”, amused by his mischievous and childlike personality on the show as well as on Weibo. The meme has been widely used to describe many beloved celebrities.
劳资 (=老子)	láo zī (=lǎo zi)	n. Labor+capital. I.. This Internet slang term means 老子 [lǎo zi] “I (used jocularly and arrogantly)” because they sound similar.
手撕鬼子	shǒu sī guǐ zi	n. To lacerate the devils [a term of abuse for foreign invaders, particularly Japanese invaders] by hand. This Internet slang term pokes fun at the 2011 Chinese TV drama The Curious Maestros against Japanese Invasion in which a Kungfu master tears up the Japanese invaders in the War of Resistance against Japan (1937-1945). The plot was berated online and by state-run newspapers like People’s Daily for distorting history.
抗日神剧	kàng rì shén jù	n. Epic dramas of the War of Resistance against Japan. This Internet slang term mocks TV dramas that blend history with fantasy to over-glorify the Chinese army in the War of Resistance against Japan. Such dramas are widely criticized by both the media and Internet users for distorting history.
秒回	miǎo huí	v. To reply within a second. To reply promptly.
心大	xīn dà	adj. Heart+big. This Internet slang term describes people who are so careless that they may put themselves or others in danger. It also describes people who are less susceptible to criticism or personal attacks because they don’t give a damn.
脸大	liǎn dà	adj. Big-faced. This Internet slang term is used to criticize someone for being brazen or narcissistic.
自黑	zì hēi	v. To make self-effacing comments. It could be a form of humble brag, but it could also serve the sole purpose of amusing others.
你的良心不会痛吗	nǐ de liáng xīn bú huì tòng ma	<Expression> Doesn’t your conscience feel pain? This expression originated from an Internet joke about the bromance between Tang poets Du Fu and Li Bai. The joke claims that Du Fu wrote 12 poems for or about Li Bai, but Li Bai reciprocated with only one poem. The joke writer felt sorry for the “mistreated” Du Fu and questioned Li Bai if he felt guilty for his “cruelty” with the aforementioned expression. Regardless of its original interrogative tone, this expression is now often used humorously to tease someone.
流量小生	liú liàng xiǎo shēng	n. Traffic+young man. 
流量小花	liú liàng xiǎo huā	n. Traffic+little flower. 
盆栽精	pén zāi jīng	n. Bonsai+elf/spirit. This Internet slang term is a loving nickname for The Weeknd due to his dreadlocks resembling a bonsai tree.
葛优瘫	gě yōu tān	n. Ge You slouch. This Internet slang term referring to the sitting posture of actor Ge You’s role in the classic sitcom I Love My Family (1993-1994). It became popular in summer 2016 to describe how people relax in the sweltering heat.
别说话，吻我	bié shuō huà, wěn wǒ	Expression. Don’t talk, kiss me. This expression was a caption of pouting selfies flaunted by a successful gamer. It also appeared in the lyrics of an internet pop song. Now it is used for joking or playing cute.
厉害了word…	lì hài le word…	<Expression> An alternative way of 厲害了我的… [lì hài le wǒ de…]. This expression substitutes 我的… [wǒ de…] “my…”with “word”… because of similar pronunciations.
点赞之交	diǎn zàn zhī jiāo	n. Click+like+acquaintances. People who maintain a minimal connection or their friendship superficially by liking each other’s social media posts.
惹	rě	Particle. This Internet slang term is a substitute for 了 [le] which is a particle indicating the completion of an action. It also mimics the Taiwanese Mandarin accent.
这样的。。。给我来一打	zhè yàng de…gěi wǒ lái yì dá	<Expression> Give me a dozen of…like this. This expression is used to emphasize one’s affection for something or someone.
鬼知道我经历了什么	guǐ zhī dào wǒ jīng lì le shén me	<Expression> The ghost knows what I went through. God knows what I went through. This expression was first made popular by swimmer Fu Yuanhui during the 2016 Rio Olympics when she described her challenging training experiences. She used another Internet slang term 洪荒之力 [hóng huāng zhī lì] “preternatural power” in the interview. Her candid and humorous replies made her an Internet sensation.
什么仇什么怨	shén me chóu, shén me yuàn	<Expression> What grudge do you hold against me? This expression first became popular in 2014 as a passenger’s reply to another passenger who tried to stop him from cracking melon seeds on the bus. They kept arguing for seven minutes while the melon seed cracker grumbled “What grudge do you hold against me [so that you keep pestering me]?” several times during the process. Now the expression is used as a comment on or complaint about an interpersonal conflict that one does not fully understand.
废柴	fèi chái	n. Trashy+firewood. Loser. Schmuck. This Internet slang term describes a loser or worthless person who has the potential to be rich and realize his or her dreams one day.
黑历史	hēi lì shǐ	n. Black+history. One’s disgraceful past. Sometimes it is used humorously to describe one’s embarrassing experiences when he or she was a rookie.
钱妞	qián niū	n. Money+lass. This Internet slang term is a nickname for Kesha.
吉米肥伦秀	jí mǐ féi lún xiù	n. Jimmy+fat+[Fal]lon+show. This Internet slang term is a chirpy translation of The Tonight Show Starring Jimmy Fallon. However, 肥倫 [féi lún] “Fatlon” is used only because it sounds similar with “Fallon” but it is not a nickname for the host himself. The alternative translations include 肥倫秀 [féi lún xiù] “Fatlon Show” and 吉米肥倫今夜秀 [jí mǐ féi lún jīn yè xiù] “Jimmy Fatlon Tonight Show.”
吉米鸡毛秀	jí mǐ jī máo xiù	n. Jimmy+Chicken feather+show. This Internet slang term is a chirpy translation of Jimmy Kimmel Live! because 雞毛 [jī máo] “chicken feather” sounds like “Kimmel.” However, 雞毛 [jī máo] “chicken feather” is a not a nickname for Jimmy Kimmel. A shorter translation of the show name is 雞毛秀 [jī máo xiù] “Chicken Feather Show.”
扣扣熊	kòu kòu xióng	n. Button+button+bear. This Internet slang term is a nickname for Stephen Colbert because it sounds like his last name “Colbert.”
囧司徒	jiǒng sī tú	n. Awkward+Situ [Chinese surname]. This Internet slang term is a nickname for Jon Stewart due to similar pronunciation.
雨神	yǔ shén	n. Rain God. This Internet slang term is a nickname for Jam Hsiao or Xiao Jingteng because his presence in new cities during the concert tour tended to coincide with downpours.
水果姐	shuǐ guǒ jiě	n. Fruit+sister. This Internet slang term is a nickname for Katy Perry because of her colorful wardrobe. She is also famous for the fruity outfit in the Super Bowl halftime performance.
付兰兰 / 腐兰兰	fù lán lán / fǔ lán lán	n. Fu Lanlan or Rotten Lanlan.. This Internet slang term is an affectionate nickname for James Franco because it sounds like his last name. “Lanlan” is traditionally a female name and 腐 [fǔ] as an Internet slang term means “obsessed with bromance or romance between two young men .”
麻辣鸡	má là jī	n. Spicy+chick. This Internet slang term is a nickname for Nicki Minaj because it sounds like her last name “Minaj” and compliments her voluptuous figure.
火星哥	huǒ xīng gē	n. Brother Mars. This Internet slang term is an affectionate nickname for Bruno Mars.
抖森	dǒu sēn	n. Tremble+forest. This Internet slang term is a nickname for Tom Hiddleston because it sounds a little like his last name “Hiddleston.”
蛋妞儿	dàn niū er	n. Egg+lass. This Internet slang term is a nickname for the hunky Daniel Wu Yin-cho or Wu Yanzu. The slang term sounds like a nickname for a country girl in North China but it is adapted from the pronunciation of his English name “Daniel.”
卷福	juǎn fú	n. Curly+Holmes. This Internet slang term is a nickname for Benedict Cumberbatch because of his curly hair and his character Sherlock Holmes.
囧瑟夫	jiǒng sè fū	n. Awkward+[Jo]seph. This Internet slang term is an affectionate nickname for Joseph Leonard Gordon-Levitt, because his facial features look like the Chinese Internet slang term 囧 [jiǒng] “awkward.”
水逆	shuǐ nì	n. Mercury+retrograde. In astrology, when Mercury retrogrades, things tend to go wrong. This Internet slang term is used humorously to describe the reason for mishaps.
霉霉	méi méi	n. Mold Mold or Bummed Bummed. This Internet slang term is a loving nickname for Taylor Swift. Her Chinese fans feel sorry for her because her hits used to peak at No.2 on the Billboard Hot 100.
丁日	dīng rì	n. Dick+fxxk. This Internet slang term is a derogatory nickname for Justin Biber because the two Chinese characters look like his initials JB which is the Pinyin acronym for 雞巴 [jī bā] “penis.”
高司令	gāo sī lìng	n. Commander Gao. This Internet slang term is a nickname for Ryan Gosling because it sounds like the Chinese translation of his last name: 高斯林 [gāo sī lín].
宇宙观	yǔ zhòu guān	n. Universe+view. Adapted from the word “worldview,” this Internet slang term is often used as a precept reminding people not to take themselves too seriously: Look at yourself from the perspective of the universe, and you’ll realize how trivial your problems are.
怎么破	zěn me pò	Expression. How to+break. How can we solve [a problem]? How should I deal with [a situation]? This expression is used to play cute and provide/ask for a solution.
丧心病狂	sàng xīn bìng kuáng	adj. Frenzied and perverse. As an Internet slang term, it is often used positively or neutrally to describe one’s wildly unexpected behavior.
传送门	chuán sòng mén	n. Convey+door. Door-shaped teleporter.【Computing】Portal, the link to a website. This Internet slang term often precedes a website link. It is also often used to request the link to more information on a subject.
摊手	tān shǒu	v./n. To have one’s open palms face upwards. Smugshrug. This Internet slang term originally described the emoticon ¯\_(ツ)_/¯ and is now often used directly to show that you don’t give a damn about something or have to accept an unfavorable situation.
周边	zhōu biān	n. Peripheral [products. ] Merchandise produced to take advantage of a related work or a celebrity featured in the work. A tie-in or spin-off.
黑科技	hēi kē jì	n. Black technology. This term first appeared in フルメタル・パニックor Full Metal Panic!, a series of light novels written by Shoji Gatoh and illustrated by Shiki Douji, and referred to technology that is far more advanced than those of the real world. As a Chinese Internet slang term, it describes awe-inspiring technology that is beyond the understanding of the average people. Sometimes this term is used sarcastically.
热单	rè dān	n. 【Music】Hot+single. Short for 熱門單曲 [rè mén dān qǔ] “hit single.”  This Internet slang term usually refers to European and American pop songs in English.
你还记得大明湖畔的。。。吗	nǐ hái jì dé dà míng hú pàn de…ma	<Expression> Do you still remember…by the Daming Lake? This question was originally a line from the 1998 TV show Princess Return Pearl [or My Fair Princess]. Ziwei confronted her birth father Emperor Qianlong, “Do you still remember Xia Yuhe by the Daming Lake?” Xia Yuhe is Ziwei’s mother and Ziwei was born out of wedlock. Now this line is used humorously to remind the listener or reader of something or someone.
爆表	bào biǎo	adj./adv. Off the charts, extrodinarily out of the norm, top of the line. 顏值爆表 [yán zhí bào biǎo] <Expression> To max out the cute-o-meter. Off-the-charts cute/pretty.
教科书般	jiào kē shū bān	adj. Textbook. Meeting the standards set by authorities or experts in the field. 教科書般的吻戏 [jiào kē shū bān de wěn xì] Textbook kissing scenes. Amazing kissing scenes.
不装逼我们还是好朋友	bù zhuāng bī wǒ men hái shì hǎo péng yǒu	<Expression> If you don’t act all snotty, we can still be good friends. 
放空	fàng kōng	v. To become mentally remote, to space out; to empty one’s mind. 
推坑	tuī kēng	v. To push [someone] into a pit. To persuade someone to become a fan of novels or manga delivered in serial form.
弃坑	qì kēng	v. To abandon a pit. To stop posting new chapters of an Internet novel and leave it unfinished; to stop playing an online game; to give up a hobby because of boredom.
出坑	chū kēng	v. To get out of a pit. To complete an Internet novel; to accomplish all the tasks in an online game.
填坑	tián kēng	v. To fill a pit. To update an online novel.
挖坑	wā kēng	v. To dig a pit. To start writing an Internet novel and publishing it in installments; to start playing an online game. To start a project that attracts people’s attention.
吓尿	xià niào	v. Spooked+pee. To be spooked and wet one’s pants.
公知	gōng zhī	n. Bogus experts. Although it is short for 公共知識分子 [gōng gòng zhī shí fèn zǐ] “public intellectual,” this coinage is often a pejorative term for rabble-rousers who seek support on social media by appealing to popular desires and prejudices.
禁欲系	jìn yù xì	n. Abstinent+sect. This Internet slang term describes the nice-looking and refined heterosexual male celebrities whose aloofness and reticence make them look as if they were not interested in sex.
日了狗	rì le gǒu	<Expression> Boinked the dog. 我真是日了狗了 [wǒ zhēn shì rì le gǒu le] “I had boinked the dog” is a vulgar way of whining “What have I done to deserve this?” It goes well with a facepalm.The term was originally an ID on Douyu TV (live streaming site).
然并卵	rán bīng luǎn	Expression. Short for 然而並沒有什麽卵用 [rán ér bìng méi yǒu shén me luǎn yòng] “But it is useless” or “But it doesn’t make any difference.” This expression is used to express one’s frustration or contempt.
追剧	zhuī jù	v. Chase+drama. To binge-watch TV dramas or to keep up with the latest episodes of a new TV series.
视奸	shī jiān	v. Visually+rape. This Internet slang term originated in Japan to describe sexual objectification of women in photography, but now in China it means: 1) to stare at women in a lewd way; 2) to annoy others online through oversharing.
砖家	zhuān jiā	n. Brick+expert. Charlatans. This Internet slang term and 專家 [zhuān jiā] are homophones. It is a cynical nickname for bogus experts who mislead the public with irresponsible or unreliable comments. Their credibility is jeopardized by their own ignorance or depravity.
干了这碗毒鸡汤	gān le zhè wǎn dú jī tāng	Drink up this bowl of poisonous chicken soup. To swallow the hard truth. To swallow the bitter pill. This invitation is used before pointing out the poignant reality or harsh-sounding advice and asking the audience to accept it.
先森	xiān sēn	n. First+forest. Sir, mister. This Internet slang term is a phonetic deviation of 先生 [xiān shēng] with a southern accent. The use of this slang term indicates playfulness and/or affection.
跪舔	guì tiǎn	v. Kneel+lick. To suck up to someone; to treat someone with a servile attitude; to blindly admire someone or something. This Internet slang term also humorously describes one’s fervent admiration for someone or something.
细思恐极	xì sī kǒng jí	Expression. Meticulously+think+fear+extreme. To think carefully about something to a point where one is petrified to the extreme.
请收下我的膝盖	qǐng shōu xià wǒ de xī gài	<Expression> Please accept my knees. Please allow me to kneel down in front of you. Please accept my reverence [for you].
活捉一只	huó zhuō yì zhī	v. To catch a [cute person, animal, or thing] alive. This Internet slang term is often used humorously to describe a happy encounter or discovery online or offline.
蹭热度	cèng rè dù	v. Cadge+heat. To freeload the popularity of a more famous celebrity for personal gain, especially public attention. This Internet slang term is often used by the fans to attack someone whom they often consider to be less popular than their idol.
单身汪	dān shēn wāng	n. Single+woof. Single+woof.  This Internet slang term refers to single people who are eager to enter a relationship but find it difficult to achieve the goal.
嗨p	hāi p	adj. Hi+P. This Internet slang term is a phonetic deviation of “happy.”
天啦噜	tiān la lu	Interj. Zoikes; well, well; oh Lord; wow. 
你这是在搞事情	nǐ zhè shì zài gǎo shì qing	Expression. You are causing trouble for me. Actor Chen He frequently used this expression on the Chinese version of Running Man. Now this expression is used to vent or joke about unexpected or undesirable situations.
握爪	wò zhǎo/wò zhuǎ	v. Hold+claw. A cute way of saying 握手 [wò shǒu] “shake hands.”
怼	duǐ	v. 1. To inveigh against [someone]. 2. To debate with [someone].
相爱相杀	xiāng ài xiāng shā	<Expression> To love and kill each other. This Internet slang term humorously describes a de facto or assumptive love-hate relationship between two individuals.
你咋不上天呢	nǐ zǎ bú shàng tiān ne	Expression. Why don’t you just go up into the sky? You might say that to a person who is full of hot air or feels too good about himself or herself. Hopefully your sarcasm will bring them down to earth
原地爆炸	yuán dì bào zhà	Expression. Implode right where you are. This expression is used to indicate one’s dissatisfaction with or anger at a person’s statement or action. It is a euphemism for “Get lost.”
萌炸	méng zhà	adj. Cute+explode. Explosively cute. Cute overload.
来啊，互相伤害啊	lái a, hù xiāng shāng hài a	<Expression> Come on, let’s hurt each other. At first glance, this expression is used to provoke a quarrel, but more often than not, it serves to humorously comment on a potentially combative situation.
先马后看	xiān mǎ hòu kàn	<Expression> First+bookmark+later+read. Since 馬 [mǎ]=馬克 [mǎ kè]=Mark=Bookmark, this phrase means “Bookmark it for later perusal.” It is used when you re-share something you like and want to read more closely when you have a moment.
蓝瘦香菇	lán shòu xiāng gū	n. Blue+slim+shiitake mushroom. This Internet slang term is how a 24-year-old man from Nanning, Guangxi said 難受想哭 [nán shòu xiǎng kū] “Sad, want to cry” in the Nanning dialect. His teary monologue made him an Internet sensation overnight.
种草	zhòng cǎo	v. Grow+grass. This Internet slang term compares recommending products to others to growing grass, because one plants the seeds of desire for the product in the listener’s mind. The speaker is usually a fashion blogger or a loyal consumer of a brand.
小白	xiǎo bái	n. Little+white. This Internet slang term is analogous to “rookie” or “newbie.” This term is often used to describe one’s inexperience in a field. It is a neutral or positive term because it implies one’s need for learning.
男神经 /女神经	nán shén jīng / nǚ shén jīng	Male buffoon/ female buffoon.. Slightly different from 男神/女神 [nán shén / nǚ shén] which literally mean “god/goddess,“ this set of Internet slang terms are saved for your goofy friends or yourself. Although 神經 [shén jīng] is short for 神經病 [shén jīng bìng] “neurotic,” many people won’t feel offended. These two Internet slang terms tend to be deemed positive for acknowledging a person’s sense of humor.
闪	shǎn	v. Literally “flash,” this Internet slang term means to leave swiftly, to beat a hasty retreat. 
有毒	yǒu dú	adj. Poisonous. This Internet slang term is often used to describe any viral Internet meme such as a catchy melody, an Internet spoof, and a humorous emoji, that is addictive. It also describes a person who is goofy and funny.
炒鸡	chǎo jī	adj. Stir-fry+chicken. This Internet slang term means 超級 [chāo jí] “super, extremely.” Since the vegetarians and vegans in China don’t eat chicken anymore, they put the dish name to good use…
敲	qiāo	adj. Strike. This verb as an Internet slang term is a phonetic deviation of 超 [chāo] “super, extremely.” When you use this meme in Internet posting or online conversations, you are deliberately trying to lighten up or act cute.
泥萌	ní méng	pron. Mud+cute. You guys. This Internet slang term is a phonetic deviation of 你們 [nǐ men] “you guys.” This term is often used humorously.
拉拉	lā lā	n./adj. Holding (hands). This Internet slang term means “lesbian.” Similar terms include 百合 [bǎi hé] lily, 女同 [nǚ tóng] female+same, and 蕾絲邊 [léi sī biān] lace+border.
有范	yǒu fàn	adj. Having great panache, radiant with confidence, displaying distinctive and stylish elegance. This Internet slang term praises one’s appearance, fashion sense, mannerisms, and/or character.
厉害了我的哥	lì hài le wǒ de gē	<Expression> Wow you rock, my brother. This Internet slang term came into popularity as a high school student’s comment on the dazzling gaming skills of his military training instructor who caught him playing The King’s Glory on the phone. Instead of confiscating the phone, the instructor unleashed his inner gamer and helped the student win the game. This expression is now used to express astonishment or amazement. The word “brother” is replaced in other contexts to address different people.
敲黑板	qiāo hēi bǎn	V. To strike the blackboard with one’s knuckles or hand (to ask the students to pay attention). This Internet slang term is reminiscent of the teaching style of many Chinese teachers. This Internet slang term is used to emphasize something.
此处应有掌声	cǐ chù yīng yǒu zhǎng shēng	<Expression> A round of applause is expected here. This expression is often humorously used by the self-touted speaker to invite the audience to acknowledge what he or she just said.
感觉身体被掏空	gǎn jué shēn tǐ bèi tāo kōng	<Expression> [I] feel the insides of my body were scooped out. I feel so drained. This Internet slang term is used to describe fatigue and depression. For example, you can use it to describe how you feel when your boss incessantly asks you to work overtime.
脱线	tuō xiàn	v. To derail. To suddenly change the subject; to suddenly become distracted.
造	zào	v. To know, know of. This Internet slang term is a funny variation of 知道 [zhī dào]. They sound similar especially when you say the original word very fast. It was created to mimic the way the word is uttered in Taiwanese Idol TV dramas.
始于颜值，陷于才华，忠于人品	shǐ yú yán zhí, xiàn yú cái huá, zhōng yú rén pǐn	Expression. [My love for my idol] started because of his or her looks, then I fell for his or her talents, and I stick around because of his or her character.
二哈	èr hā	n. Silly+Ha. Silly husky. This Internet slang term is an affectionate nickname for pet huskies.
痴汉脸	chī hàn liǎn	n. Infatuated man’s face. This Internet slang term is used to describe one’s ardent admiration for someone or something. It is very often seen in the humorous depiction of one’s adoration for an idol’s looks and/or talents.
湾湾	wān wān	n. Wan Wan. This Internet slang term was created by Mainland Internet users as a nickname for Taiwan or the Taiwanese people.
实力	shí lì	adj./adv. Derived from the original noun “capability,” this Internet slang term is used as an adjective meaning “real,” or “evidence-based” and as an adverb meaning “strongly” and “effectively. ” This term is often used humorously or satirically. For example, 實力裝逼 [shí lì zhuāng bī] v. to try hard to impress others by pretending to be better than one really is. 實力心疼 [shí lì xīn téng] v. To really feel sorry for [someone].
墙裂	qiáng liè	adj. Wall+crack. This Internet slang term and 强烈 [qiáng liè] “strongly” are homophones. This meme is often used to recommend something; the image of a cracked wall is way more vivid than the original word. Imagine someone smacking a wall and speaking effusively.
霍比特人 (=哈比人)	huò bǐ tè rén (=hā bǐ rén)	n. The Hobbits.. This Internet slang term describes short people in a humorous or affectionate way.
凹造型 (=拗造型 )	āo zào xíng (=ǎo zào xíng)	n. Concave+pose=twist+pose.. This Internet slang term refers to striking a 1) trendy and cool, 2) aesthetic but pretentious or unnatural, or 3) funny pose (for photo shooting). This term is often used for humorous effects such as self-mockery.
担当	dān dāng	n. [Role] assumption. This Internet slang term is used after a noun to describe a task or challenge that one takes on. For example, in “Bounty Hunters”, Wallace Chung assumed the role of a jester (喜劇擔當 [xǐ jù dān dāng]), strategist (謀略擔當 [móu luè dān dāng]), and food junkie (吃貨擔當 [chī huò dān dāng]).
嘴炮	zuǐ pào	n. Mouth+cannon. This Internet slang term refers to telling tall tales or being argumentative and even a little aggressive.
尴尬症	gān gà zhèng	n. Embarrassment+ syndrome. 
尴尬癌	gān gà ái	n. Chagrin+cancer. 
懒癌	lǎn ái	n. Laziness cancer. This Internet term is used to describe one’s procrastination or slothfulness.
在线	zài xiàn	adj. On+line. Up to scratch. This Internet slang term is a compliment for someone or something that reaches a satisfactory level. For example, you can say an actor’s acting skills are online, meaning his or her acting skills meet the audience’s expectations.
粗线	cū xiàn	v. Bold+line. To appear, to show up. This Internet slang term and 出現 [chū xiàn] “come up, show up” are homophones. This term is a humorous way of saying “to appear” with a Taiwanese Mandarin accent.
钟黑	zhōng hēi	n. Chung+black. Wallace Chung detractors. People who disparage Wallace Chung and his fans.
又叒叕	yòu ruò zhuó	adv. Again + Again×3 + Again×4. This Internet slang term emphasizes a recurring event.
清流	qīng liú	n. Limpid+stream. A clear stream. This Internet slang term is often used in the context of “XXX is a clear stream in the field of…” to describe a rising star who stands out among others in a field, usually for his or her refreshing candor or sense of humor.
泥石流	ní shí liú	n. Mud-and-stone flow. Mudflow. This Internet slang also refers to someone who stands out in a field for his or her great sense of humor.
吃土	chī tǔ	v. To eat soil. This Internet slang term quips about the consequence of spending too much money on online shopping—eating nothing but soil because soil is free.
老干部	lǎo gàn bu	n. Old cadres. An “old cadre” is a male actor whose gravitas in conduct and speech seems a little outdated but is still very adorable for his crazy female fans.
碾压	niǎn yā	v. To mash [someone]. To defeat someone with an obvious advantage in intelligence, wealth, etc.
喷子	pēn zi	n. Literally “sprayers,” this Internet slang term means Internet trolls, or people who make deliberately offensive or provocative online postings. 
比心 /笔芯	bǐ xīn	Gesticulate+heart. Or pencil lead. Make a heart-shape with one’s hand or one’s thumb and index finger to show love and support. There are generally three ways. Click on the Chinese word to see the picture instructions.
科科	kē kē	n. Taiwanese Internet slang term meaning 呵呵 [hē hē], the sound of a smirk or an adorable giggle. Also, the term recently became the nickname of Chinese table tennis player Zhang Jike.
妖艳贱货	yāo yàn jiàn huò	n. Pretty and coquettish bitches. This Internet slang term was made popular by Taiwanese vlogger @谷阿莫 who is famed for producing video synopses of movies and TV series. In the synopses, the term was used frequently in the sentence “[The male lead] feels [the female lead] is so innocent, so unpretentious, and so different from those pretty coquettish bitches outside.” This term describes the type of women that grosses the male leads out, but of course irony is often involved.
好单纯好不做作	hǎo dān chún hǎo bú zuò zuò	<Expression> So innocent, so unpretentious. This Internet meme was made popular by vlogger @谷阿莫 in his synopses of movies and TV series. This term is usually used to explain the reason why the male lead fell in love with the female lead.
迷之=蜜汁	mí zhī/mì zhī	adj. Mystical, inexplicable.. This Internet slang term sounds like “honey+juice” so the latter is often used as an alternative. They are popularly used to point out things that are not obvious or hard to understand, such as dry humor.
白莲花	bái lián huā	n. White lotus flower. 1) Kind, innocent, lovable, good people. 2) People who pretend to be kind, innocent, and lovable.
吃瓜群众	chī guā qún zhòng	n. The watermelon-eating people. This Internet slang term is often used in the context of 不明真相的吃瓜群眾 [bù míng zhēn xiàng de chī guā qún zhòng] the watermelon-eating people who are oblivious to the truth. This term was originally used to describe the public whose interest is jeopardized by the civil servants who blindly follow the directions of their injudicious supervisors. Now it describes Internet users who are gossipy and inquisitive or who are awear of certain hot topics but decline to comment on something. They often chalk up their silence or apathy to disinterest or the lack of access to the truth.
耽美	dān měi	n. Obsess+beauty. Japanese litereary term たんび (tanbi) which originally referred to aestheticism but has evolved to be connected with BL-themed works since the 1970s.
同人	tóng rén	n. Japanese term doujin referring to a group of people or friends who share an interest, activity, hobbies, or achievement. In China, this term is often used to describe people who are engaged in fanfiction writing.
对方不想和你说话并向你扔了一只狗	duì fāng bù xiǎng hé nǐ shuō huà bìng xiàng nǐ rēng le yì zhī gǒu	n. The other party didn’t want to talk to you and threw a dog at you. This Internet slang term went popular in April, 2016 as a reference to the Reject Message notification on WeChat. The dog is an emoticon sent by one party of the chat after rejecting the message. Rejection of WeChat messages is usually caused by dissatisfaction of the other party’s opinions or communication styles. This meme has witnessed a variety of permutations starting with “The other party doesn’t want to talk to you and…”
同框	tóng kuāng	v. Same+frame. (To be captured) in the same picture. To be seen together in public.
背锅	bēi guō	v. Carry+wok. 1) To be made the scapegoat. 2) To bear the blame for someone else’s mistake.
甩锅	shuǎi guō	v. Dump+wok. 1) To refuse to be wronged. 2) To shirk responsibility while one is actually responsible.
一言不合就。。。	yì yán bù hé jiù…	<Expression> [To do something] because of a word of discord. This expression is used to emphasize the unexpected behavior after having a mild disagreement. Sometimes disagreement is not involved, it is used to describe how someone started doing something out of the blue.
油管	yóu guǎn	n. Gas pipeline. This Internet slang term is a nickname for YouTube. 油 [yóu] “oil or gas” sounds like “you” while 管 [guǎn] “pipe” is a translation of “tube.”
约炮	yuē pào	v. Appointment+cannon. To have casual sex such as one-night stands and other related activity. This Internet slang term is created from a male points of view because it is a combination of 約會 [yuē huì] “to have a date” and 打炮 [dǎ pào] “1) To open fire with artillery, 2) a slang term for having sex [with a prostitute], or 3) to jerk off.”
饭	fàn	n. Fan.. The pinyin pronunciation of the Chinese character “rice” looks like the English word “fan”
饭制	fàn zhì	adj. Fan-made. 
饭拍	fàn pāi	adj. Fan-shot. (Of videos) shot by fans.
毁童年	huǐ tóng nián	adj. Destroy+childhood. (Of things) leading to the disillusionment about childhood. This Internet slang term is often used to describe a parody of childhood idols or favorites.
干货	gān huò	n. Dry+goods. Originated from the old-school robber vernacular referring to valuables, this Internet slang term now refers to valuable information or helpful advice.
行走的荷尔蒙	xíng zǒu de hé ěr méng	n. The walking hormones. Stud muffins, attractive men.
剩男	shèng nán	n. Leftover men. A sexist Internet slang term referring to single men over 30 years old.
剩女	shèng nǚ	n. Leftover women. A sexist Internet slang term referring to single women over 27 years old.
内个	nèi ge	interj. An alternative of 那個 [nà ge] “that one. ” A common filler in Mandarin everyday conversations.
抱大腿	bào dà tuǐ	v. Hug+lap. To cling to someone’s laps. To curry favor. To be obsequious and exhibit a fawning attitude.
雨露均霑	yǔ lù jūn zhān	v. To bestow benefits equally. Do not play favorites. This Internet slang term is used to 1) resist unwanted attention, 2) request equal treatment, or 3) brag about the attention one receives.
刷	shuā	v. To swipe. To watch [movies or TV dramas].
科普	kē pǔ	v. To popularize science. As an Internet meme, it means to explain details about something to outsiders or nonfans.
狗带	gǒu dài	v. Dog leash. The Internet term sounds like “go die” in English and serves as an expletive.
撞脸	zhuàng liǎn	v. Face+bump. This Internet slang term is often used to describe celebrity look-alikes.
没想到你是这样的。。。	méi xiǎng dào nǐ shì zhè yàng de…	<Expression> I didn’t know you were such a… Traditionally this sentence structure is used to chastise someone, but as an Internet slang term, it is used to reveal a little-known trait of someone or something for comic effect. 
彩蛋	cǎi dàn	n. Colorful+egg. Video teaser.
碧池	bì chí	n. Turquoise pond. Bitch. This Internet slang term is a euphemism for “bitch” because of the similar pronunciation.
老司机	lǎo sī jī	n. The old driver. The Internet slang term started off referring to a person who likes talking dirty. The internet meme comes from “老司機，嗚嗚嗚/污污污”: Old driver, toot, toot, toot/dirty dirty dirty.” “Toot” and “dirty” are homophones. Later, another meaning of this term emerged: a person who is experienced in something. For example, a senior-year student may refer to himself or herself as an old driver because he or she has spent more time at a university than younger students. A veteran salesperson can also describe himself or herself as an old driver in the field.
不能我一个人瞎	bù néng wǒ yí gè rén xiā	<Expression> I can’t go blind alone. This Internet meme is used after you see gross or scary stuff online. You are so traumatized that you wish to poke your eyes out, but before you do that, you feel you must share what you saw…
手贱	shǒu jiàn	adj. Hand+base. (Of hands) base. You chastise your hand or fingers for being base because you clicked on something that is so gross or scary that you regret being inquisitive.
人设	rén shè	n. Short for 人物設定 [rén wù shè dìng] character design. This internet meme is typically used in the discussion of characters in Internet novels, TV series, and movies.
小黄书	xiǎo huáng shū	n. Little+yellow+book. The yellow little book is a nickname for books and magazines characterized by either pornography or eroticism.
爱情动作片	ài qíng dòng zuò pian	Love+action+movie. This Internet meme is a euphemism for porn movies or videos.
船戏 (=床戏)	chuán xì/chuáng xì	n. Boat scenes=bed scenes=sex scenes.. This Internet slang term came into popularity because “boat” and “bed” are soundalikes.
滚床单	gǔn chuáng dān	v. roll+bed sheets. Originating from a sexist belief in Northeast China that having a little boy roll on a wedding bed will help the couple conceive sons, this Internet slang term now refers to having sex.
欲求不满	yù qiú bù mǎn	adj. Having unsatisfied sexual desire. #Wuli污月#
发糖	fā táng	v. To give out candies. This Internet slang term stems from the ritual of giving out sweets as wedding favors. Now it refers to a couple displaying affection in public or sharing details about their love. It is a positive term.
好奇宝宝	háo qí bǎo bao	n. Curious baby. This Internet slang term is often used to describe an adult (often one’s idol) of boundless curiosity. The childlike quality is celebrated and adored.  #520告白钟汉良##科沃斯管家机器人#
LOL=撸啊撸	lū a lū	n. League of Legends, a multiplayer online video game. The Chinese nickname, literally “stroke and stroke,” has a sexual connotation because of its connection with 擼管 [lū guǎn] stroke+tube [penis] or male masturbation.
黑子	hēi zi	n. Black mole/sunspot. As an Internet slang term, it refers to web users who vilify a celebrity on the Internet.
啪啪啪	pā pā pā	n. The sound of slapping or smacking. This is a euphemism for having sex.
雅蠛蝶	yǎ miè dié	n. Literally “small elegant butterfly,” this Internet meme became popular around 2009. It sounds like the Japanese word yamete (止めて) “stop,” which is a stereotypical female line in Japanese porn movies. The butterfly species doesn’t exist.
颜艺	yán yì	n. The art of facial expression, especially the acting style featuring contorted facial expressions. This Internet slang term comes from the Japanese ACG culture.
酸	suān	v. Sour. To make snide remarks. 
有毒	yǒu dú	adj. Poisonous. This Internet slang term is used to describe wonderful things that enthrall the audience, listeners, web users, etc.
苏 (=酥)	sū	adj. (Of a person’s limbs) weak, soft.. This Internet meme describes a charming smile or gesture that melts you heart. Reactions may include goose bumps, shivers down you spine, a tingling sensation all over your body, and a big smile on your face.
油菜花	yóu cài huā	n. Canola flower/rape flower. This term is popular among Wallace Chung’s mainland fans and refers to talented fans who are creative, artistic, and/or tech-savvy. The namesake was created because it sounds like 有才華 [yǒu cái huá] “talented.”
放开他, 让我来	fàng kāi tā, ràng wǒ lái	Get your hands off him, let me handle this. Originally a cliche line asking the kidnapper to release the hostage, this Internet slang term is now used to humorously express the desire to hug or kiss one’s favorite star.
直女癌	zhí nǚ ái	n. Straight woman cancer. The female form of “straight man cancer,” this Internet slang term describes women who submit to sexism and actively attack women’s liberation. They deride career women, single women, childless women and mothers who don’t have sons.
无感	wú gǎn	adj. No feeling. Show no interest. To be not affected. This Internet slang term is used to show your disinterest in someone or something.
生无可恋	shēng wú kě liàn	<Expression> There is nothing in life to long for. This Internet meme is a humorous alternative to words like “distraught,” “bummed out,” and “speechless.” A typical facial expression is actually an impassive one due to utmost frustration. 
套路	tào lù	n. Trap+path. Originally the word means “routine,” “sequence,” “pattern,” “artifice,” “stratagem,” and “style.” As a new Internet meme, however, it also means “cliche,” “trap,” and “machination.” It is used to express one’s boredom with cliches or speaking patterns. It also helps express distraught after falling into someone’s trap.
我走过最远的路，是你的套路	wǒ zǒu guò zuì yuǎn de lù, shì nǐ de tào lù	The longest path I have ever taken, is the path to your trap. 
少一点套路，多一点真诚	shǎo yì diǎn tào lù, duō yì diǎn zhēn chéng	Fewer schemes and more sincerity please. 
浪	làng	v. To play in an unrestrained way. Sometimes it means to be promiscuous, to fool around.
圈粉	quān fěn	n. Encircle+fans. To glean/accumulate fans.
洪荒之力	hóng huāng zhī lì	n. Primeval power. Catastrophically strong physical strength. This Internet slang term came into popularity because of the 2015 TV drama The Journey of Flower in which the character Hua Qiangu aka Demon God has the preternatural, catastrophic power. Currently the meme is used to describe one’s physical strength or one’s urge to do something.
发动洪荒之力	fā dǒng hóng huāng zhī lǐ	“To harness the premival strength”. 
抵挡不住体内的洪荒之力	dǐ dǎng bú zhù tǐ nèi de hóng huāng zhī lì	“[I] can’t resist the primeval power in my body”. 
么么哒	mē mē da	n. 麼 [mē] is an onomatopoeia that mimics the sound of a gentle kiss aka “mwa,” [or chup in Thai, schmatz in German, mats-muts in Greek, umma in Malayalam, and chu in Japanese]. This Intenernet term imitates the form of 萌萌噠 [méng méng da] and has been a popular way among Chinese young people to show affection.
这句话我给满分	zhè jù huà wǒ gěi mǎn fēn	<Expression> I give this sentence full marks. This phrase is used to compliment someone who says something that greatly pleases the listener. A variation is 這句話我給99分，多一份怕你驕傲 [zhè jù huà wǒ gěi jiǔ shí jiǔ fēn, duō yì fēn pà nǐ jiāo ào] I give this sentence 99 points; if I give you one more point, I am afraid you will be too proud.
会聊天	huì liáo tiān	v. To know how to chat. A conversationalist who is polite, respectful, understanding, and interesting is touted as someone who knows how to chat. This Internet slang term celebrates one’s high EQ. In the Chinese Internet culture, a high IQ is predominately defined as being polite and considerate of others.
不会聊天	bú huì liáo tiān	v. To not know how to chat. A person who doesn’t know how to chat tends to offend others intentionally or unintentionally. This Internet slang term is often used humorously as a mild criticism of the lack of consideration of others’ feelings.
应援	yìng yuán	v. Originating from Japan and South Korea,  応援 or 응원, this Internet slang term means to help and support [the idol]. 
男友力	nán yǒu lì	n. Boyfriend+strength. The likelihood of being an ideal boyfriend.
男友力MAX	nán yǒu lì MAX	n. Perfect boyfriend material. This Internet slang term describes both men and women who make a woman feel safe, loved, and happy.
霸屏	bà píng	v. To occupy the screen. You use this Internet slang term to describe an actor whose works you can see everywhere on TV and in movie theaters.
本宝宝	běn bǎo bao	n. I, the baby. Referring to oneself as a baby. This Internet slang term is used by young people to play cute. (Digital illustration by Kim Smith)
明明可以靠脸吃饭, 偏偏要靠才华	míng míng kě yǐ kào liǎn chī fàn, piān piān yào kào cái huá	<Expression> [Someone] could have clearly had meals with the face, but he/she chose to do so with talents and skills. “Have meals” means “make a living.” This expression means “[someone] could have made a living easily with his or her good appearance, but he/she insists on utilizing his or her talents and skills.” The expression is used to show recognition of someone’s becoming appearance and volition to learn skills and work hard.
迷妹	mí mèi	n. Fan+sister. Female fanatics. Fervent female fans.
迷弟	mí dì	n. Fan+brother. Male fanatics. Fervent male fans.
节操掉了一地	jié cāo diào le yí dì	Expression. Integrity is scattered all over the floor. This Internet slang term often describes people who do unconventional things that are not necessarily unethical. Considered reckless, silly or even brash by the outsiders, those “out-of-place” acts are usually done out of passion, such as what fans would do for idols or what an infatuated person would do for his or her crush.
酱	jiàng	n. Chan. This word is added after a child’s name or a close friend’s name to show affection in Japanese, but Chinese young people (especially Japanese culture lovers) like using the word too. 
新番	xīn fān	n. New show. Originally it referred to new Japanese animation-manga TV series, now it describes any new TV show or movie.
颜值巅峰	yán zhí diān fēng	n. The peak of physical attractiveness. 
洗脑神曲	xǐ nǎo shén qǔ	n. Brainwashing+epic+song. A pop song whose melody and lyrics are catchy and memorable. When it is stuck in your head, it can stay there for days. Sometimes this Internet slang term is slightly negative because the music is often not considered very classy.
碎成渣渣	suì chéng zhàn zhā	v. To break into smithereens. This Internet slang term is often used to describe a broken heart or the challenged worldview, but exaggeration, humor, and/or sarcasm are involved in the usage.
活久见	huó jiǔ jiàn	<Expression> Live+long+see. If you live long enough, you will be able to witness all kinds of things (however unbelievable or bizarre they are).
烧脑	shāo nǎo	adj. Burn+brain. Brain-scorching. This Internet slang term means “intellectually challenging”.
鬼畜	guǐ chù	n./adj. Ghost+beast. To inflict suffering. Originally an ACG term, this neologism often refers to a video editing technique that pieces together dialogue and background music for humorous value. Some sounds are looped at a high speed, which might cause discomfort.
蒙圈 (=懵圈=懵逼 )	mēng quān (=měng bī)	adj. Dumbstruck, dumbfounded, muddled, perplexed, flustered.. 
A站	A zhàn	A site aka Acfun. B站 [B zhàn] B site aka bilibili. Both are interactive video sharing websites themed around anime, manga, game, movie, music, and TV fandom based in China. They also both feature “barrage,” a real-time on-screen user commentary system.
凤凰男	fèng huáng nán	n. Phoenix man. This Internet slang term refers to self-made men of humble roots. This group has been widely discussed because of their marital conflicts typically with “peacock women” and their emotional enmeshment with their families of origin. The implication is negative.
孔雀女	kǒng què nǚ	n. Peacock woman. This Internet slang term refers to women raised in well-off families in the cities. This group has been widely discussed because of their marital conflicts typically with “phoenix men” on cultural differences and financial matters. The implication is negative.
键盘侠	jiàn pán xiá	n. Keyboard+knight-errant. People who like going on a rant on the Internet. They are cynical and judgmental without the ability to make a difference through action. 噴 [pēn] v. To spurt, spout, gush. This Internet slang term means “to go on a rant,” often used to describe Internet trolls.
生肉	shēng ròu	n. Raw meat. Foreign language videos without Chinese subtitles.
熟肉	shú ròu	n. Cooked meat. Foreign language videos with Chinese subtitles.
小李子	xiào lǐ zi	Little Lee, an affectionate nickname for Leonardo Dicaprio. It is also a common nickname for an eunuch whose family name is Li in TV series about the imperial palace of the Qing dynasty.
狗粮	gǒu liáng	n. Dog food. This neologism refers to the self-pity of single people (humorously dubbed “single dogs“) triggered by the public displays of affection by couples online or offline.
瞎逼逼=瞎BB	xiā bī bī	v. To talk sheer nonsense; to ramble on; to nag; to gossip; to judge others. 
你行你上，不行别瞎BB	nǐ xíng nǐ shàng, bù xíng bié xiā bī bī	Expression. If you can do it then you should go up and do it, otherwise you’d better keep your mouth shut.
调戏=TX	tiáo xì	v. To tease (someone). The word used to mean “to take liberties with (a woman)”, but as an Internet slang term, it means “to tease someone for wholesome fun”.
污力滔滔	wū lì tāo tāo	<Expression> Pouring out dirtiness in a steady flow. This expression is used to describe people who like talking about sex either directly or indirectly.
嘿嘿嘿	hēi hēi hēi	n. Hehehe. Lewd laughter. A euphemism for lovemaking used by Taiwanese entertainer Fei Yu-ching in one of his sex jokes on TV.
污	wū	adj. Dirty. This neologism is used to tease someone that tells sex jokes. It is also used to comment on sexually explicit content. Humor is involved in the usage and the user doesn’t really abhor the sex puns or lewd talk.
开挂	kāi guà	v. Originally referring to playing dirty in video games through a cheat code or a cheat cartridge, this Internet slang term is an alternative way of saying “[someone] is on fire/doing an incredibly great job as if she or he were cheating”. 
逼格	bī gé	n. Fraud caliber. The ability to make people think you are better than you really are.
朝阳群众	cháo yáng qún zhòng	n. People of Chaoyang District [in Beijing]. Residents of this area are famous crime-busters who actively report suspicious activity to the police to ensure community safety.
我伙呆 (=我和小伙伴都惊呆了)	wǒ huǒ dāi (=wǒ hé xiǎo huǒ bàn men dōu jīng dāi le)	<Expression> My little buddies [“little buddies” is used among children to refer to friends] and I were all dumbfounde. This expression is often used humorously to express one’s shock at something.
表情包	biǎo qíng bāo	n. Emoji package. A humorous picture or GIF used in online conversations as an emoji. The image is often captioned.  Celebrities’ pictures of exaggerated facial expressions are often captioned as emojis.
大写加粗	dà xiě jiā cū	adj. Written in bold and all caps. This Internet slang term is used to emphasize the words that come thereafter.
耿直	gěng zhí	adj. Candid, honest and outspoken, not worried about one’s own image or others’ feelings. This Internet slang term can be either positive or negative.
节操	jié cāo	n. Scruples, moral principles, integrity. This slang term is often used in teasing and joking.
从此节操是路人	cóng cǐ jié cāo shì lù rén	<Expression> Scruples have since been passers-by. This expression means making unconventional choices would distance you from the social norms widely observed by the consertative people. For example, when one develops a hobby of reading or watcing Boy’s Love anime, he or she may be more likely to appeciate unconventional ideas about dating and relationships.
追星狗	zhuī xīng gǒu	n. Star-chasing dogs. Fanatic fans [of artists and entertainers such as singers and actors].
把妹	bǎ mēi	v. To hit on a woman, to do something rather purposefully to attract women’s attention. This Internet slang term comes from Taiwan.
撩妹	liáo mēi	v. Titillate+sister. 1) To do something snazzy to attract the female audience’s attention. 2) To hit on a female to steal her heart.
城会玩	chéng huì wán	City+can+play. This Internet slang term is short for “urban residents know how to have fun”. You use it when you are amused by people’s attempt to entertain themselves. Sometimes it is used sarcastically.
叨逼叨	dāo bī dāo	n./v. Meaningless, rapid talk; an idle chatter; gabble; nagging. 
心机boy/girl	xīn jī boy/girl	n. Scheming, shrewd boy/girl. This Internet slang term is used to describe a person whose behaviors are self-serving. It can be used positively to tease a friend or an idol or negatively to criticize someone.
聊聊人生	liáo liáo rén shēng	v. To chat about life, a humorous euphemism for “I disagree,” “Are you kidding me,” and “Are you out of your mind. ” This Internet slang term is used when you find people’s words or actions silly or perplexing and you want to tease them a little bit.
粗来	cū lái	v. Come out. A humorous phonetic deviation of 出來 [chū lái] “come out”.
森女	sēn nǚ	n. Mori (Forest) girl. In Japanese, a mori girl is a girl who looks like she lives in forests. She is dressed in earthy colors and pursues a simple and natural lifestyle.
舔屏	tiǎn píng	v. To lick the screen. To drool over the online photos or videos of sexy people or scrumptious food.
触手	chù shǒu	n. 1. Illustrators who use touch-enabled devices and pressure-sensitive pens. 2. ACG illustrators.
死忠粉	sǐ zhōng fěn	& 鐵粉 [tiě fěn] n. Dead+loyal+fan. Iron+fan. Both Internet slang terms mean “hardcore fans, stalwarts”.
放大招	fàng dà zhāo	v. To roll out a significant gambit. To make a big and possibly risky move to achieve the desired result.
严肃脸	yán sù liǎn	adj./n. Stern-faced. A stern face.
我宣你	wǒ xuān nǐ	~= 我喜歡你 [wǒ xǐ huān nǐ] Expression.. This Internet slang phrase is a cute way of saying “I like/dig/love you” with a Taiwanese Mandarin accent.
。。。不是高冷，只是暖的不是你	。。。bú shì gāo lěng, zhǐ shì nuǎn de bú shì nǐ	<Expression> [Someone] is not cold and aloof—it’s just that you are not the one he/she cares about. This Internet slang phrase is used to comment on the fact that someone is not that into you.
妈妈问我为什么跪著看。。。	mā ma wèn wǒ wèi shén me guì zhe kàn。。。	Mom asked me why I watch…on my knees. This Internet slang term is used to describe a mind-blowing or mind-boggling video or other content.
人畜无害	rén chù wú hài	adj. Doesn’t not do harm to either human beings or animals. Innocuous. This Internet slang term is used to describe a person who is kind and innocent and maybe occasionally naive.
没sei了 (= 没谁了)	méi séi le (méi shuí le)	<Expression> Nobody can beat that. This Internet slang term is often used ironically to comment on unique or controversial people or behavior.
趴	pā	n. Party. The word literally means lying on one’s stomach, but as an Internet slang term, it means “party” because of the similar pronunciation. 
圣诞趴	shèng dàn pā	n. Christmas party. 
轰趴	hōng pā	n. Bomb+lie on one’s stomach. Home party. This Internet slang term is a translation of the English term “home party” because 轟 [hōng] sounds like “home” and 趴 [pā] sounds like “party.”
卖家秀	mài jiā xiù	n. The seller’s demo. 
买家秀	mǎi jiā xiù	n. The customer’s demo. 
买买买	mǎi mǎi mǎi	v. Buy buy buy! This Internet slang term is often used humorously to convey or provoke a strong desire to splurge. 
反射弧过长	fǎn shè hú guò cháng	<Expression> The reflex arc is too long. Slow reflexes/response. This Internet slang term is used to describe the situation where it took someone a while to discover or realize something.
陪伴，是最长情的告白	péi bàn, shì zuì cháng qíng de gào bái	<Expression> Staying as one’s companion is the most perennial love confession. 
车震	chē zhèn	v. Car+quake. To have sex in a car.
碰瓷	pèng cí	n. Bump+china. Extortion under false pretence. As an Internet slang term, its latest meaning is that old people deliberately lying down in front of vehicles pretending to be injured and then asking vehicle owners for compensation.
娇羞	jiāo xiū	adj. Bashful. This Internet slang term is often used humorously to describe males.
……的正确打开方式	……de zhèng què dǎ kāi fāng shì	The right way of opening… This Internet slang term is an alternate way of saying “how to do…(in my opinion)” or “the right way of interpreting…(in my opinion)”. 
机智如我	jī zhì rú wǒ	adv. Witty like me. This Internet slang term is used to precede crediting oneself with accomplishing a task or avoiding a contretemps. This term is often used ironically.
以梦为马	yǐ mèng wéi mǎ	<Expression> [With one’s] dream as a horse. Originally the title of a poem by Hai Zi, this Internet slang term is now used by hipsters to show their dedication to their dreams.
自己挖的坑，跪著也要填完	zì jǐ wā de kēng, guì zhe yě yào tián wán	<Expression> Since the hole is digged by myself, I have to fill it even if that means kneeling on the ground throughout the process. This Internet slang term means that, once you make a decision or commitment, you have to pay the dues no matter what.
翻牌	fān pái	n. To flip the name plates. In ancient China, the emperor chose who to serve him at night by flipping the name plates of consorts. It is now a metaphor for being responded by someone you admire (such as your favorite star) on Weibo or being chosen to meet or interact with him or her.
上辈子拯救了银河系	shàng bèi zi zhěng jiù le yín hé xì	Rescued the Milky Way in one’s previous life. This Internet slang phrase is used to express your envy or jealousy toward the people who got something you desire. You joke that their good luck implies good karma.
讲真	jiǎng zhēn	To be honest, honestly, seriously. 
黑暗料理	hēi àn liào lǐ	n. Dark cuisine. Bizarre foods or weird food combinations that look distasteful.
重口味	zhòng kǒu wèi	adj. Strong-flavored. This Internet slang term is used to describe unconventional practices or artworks that are obscure or unpopular with the average people or mainstream audiences. Some may cause discomfort. E.g. BDSM, fetishism, eating bizarre foods.
一大波僵尸正在接近	yí dà bō jiāng shī zhèng zài jiē jìn	A huge wave of zombies is approaching. This is a famous line in the game Plants vs. Zombies. 一大波 [yí dà bō] “A huge wave/crop of…” is now an Internet slang term commonly seen in news. Pics: World Zombie Day
反转	fǎn zhuǎn	n. Turnover, an abrupt change; a reversal. 劇情反轉 [jù qíng fǎn zhuǎn] n. Plot twist. A plot twist is an unexpected change in the storyline of a novel, film, television series, comic, video game, news story, etc.
抱紧我	bào jǐn wǒ	Hold me tight. This phrase is used after voicing an opinion to invite others to side with you. It is also used to ask others to tell you if they had the same experience as you did. It originated in a weibo uproar in February, 2015 concerning a dress of disputed colors.
哏 (=梗)	gén (=gěng)	n. Punch line, joke.. This Internet slang term originally comes from Xiangsheng aka Crosstalk, a Chinese comedic performance, but it is made popular online through Taiwanese talk shows like Kangxi Lai Le aka Kangsi Coming. #Cai Kangyong and Little S Bid Farewell to Kangsi Coming# #蔡康永小S告别康熙#
气场两米八	qì chǎng liǎng mǐ bā	n. An aura of 2. 8 meters. This Internet slang term is used to describe a person with an aura of respectability. It is often used humorously.
vegan-dish带感	dài gǎn	adj. carry+feeling. This Internet slang term is used to describe people or things that touch your heart, pique your interest, and/or bring you joy.
内心戏	nèi xīn xì	n. The inner drama. This Internet slang term describes the unsaid thoughts and feelings that one has. The inner drama is often communicated through microexpressions.
公主病	gōng zhǔ bìng	n. The princess syndrome. This negative Internet slang term is used to describe women who are high-maintenance and demand to be treated like a princess. They are self-centered, temperamental, needy, attention-seeking, and often fall victim to consumerism.
福利	fú lì	n. Perks, giveaways. This Internet slang term is used to describe the benefits or gifts received for carrying certain identities.
补刀	bǔ dāo	v. [Gaming terminology] To attack a dying person once more to make sure he or she will definitely die. Similar to “rub salt in the wound,” this Internet slang term is later used to describe further mocking or rebuttal in communication.
狗血	gǒu xiě	adj. Of, Dog+blood. 1) Since dog blood was often used for exorcism in Hong Kong horror film scenes, it became an Internet meme to describe trite and highly predictable movie or TV drama scenes; 2) of, relating to ludirously unrealistic movie or TV drama scenes; 3) of, relating to, or characterized by schmaltz, dramatized sentimentalism, as in TV shows and movies; 4) of, relating to life events that are ridiculous and infuriating.
宠溺	chǒng nì	adj. adv. & n. Spoil+indulge. Indulgent, indulgently, loving indulgence.
习大大	xí dà dà	n. Uncle Xi. This Internet slang term was created by 張洪銘 Zhang Hongming as a nickname for Xi Jinping, the President of China. Zhang explained that 大大 [dà dà] is a way of addressing a paternal uncle younger than one’s father in Shaanxi dialects.
小公举	xiǎo gōng jǔ	n. A phonetic variation of 小公主 [xiǎo gōng zhǔ] “the little princess”. This Internet slang term refers to a man who does not follow the traditional gender role as a macho guy. He is not afraid to display the “feminine” body language.
碎碎念	suì suì niàn	v. Fragmented+fragmented+talk. 1) To chatter/prattle/jabber; 2) to nag; 3) to mutter.
隔壁老王	gé bì lǎo wáng	n. Next door+Old Wang. Mr. Wang who lives next door. This Internet slang term has two meanings: 1) The secret lover of one’s wife. 2) Someone else’s husband whom a woman often deems better than her own. She often annoyingly compares her own husband with that alpha male neighbor/friend/acquaintance hoping to inspire the husband to catch up with the “role model.”
嘴欠	zuǐ qiàn	adj. Having a propensity to nag at others, to talk about people behind their backs, or to simply speak impolitely or even offensively. This Internet slang term is used to describe people who lack respect for others, hurt others’ feelings, or don’t know how to hold a friendly and delightful conversation.
用生命在……	yòng shēng mìng zài	adv. To use one’s life to [do something]. To [do something] wholeheartedly/with no reservation. This Internet slang term is often used humorously.
鸡冻 (=激动)	jī dòng	adj. Chicken+frozen.. This Internet slang term and 激動 [jī dòng] “excited” are homophones and synonyms.
霸道总裁爱上我	bà dào zǒng cái ài shàng wǒ	<Expression> The overbearing executive fell in love with me. This Internet slang term describes a trending patriarchal storyline in Chinese and Korean TV shows: A domineering upper-class man being attracted to a working-class woman.
霸道总裁	bà dào zǒng cái	n. Imperious+executive. This Internet slang term refers to a chauvinist male character in romance novels and TV shows—he is a rich, powerful, and fatally attractive control freak who has a soft spot for a rather unlikely female love interest.
人生赢家	rén shēng yíng jiā	n. A winner in life. A person who achieves or even exceeds the mainstream definition of success. In China, such a person is typically heterosexual, nice-looking, highly educated, incredibly rich and/or powerful, married, and has one or more adorable children.
YY=歪歪	wāi wāi	v. YY is a pinyin acronym for 意淫 [yì yín]. 1) To fantasize; 2) to have sexual fantasies; 3) to have unrealistic expectations. 4) to interpret things in narcissistic ways. 歪 [wāi] means crooked, slanted, and evil.
求……的心理阴影面积	qiú…de xīn lǐ yīn yǐng miàn ji	<Expression> Determine the size of [someone’s] psychological shadow. Determine how traumatized someone is. This Internet slang term is used to poke fun at someone assumed to be embarrassed or hurt in a situation. For example, when you see your neighbor constantly chastise his kid by comparing the little child with the smartest kid in the class, you lament that you don’t know how traumatized the child will be by such an overbearing parent.
既视感	jì shì gǎn	n. Originally きしかん in Japanese meaning “déjà vu”, the illusion of having previously experienced something actually being encountered for the first time. As an Internet slang term, it simply means “[someone or something] looks like/feels like…”
作	zuō	v. To spaz out. To go into hysterics on someone.  To overreact and seek attention. To make a fuss about small things. n. Histrionics.
偶像包袱	ǒu xiàng bāo fu	n. An idol’s baggage. This Internet slang term refers to the the fear of losing fans that causes artists or celebrities to hide their true selves in public. They might hold fast to the established image on purpose to maintain popularity.
看脸的世界	kàn liǎn de shì jiè	n. Face-looking world. A world that prioritizes appearance. A world that favors good appearance. This Internet slang term is sometimes an example of the fundamental attribution error: Attributing personal setbacks to the cultural obsession with appearance.
颜控	yán kòng	n. Face+freak. A person who is obsessed with good-looking people and believes that beauty can give one a head start in life. They might have a conscious or unconscious bias against plain-looking people.
剁手族	duò shǒu zú	n. Hand-chopping gang. White-collar consumers whose obsessive online shopping sprees result in long bills. In hindsight, they are so guilty that they want to chop off their own hands to prevent themselves from placing orders on the Internet.
傻白甜	shǎ bái tián	n. Silly+innocent+sweet. Originally used to describe an unaffected, sweet and innocent female character in romance novels, this Internet slang term now applies to people of all genders and ages who are genuinely adorable.
我想静静	wǒ xiǎng jìng jìng	<Expression> I want some quiet time. This Internet slang term is used to when you are shocked. The expression is sometimes followed by 別問我靜靜是誰 [bié wèn wǒ jìng jìng shì shuí] Don’t ask me who Jingjing is, because an alternative interpretation of the expression is “I miss Jingjing.”
外貌协会	wài mào xié huì	n. Appearance+association. The good looks club. This Internet slang term was first used to describe women who pick dates or spouses based on their looks—handsomeness outweighs everything else. Now it also refers to a preference for aesthetic qualities.
用力过猛	yòng lì guò měng	v. To use too much strength. A Chinese equivalent of the idiom “cross the line” in English. This Internet slang term describes well-intended yet inappropriate efforts that turn out to be counterproductive or socially unacceptable.
花式秀恩爱	huā shì xiù ēn ài	v. To make a fancy display of the intimacy between a couple. This Internet slang term is created from the perspective of single people who feel left out in the face of couples especially on Valentine’s Day.
花式虐狗	huā shì nüè gǒu	v. Fancy+abuse+dogs. To hurt the feelings of single people [single dogs] knowingly or unknowingly through myriad forms of public display of affection.
虐狗	nüè gǒu	v. To abuse [single] dogs. To deliberately or unknowingly tease or hurt the single people through public displayed affection online or offline.
不忍直视	bù rěn zhí shì	<Expression> Cannot bear to look at [someone or something] straight in the eye. This Internet slang term is used when you find it hard to accept a situation.
男神/女神	nán shén / nǚ shén	n. A god/goddess. This Internet slang term is often used to describe one’s idol or love interest, usually of stunning looks and/or talents. Hyperbole is employed here to show one’s admiration.
治愈系	zhì yù xì	n. / adj. (Of the) therapeutic+series. Originated from the Japanese phrase 癒し系, this Internet slang term describes people and things that are healing, calming, and heartwarming.
负能量	fù néng liàng	n. Negative energy. People or things that are of or cause toxic emotions like excessive and/or unnecessary guilt, shame, anger, self-loathing, depression, regret, bitterness, jealousy, and resentment. Negative energy saps people of their motivation and strength.
逆袭	nì xí	v./n. To counterattack, to reverse the score, to catch up and eventually taking the lead. 
玻璃心	bō lí xīn	n. Glass+heart. Glass-like fragile heart. This Internet slang term is used to judge someone who is hypersensitive and emotionally vulnerable. It also alludes to low self-esteem. The term is sometimes used to describe oneself for humorous effect.
并没有	bìng méi yǒu	Actually, not really. This Internet slang term is often used to defy someone else’s presumption humorously.
蛇精病	shé jīng bìng	n. Snake+spirit+disease. Adapted from 神經病 [shén jīng bìng] “a neurotic person or a person with a mental disorder”, the Internet slang term often describes a creatively wacky and often funny person. It can be a compliment.
什么鬼	shén me guǐ	What the devil [is that/are you talking about]? This Internet slang term is often coupled with this emoticon [笑cry] which means 笑cry [xiào cry] “laugh to the point of crying”. You don’t use this term when you are mad or upset or confused; use it when you are amused.
燃	rán	adj. Feeling pumped and inspired. 
深夜发吃，报复社会	shēn yè fā chī, bào fù shè huì	Expression. 
翔	xiáng	n. Excrement, feces, poop. 
吓出翔	xià chū xiáng	Scare the crap out of me. 
国民老公	guó mín lǎo gōng	n. The national husband of China. This Internet slang term usually refers to Wang Sicong. The 27-year-old man is the son of Wang Jianlin, a Chinese businessman and philanthropist who is currently the richest person in China and Asia.
任性	rèn xìng	adj. Self-willed, obstinately doing what one wants in spite of social norms or the expectations of others. This Internet slang term is often used to elucidate or defend one’s independence or uniqueness in mind and action.
打脸	dǎ liǎn	v. To slap one’s own face. To behave in ways that contradict one’s previous statements; to have one’s claims contradicted by the truth.
渣男	zhā nán	n. Dreg+male. This Internet slang term usually refers to dissolute and licentious men who are disloyal in love, but it also describes men who don’t work hard for career advancement. Sometimes it is another way of describing the male chauvinist pigs.
绿茶婊	lǜ chá biǎo	n. Green tea+bitch. An ostensibly graceful and innocent young woman who is actually very calculating. This Internet slang term was created in 2013 to describe models and actresses who lead a dissipated life around the rich and powerful for personal gain.
友尽	yǒu jìn	v. Friend+over. To sever a friendship. This Internet slang term is often used as a humorous reply to a friend’s prank or offensive comment or a joking comment on a friend’s amazing strength that makes you feel sorry for your mediocrity. Yet, sometimes people do mean it when they say to you, “Friendship terminated.”
拉仇恨	lā chóu hèn	v. Pull+hatred. [Gaming terminology] To attract the monsters to attack oneself. As an Internet slang term, it means to deliberately boast or to say potentially offensive things. It typically refers to boasting in ways that could induce jealousy.
自来水	zì lái shuǐ	n. Tap water. This Internet slang term refers to the Internet users who voluntarily post laudatory remarks online to promote a brand. This term was originally used to describe the viewers of Monkey King: Hero’s Back who recommend the movie on the Internet.
灌水	guàn shuǐ	v. Literally “to irrigate,” this Internet slang term is a metaphor for posting tasteless messages online. 
水军	shuǐ jūn	v. Literally “waterborne troops,” this Internet slang term refer to the rumored people hired by PR firms for online marketing purposes. They post online to either support a brand or sabotage the brand’s competition.
黑	hēi	v. To blacken. This Internet slang term means to mock or tease a friend or to bash, malign, or vilify one’s enemy.
狼民	láng mín	n. Wolf+people. Lustful citizens. A nickname for Wallace Chung’s fans 良民 “good citizens”. The nickname was created based on some Wallace fans’ unapologetic vehement admiration for their idol.
贵圈真乱	guì quān zhēn luàn	<Expression> Your distinguished field is so chaotic. This Internet slang term is often used to describe the entertainment industry which is believed to be fraught with unspoken rules regarding power struggle for fame and fortune.
刷屏	shuā píng	v. Paint+screen. To publish several posts on the homepage or News Feeds page on a social media site within a short time, which sometimes exasperates the followers. 被……刷屏 [bèi shuā píng] v. To have the homepage occupied by posts by someone or about a topic.
毒舌	dú shé	adj. [Having an] acid tongue; to be inclined to be make acerbic comments that are likely to hurt people’s feelings. 
壕 (=土豪 )	háo (=tǔ háo)	n. Rich people.. 2) adj. Rich, luxurious. Sometimes this Internet slang term indicates a sense of contempt for the rich people who are uneducated and ill-mannered.
网红	wǎng hóng	n. Internet celebrity, cyberstar. 
业界良心	yè jiè liáng xīn	adj./n. Industry+conscience. Of the industry standard.
怒刷存在感	nù shuā cún zài gǎn	<Expression> Vigorously+swipe+[the] presence [card]. To have a strong presence. To stand out and impress others. This Internet slang term is sometimes used sarcastically.
安利	ān lì	v. As an Internet slang term, the Chinese translation of Amway means “to advertise something or someone that one adores to others, sometimes in defiance of others’ disinterest”. 
累觉不爱	lèi jué bú ài	<Expression> So tired that I feel I will not fall in love anymore. 
虐心	nüè xīn	adj. Abuse+heart. Heart-wrenching.
笑得像钟汉良一样	xiào de xiàng zhōng hàn liáng yí yàng	To laugh as Wallace Chung does. 
魔性	mó xìng	adj. Monster+nature. Having a magical pull, captivating. This Internet slang term is sometimes used sarcastically.
傲娇	ào jiāo	adj. Originated from the Japanese ACG [Anime, Comic and Games] sub-culture, “tsundere” [ツンデレ] describes a person who is initially cold and even hostile towards another person before gradually showing their warm and even coy side over time. Now the term is also used to mean “sassy”.
玛丽苏	mǎ lì sū	n. [Fan fiction terminology] Mary Sue, an idealized character. The male equivalent is Gary Stu or Marty Stu. A a poorly developed female character, too perfect and lacking in realism to be interesting.
真爱粉	zhēn ài fěn	n. True love+fan. Fanatic fans whose love for the idol stands the test of time. They often regard the idol as a mentor and major influence, express their devotion creatively, and strive to become a better person as a result.
前方高能	qián fāng gāo néng	n. Highlights ahead. Originating from the Japanese ACG (anime, comic and games) culture, this Internet slang term asks the readers to pay attention to what comes next. It often precedes a spoiler alert or an interesting fact.
深柜男	shēn guì nán	n. Deep in the closet+male. Homosexual males who haven’t come out. They claim to be heterosexual and sometimes display anti-homosexual attitudes. Some of them date and/marry the opposite sex under social pressure and keep their sexual orientation a secret.
饭随爱豆	fàn suí ài dòu	<Expression> The fans and their idols share similar qualities [in terms of personality and interests]. 
被自己帅醒	bèi zì jǐ shuài xǐng	To be waken up by one’s handsomeness. 
怪我咯	guài wǒ lo	<Expression> My bad? So you think it is my fault? The person who uses this Internet slang term usually doesn’t think he or she is to blame. 
精分	jīng fēn	adj. Short for 精神分裂 [jīng shén fēn liè] schizophrenia. As an Internet slang term, it means showing two or more personalities or being dazzled by a fickle and annoying person or unexpected changes. It is often used humorously.
高冷	gāo lěng	adj. Proud and detached. This Internet slang term is often used to describe someone who is mature, calm, reserved, stern, and aloof. Those qualities can be either enigmatic or annoying, depending on how much you like the person. Sometimes the term is a euphemism for “you cocky bastard”.
落水	luò shuǐ	v. To fall into water. A metaphor for becoming Wallace Chung’s fans. 落水文 [luò shuǐ wén] n. An essay on falling into water—an essay that a new fan wrote about how he or she became a Wallace fan.
LM=良民	liáng mín	n. Wallace Chung aka Zhong Hanliang’s fans—Liang’s people aka good citizens. Their motto is: Get closer to his [Wallace Chung’s] works; stay farther away from his personal life.
萌萌哒	méng méng da	adj. Criminally cute, cuteness overload. 
撕逼	sī bī	v. & n. Tear up+vagina. This sexist Internet slang term originally referred to caustic quarrels between women, but now it has evolved to describe acrimonious disputes or tough competition between people or organizations.
路(人)转粉	lù (rén) zhuǎn fěn	v. Pedestrian+turn+fan. To change from being a pedestrian [nonfan] to being a fan. This Internet slang term is often used by an entertainer’s new fans to describe their conversion or attitude change.
壁咚	bì dōng	v. Wall+slapping sound. Originally “kabe-don” [かべドン] in the Japanese anime, this Internet slang term refers to a man forcing a woman against a wall with one hand OR leaning against a wall, making a slapping sound, and leaving the woman nowhere to go.
逆生长	nì shēng zhǎng	n. Reverse+growth. This Internet slang term is used to describe someone whose appearance (almost) does not show signs of aging over a span of years.
不要不要	bú yào bú yào	<Expression> No! No! This phrase is originally related to Japanese porn movies. 萌得不要不要的 Unbearably cute that it makes you say “No! No!” or “Stop! Stop!”
画风突变	huà fēng tū biàn	A sudden change in the painting style. This Internet slang term is often used to accentuate the contrast between one’s responses in different situations. It also refers to an unexpected twist in the story. Humor is often involved in the context where this term is applied.
画风	huà fēng	n. Painting style. This Internet slang term is often used to describe one’s style in appearance and behavior or the vibes in an environment.
脑洞	nǎo dòng	n. Brain+hole. As an Internet slang term, this is a vivid metaphor for imagination or creativity. 腦洞太大 “Having a super big hole in the brain” renders a person amusingly or ridiculously imaginative and creative. Sometimes this term is used sarcastically.
少女心收割机	shào nǚ xīn shōu gē jī	n. Teen girls’ hearts+harvester. Male actors or singers who captivate female audiences with their good looks and/or talents.
血槽已空	xuè cháo yǐ kōng	<Video game terminology> The blood groove is already empty. Death. This Internet slang term is often used to describe how people are swept off their feet by the pictures of their idols.
取关	qǔ guān	v. Cancel+follow. To unfollow [someone on a social media site].
蠢萌	chǔn méng	adj. Adorkable. Both dorky/silly and adorable. This Internet slang term is used lovingly.
小婊砸	xiǎo biǎo zá	n. <Expletive> A phonetic variation of 小婊子 [xiǎo biǎo zi] “little bitch” with the Beijing accent. 
装13 (=装逼=装B)	zhuāng shí sān (=zhuāng bī)	v. Pretend+vagina.. To aggrandize oneself, to put on a charade of wealth and/or wisdom, to make oneself look richer, more powerful, more intelligent, and more important than he or she really is.
小确幸	xiǎo què xìng	n. Little+definite+happiness. Little things that you can be sure of and will make you happy. Quoted from Haruki Murakami’s book Afternoon of the Islets of Langerhans to refer to transient happiness, this Internet slang term reminds people to be grateful.
腐女	fǔ nǚ	n. Rotten+female. This Internet slang term originated from ふじょし [fujoshi, readers of male-male romance narratives]. In China, it refers to female consumers of TV shows, movies, novels, etc. about BL [Boys’ Love] aka emotional (and sexual) intimacy among young men.
路透	lù tòu	n. & v. street+leak. Though identical with the Chinese translation of Reuters, this Internet slang term refers to spoiler alerts by the fans of celebrities who are working on a reality TV show, movie, etc.
颜值爆表	yán zhí bào biǎo	Maxing out the cute-o-meter. Off-the-charts cute/pretty.
单身狗	dān shēn gǒu	n. Literally “single dog”, this Internet slang term refers to single people who are eager to enter a relationship but find it difficult to achieve the goal. 
新技能	xīn jì néng	n. New skill. This Internet slang term is often followed by “快get” [kuài get] which means “get [the new skill] quickly”. The skills discussed are often inspired by creativity.
男闺蜜	nán guī mì	n. A woman’s male confidante. 
喵星人	miāo xīng rén	n. Meow star folks. Cats, kittes. Dogs or puppies are called 汪星人[wāng xīng rén] woof star folks.
逗逼=逗比	dòu bī	n. Clown, hoot. An amusing person.
你们感受下	nǐ men gǎn shòu xià	<Expression>. 
掰弯	bāi wān	v. To bend [someone]. To turn a heterosexual person into a homosexual. Sometimes this Internet slang term is used to praise a charming person of the same sex.
走心	zǒu xīn	adj. Walk+heart. Going through one’s heart. Sincere, from the bottom of one’s heart, [a project] showing diligence and dedication and moving the reader or the audience.
撕逼	sī bī	v. & n. 1. Fierce verbal fights; 2. Malicious competition or intrigues.
我也是醉了	wǒ yě shì zuì le	<Expression> I’m drunk too/I got wasted too. 
还能不能愉快地玩耍了	hái néng bù néng yú kuài de wán shuǎ le	Expression. 
小鲜肉	xiǎo xiān ròu	n. Little+fresh+flesh. Spring chicken. This Internet slang term refers to teens or young adults who are nice-looking (especially with impeccable skin) and look innocent.
不作死就不会死 (No Zuo No Die)	bù zuō sǐ jiù bú huì sǐ (no zuō no die)	<Expression> If you don’t seek death, you won’t die. If you don’t do stupid things, you won’t suffer. This phrase is often used to comment on crazy behaviors that lead to embarrassment and awkwardness.
感觉自己萌萌哒	gǎn jué zì jǐ méng méng da	<Expression> [I] feel that [I] am such a peach. This Internet slang phrase went popular recently as a way of complimenting oneself or others for being adorable, playing cute, or doing funny things.
得瑟	dé sè	v./adj. To gloat; cocky. 
各种	gè zhǒng	adj. All kinds of. This Internet slang term is usually followed by an adjective.
-_-||=黑线	hēi xiàn	n. Black lines. The emoticon is used to indicate embarrassment.
灰常	huī cháng	~= 非常 [fēi cháng] Gray+usual. Very, extremely.. This Internet slang term is a humorous way of saying 非常 [fēi cháng] “very” with a Fujian accent.
分分钟	fēn fēn zhōng	adv. Literally “every minute”, this Internet slang term means “instantly”. 
小清新	xiǎo qīng xīn	adj. Little+clear+fresh. 1. A music genre marked by artistic, aesthetic, and nonmainstream compositions and/or lyrics. 2. The artistic, aesthetic, and nonmainstream style in literature, movie, and photography. 3. [Of people] adoring simplicity, elegance, serenity, and independence. Sometimes this Internet slang is used with sarcasm.
酱紫	jiàng zǐ	~=这样子 [zhè yàng zi] With this…/doing this.. This Internet slang term mimics the Taiwanese way of saying the phrase 这样子 [zhè yàng zi].
都教授	dū jiào shòu	n. Professor Du, referring to Do Min-joon from the South Korean TV show My Love from the Star which was tremendously popular in China in 2013. 
段子手	duàn zi shǒu	n. Internet joke or quip writer. 
脑残	nǎo cán	adj. Brain+disabled. Literally “brain-damaged”, this slang term is often used to laugh at a person who is ludicrous, dumb, or weird.
基佬	jī lǎo	n. A gay person, a homosexual man. Contingent on the context, this Internet slang term can be either neutral or negative.
这货	zhè huò	n. This dude, often used in causal conversation among Chinese young people. 
奇葩	qí pā	n./adj. Weirdo. Goofy, wacky, zany.
躺枪	tǎng qiāng	v. “Lying down [but still got] shot. ” Short for 躺著也中槍 [tǎng zhe yě zhòng qiāng] “getting shot while lying [on the floor]”, this Internet slang term is used to describe people being criticized or mentioned in an unwanted way even when they deliberately try to avoid it. People mentioned or blamed for what they are not responsible for often use this Internet slang term for self-mockery.
崩溃	bēng kuì	adj. Feeling crushed, having an emotional meltdown. 
悲催	bēi cuī	adj. So sad that it makes you cry. This Internet slang term is often used to describe something that’s shocking, sad and hard to accept.
人生苦短，必须性感	rén shēng kǔ duǎn bì xū xìng gǎn	<expression> Life is short, [one] must be sexy.. This expression is widely used to encourage people to be brave. As 短 [duǎn] “short” rhymes with 性感 [xìng gǎn] “sexy”, I prefer to translate it as “life is short, get some balls.”
笑尿	xiào niào	v. Laugh [so hard that I] wet my pants. 
笑点	xiào diǎn	n. Literally “laughing point,” this slang term refers to how easy it is to make someone burst into laughter. An easily amused person has a low laughing point.
霸气外露	bà qì wài lù	v. To be brimming with swagger. This Internet slang term is sometimes used sarcastically to refer to someone who blatantly violates social norms or makes a showy display of his or her abilities.
冷笑话	lěng xiào huà	n. Cold joke. Similar to brain teasers, cold jokes are funny because they urge the listeners to think outside the box. Homophones, Chinese words with multiple meanings, and linguistic deviations like personification are often included in cold jokes.
高手在民间	gāo shǒu zài mín jiān	<Expression> The maven is among the folks. This sentence is often used to describe the average Chinese people who are capable of jaw-dropping stunts.
