几	少
不	没
没	不
爱	喜欢
喜欢	爱
会	能
能	会
少	几
您	你
两	二
件	块
右边	对
早上	上午
时间	时候
出	来
知道	认识
可以	能;会
要	想
快乐	高兴
对	右边
矮	短
帮忙	帮助
变化	换
差	坏
打扫	干净
担心	着急
短	矮
发现	找
分	分钟
干净	打扫
更	越
还是	还
坏	差
还（动词）	回
换	变化
讲	说
久	长
旧	老
口	嘴
老	旧
了解	懂
马上	对;右边
米	米饭
明白	清楚
拿	起飞
起来	起床
起飞	拿
清楚	明白
认为	觉得
先	第一
小心	手表
一直	总是
又	再
越	更
着急	担心
照顾	看
总是	一直
嘴	口
爱情	爱;喜欢
安排	整理
按时	准时
按照	根据
抱	把;举办;举行
倍	遍;次
比如	例如
遍	时候;趟;倍;次;时间
表示	演出;表演
表演	表示;演出;玩
并且	也
博士	医生;大夫
不过	可是;仍然;而;倒;然而;却
不得不	有;只好;得（助动词）
部分	节
餐厅	饭店
差不多	几乎
尝	味道;试
场	地点
厕所	洗手间;卫生间
乘坐	骑
从来	一直;总是
粗心	马虎
存	节约
答案	回答
打扰	麻烦
大约	关于;对于;左右
戴	穿;提
大夫	医生;博士
倒	仍然;其实;而;却;实在;不过
到底	究竟
地点	场
得（助动词）	有;只好;不得不
等 （动）	等
底	基础
丢	输
对于	关于;大约;左右
对面	相反
而	可是;和;不过;仍然;倒;然而;与;却
发展	长（动词）
放弃	给
份	复印
丰富	富
符合	见面
富	丰富
付款	工资
父亲	爸爸
复印	份
改变	零钱;换;变化
感觉	感情
感情	关系;感觉
感谢	谢谢
干	工作;弄;做
刚	刚才
各	每
工资	付款
关键	重点;钥匙
光	轻;只（副词）
国籍	民族
号码	数量;数字
厚	深
活泼	热闹
火	热
获得	弄;起来;起床
基础	底
激动	兴奋
寄	发
计划	节目;打算
既然	由于;尽管
减少	降低
降低	减少
交	弄;使
接着	其次
结果	因此
节	节日;部分
节约	存
解释	说明
尽管	既然
进行	举办
究竟	确实;到底;终于
举	抬;提
举办	举行;抱;把;进行
举行	抱;把;举办
开玩笑	笑话
开心	快乐;高兴;愉快;幸福
棵	树
可怜	穷
可是	而;不过;然而;却
肯定	自然
理解	懂;了解
力气	优点
例如	比如
俩	两;二
零钱	换;变化;改变
留	离开
旅行	旅游
麻烦	打扰
马虎	粗心
满	饱
毛	头发
美丽	漂亮
民族	国籍
母亲	妈妈
内	在
弄	干;交;使;做;起来;起床;获得
其次	接着
轻	光;轻松
轻松	轻
情况	条件
穷	可怜
取	拿;起飞
却	可是;仍然;而;倒;然而;不过
确实	究竟
然而	而;不过;可是;却
热闹	活泼
仍然	还;而;倒;却;不过;还是
伤心	难过
稍微	一点儿
深	厚
申请	使用
生活	生命
生命	生活
失败	输
十分	非常;极
实在	其实;倒;真
使	引起;弄;交;原因
使用	用;申请
收	受到
收拾	整理
受到	收
输	失败;丢
数量	数字;号码
数字	数量;号码
说明	解释
所有	都
抬	提;举
谈	说话
趟	遍;时候;时间
提	抬;戴;举
条件	情况
挺	很
通过	以
往往	经常
味道	尝
卫生间	洗手间;厕所
相反	对面
消息	信息;新闻
笑话	开玩笑
效果	作用
信息	消息;新闻
兴奋	激动
性格	字
幸福	快乐;高兴;愉快;开心
许多	多
呀	啊
演出	表示;表演
样子	照顾;看
要是	如果
钥匙	关键;重点
也许	或者
以	跟;与;通过
以为	认为;觉得
因此	于是;结果
引起	使;原因
优点	力气
由	从
由于	既然
尤其	专门;特别
愉快	快乐;高兴;幸福;开心
于是	因此
与	和;跟;以;而;对
原因	引起;使
约会	日
阅读	读
咱们	我们
增加	提高
占线	忙
整理	安排;收拾
正确	马上;对;右边
只好	有;不得不;得（助动词）
重点	关键;钥匙
周围	环境
著名	有名
专门	尤其;特别
准时	按时
仔细	注意
自然	肯定
左右	关于;对于;大约
座	座位
作家	作者
座位	座
作用	效果
作者	作家
爱心	同情;恋爱;爱;爱情;喜欢
岸	银行
包含	体现
保存	救;节约;节省;存
报到	登记;挂号;支票;注册
报告	报道
本领	能力
辩论	争论
标志	签;象征
表达	表情;词语
表情	词语;表达
表现	演出;表演
不断	连续
不见得	未必
补充	增加
不然	要不;否则
部门	系
采取	取;拿;起飞
产生	生产
彻底	周到
趁	一会儿
称	命令;叫
称赞	表扬;赞美;夸
承担	承受
承受	承担
程序	手续
成立	出发;建立
持续	坚持;继续
冲	闯;赶
出示	表示;演出;表演
处理	办理;过程
闯	冲;赶
此外	另外
匆忙	急忙
从而	因此;因而
从前	原来;以前
促使	归纳;劝;催
打工	干;干活儿;劳动;作品;工作
待遇	付款;工资
单位	公司;单元
耽误	推迟
淡	浅;光明;轻;清淡;光
道理	理由;原因;实话
登记	挂号;报到;注册
递	交
顶	最
逗	有趣
度过	花（动词）
发表	出版;公布
发达	发挥;生长;发展
发挥	摆;发达;展览;生长;发展
罚款	优美;晴
反而	相反;代替
范围	规模
方式	方法;办法
妨碍	挡
分布	分配
风景	景色
扶	帮助;抱;帮忙;把;举行;举办
复制	复印;份
改进	完善;改善;进步
改正	正确;正
感想	摸;感觉
赶快	赶;就
干活儿	打工
个人	个别;私人
各自	各
公开	开放;睁;公布;开;展开
工业	行业
沟通	交流
乖	良好;好
怪不得	难怪
观念	概念
光滑	顺利
光明	浅;轻;清淡;淡;光
规律	法律;规则;规定
规则	规律;规矩;规定
果实	水果
何必	为什么
合作	配合
恨	讨厌
后背	背
壶	锅
糊涂	慌张
怀念	想念;小姐
慌张	糊涂
灰	灰尘
活跃	主动;活泼;热闹;积极;生动
伙伴	对象
或许	也许;大概;说不定
及格	过（动词）
记忆	回忆
纪录	记录
假如	要是;如果
假装	装
坚强	结实;强烈;坚决;硬;重;浓
艰苦	难;硬
捡	接;摘
简直	干脆
建筑	结构
讲座	教训
浇	水
交换	兑换
交往	关系;感情
教训	讲座;课
接待	受到;收;招待
结实	坚强;重;浓;强烈
节省	保存;救;节约;存
结构	建筑
结合	组合
紧急	迫切
进步	完善;改善;改进
精神	精力
经典	古典
救	保存;节约;节省;存
舅舅	叔叔
具备	有;只好;不得不;得（助动词）
开放	睁;公开;开;展开
砍	切
看不起	轻视
可怕	糟糕
客观	目的
口味	味道;尝
夸	表扬;赞美;称赞
扩大	发展
烂	破
劳动	作品;干;工作;打工
老鼠	鼠标
姥姥	奶奶
理由	道理;原因
立刻	立即
力量	权力
利息	权利;利益
利用	用;用途;使用
连忙	赶紧;及时
列车	培训;训练
临时	暂时
领域	面积
流传	传播
录取	招聘
落后	退步
骂	喊
面对	脸
明确	表明
命令	指挥;叫;称
摸	碰;感觉;感想
某	一定;些;的确
哪怕	即使
脑袋	首
嫩	温柔
年纪	年龄;时代
派	发;寄
培养	文化
配合	合作
平常	平时;通常
平方	方
期待	盼望
启发	鼓舞
气氛	心情;情绪
谦虚	虚心
签	标志
浅	轻;光明;清淡;淡;光
抢	抓
瞧	照顾;样子;看;寻找;当心
巧妙	聪明
亲切	善良
勤奋	刻苦;用功
轻视	看不起
请求	征求
去世	死
权力	力量
劝	催;促使;说服
缺乏	缺少
群	团;组
绕	移动;转;围绕;搬
热心	热情;热烈
人生	生命;生活;日子
人物	文字;字;性格
如何	怎么
嗓子	声音
晒	太阳
商务	企业;生意;商业
伤害	疼;危害
深刻	深;厚
生动	热闹;活跃;活泼
生长	发达;发挥;长（动词）;成长;发展
时代	年纪;年龄;遍;倍;次
实验	测验
事物	东西;对象
手续	程序
首	脑袋
输入	进口
鼠标	老鼠
数据	资料
摔倒	甩;丢
说服	劝
随身	进行
碎	破
台阶	步骤
逃	逃避
淘气	调皮
特色	特征;特点;性质
提倡	促进;宣传;推广;主张
题目	题
体贴	周到
体验	经历
天真	老实
通常	平时;平常
痛快	幸福;愉快;开心;快乐;高兴
突出	优秀;出色
推辞	拒绝
推荐	建议
外公	爷爷
完整	完成
维修	修理
围绕	转;绕
未必	不见得
温柔	轻;嫩;轻松
勿	别
物质	事情
系统	制度
戏剧	播放;表演;玩
显然	明白;清楚
相当	很;挺
想念	怀念;小姐
象征	标志
消极	否定
写作	文字
行为	指挥;举办;进行
形容	描写
形势	条件;状况;情景;情况
形状	形式
虚心	谦虚
宣布	公布
询问	打听
训练	培训;列车
押金	存
样式	风格
夜	晚上
依然	还;仍然;而;倒;却;不过;还是
一旦	曾经;假设
一致	赞成
一再	反复;再三
疑问	怀疑
以来	自从;既然;由于
议论	讨论
硬	坚强;坚决;艰苦
应用	运用;申请;使用
用功	勤奋;刻苦
优势	优点
悠久	长;盼望;久
预防	阻止
运用	应用;申请
在乎	爱护;关心
再三	一再;反复
赞成	批准;一致
糟糕	可怕
造成	使;原因;制作;引起;导致;创造
展开	开放;公开;开;睁
掌握	主人
珍惜	价值;爱惜;重视
阵	前面
睁	开放;公开;开;展开
争取	努力
整个	全部
整齐	整理;收拾
正	直;刚才;正确;刚;改正
支票	报到
指导	辅导
制定	交;使;制作;挣;组成;搞;弄
制造	生产;制作
中旬	中间
周到	彻底;体贴
逐步	逐渐
主持	主人
主任	总裁;导演
抓	抢
转告	告诉
装	安装;假装
状况	状态;形势;地位;情况;情景;条件
追	追求;跑步
资格	条件
资料	信息;数据
姿势	位;位置
自由	空闲
综合	全面
总算	究竟;终于
组成	制定;形式;表格;交;使;构成;制作;挣;搞;弄
爱护	在乎;宝贝;关心
爱惜	珍惜
安装	装
把握	抓紧
摆	发挥;安排;展览
办理	过程;处理
包裹	包
薄	瘦
宝贝	爱护
报道	报告
报社	报纸
背	后背
本质	性质
彼此	互相
毕竟	究竟;到底
便	然后
表明	表示;明确
播放	戏剧;广播;表演;玩
布	衣服
不得了	严重;非常;严肃;十分
步骤	台阶;阶段
参与	参加
测验	实验
曾经	一旦
差距	区别;距离
朝	向
称呼	地址
成果	成绩;成就
成就	成绩;成果
成长	生长;发展;长（动词）
出版	公布;发表
出色	优秀;突出
传播	流传
创造	制作;造成
促进	提倡;宣传;推广
催	劝;促使
答应	同意
打听	询问
呆	留
代替	反而
单纯	简单
单元	单位
当地	地方
当心	手表;小心;样子;照顾;看;瞧;寻找
挡	拦;阻止;妨碍
导演	总裁;主任
导致	造成;引起;使;原因
到达	到
等待	等;等 （动）
的确	一定;确实;某
地位	状况
点心	小吃;零食
钓	鱼
断	违反;破
对象	伙伴;事物
兑换	交换
反复	一再;再三
反映	照;体现;思考
方	平方
非	错
分配	分布
纷纷	陆续
奋斗	挣
风格	样式
风俗	海关
否定	消极
辅导	教练;指导
妇女	女人
改善	完善;改进;进步
盖	被
概念	主意;观念
干脆	简直
干燥	干
感激	感谢;欣赏
感受	感觉;感情
赶紧	连忙
搞	制定;干;交;使;制作;挣;组成;起来;做;弄;起床;获得
格外	尤其;专门;特别
个别	具体;个人
个性	性格
公布	宣布;出版;公开;发表
恭喜	祝贺
构成	组成;表格;形式
古典	经典
鼓舞	启发
股票	份
挂号	登记;报到;注册
拐弯	转
关闭	近;关
观点	看法
广泛	宽
规矩	规则
规模	范围
归纳	促使
锅	壶
哈	呀;啊
海关	风俗
喊	骂
行业	工业
核心	中心
忽然	突然
灰尘	灰
恢复	简历
火柴	比赛
激烈	厉害;强烈
极其	十分;极
急忙	匆忙
记录	纪录
假设	一旦
嫁	结婚
价值	珍惜;重视
坚决	坚强;硬
简历	恢复
建立	成立
交际	交流
教练	辅导
接触	遇到
阶段	步骤
戒指	响
进口	输入
精力	精神
经商	贸易;商业
经营	管理
居然	其实;倒;竟然;实在
具体	个别
开发	发展
看望	参观;游览
课程	过程
刻苦	勤奋;用功
空闲	自由
宽	广泛
拦	阻止;挡;停
朗读	念
老实	天真;诚实
老婆	太太;妻子
类型	种类
冷淡	冷
立即	立刻
利益	权利;收获;利息;好处
连续	不断
恋爱	爱心;爱;爱情;喜欢
良好	乖;好
零件	部分
零食	点心;小吃
陆续	纷纷
毛病	麻烦;打扰
贸易	商业;经商
面积	领域
描写	形容
陌生	奇怪
难怪	怪不得
念	朗读
浓	坚强;结实;重;强烈
盼望	长;悠久;期待;久
培训	列车;训练
碰	摸;符合;见面;迎接
批准	赞成
匹	马
迫切	紧急
期间	时期
其余	休息;别人;歇;在于
企业	商业;生意;商务
强烈	坚强;结实;激烈;重;浓
切	砍
青	绿;年轻
轻易	容易
清淡	浅;轻;光明;淡;光
情景	形势;状况;情况
情绪	心情;气氛
全面	综合
权利	马上;利益;正确;利息;对;右边
热烈	暖和;温暖;热心
日期	约会;日
日子	生命;生活;人生
如今	现在
软	轻
色彩	颜色
善良	亲切
商业	生意;商务;贸易;经商;企业
上当	当
设备	设施
设施	设备
射击	火
升	涨
生产	制造;制作;产生
失去	丢;输
时刻	时候;刻;趟;遍;时间
时期	期间
实话	道理
实践	练习
事先	提前
收获	利益;好处
手指	指
舒适	舒服
甩	摔倒;丢
说不定	或许;也许
思考	反映
私人	个人
所	位置
太太	老婆;妻子
逃避	逃
特征	特点;特色;性质
体现	包含;照;反映
调皮	淘气
土地	降落
团	组;群
推广	提倡;宣传;促进
退步	落后
完善	改善;改进;进步
往返	还（动词）;回
网络	互联网
危害	伤害
微笑	笑
违反	断;破
唯一	光;只（副词）
伟大	重大;棒
位置	姿势;所;座;位;座位
温暖	暖和;热烈
闻	味道
文字	人物;写作;字;性格
屋子	房间
系	部门
显得	出现
显示	展览
相对	亲戚
项目	计划
销售	售货员
歇	其余;休息;在于
欣赏	感激
行动	动作
形式	组成;表格;形状;构成
形象	像
性质	特征;特点;特色;本质
宣传	提倡;推广;促进
学问	知识
寻找	照顾;样子;看;瞧;当心
严肃	严重;不得了
要不	否则;怎么样;不然
移动	绕;搬
遗憾	后悔
乙	秒
意义	意思
因而	于是;因此;从而
印刷	打印
迎接	碰;见面;符合;欢迎
拥抱	抱
用途	用;目的;利用;使用
优美	晴;罚款
游览	参观;看望
预订	书
在于	其余;休息;歇
赞美	表扬;夸;称赞
则	可是;成为;而;却;然而;不过
摘	接;捡
展览	摆;发挥;显示
涨	升
招待	受到;收;接待
真实	真正
针对	目的
争论	辩论
征求	请求;问
挣	制定;使;交;奋斗;制作;组成;赚;搞;弄
直	正
执照	允许
指挥	命令;行为;举办;进行
制度	系统
制作	制定;交;使;造成;制造;生产;挣;组成;创造;搞;弄
中心	核心
种类	班;类型
重大	伟大;棒
逐渐	逐步
主动	积极;活跃
主人	掌握;主持
主张	提倡;意见
注册	登记;挂号;报到
抓紧	把握
转变	零钱;换;变化;改变
状态	状况;条件
追求	追
资金	首都
自从	以来;既然;由于
自豪	骄傲
总裁	主任;导演
组	团;群
组合	结合
阻止	拦;挡;预防
最初	第一;先
尊敬	尊重
作品	劳动;干;工作;打工
挨	推迟;熬;拖延;忍受;受罪;延期;耽误;接着;其次
暧昧	含糊;模糊;隐约
安宁	安详;沉着;平静;镇定;镇静
安详	沉着;安宁;平静
安置	摆;包装;布置;筹备;搭;安排
暗示	建议;含义;倡议;提议;提示;示意
案件	事故
案例	盒子
按摩	揉
昂贵	贵
熬	遭受;挨;忍受;受到;受罪
奥秘	秘密;机密
扒	挖掘;条;拉;拨;攀登;牵;掏;撤退
巴不得	长;渴望;盼望;久;思念;期待;展望;悠久;向往
巴结	讨好
把手	办理;处置;辫子;对付;处理
霸道	坚强;结实;强烈;坚固;健全;重;浓;扎实
罢工	打击;敲
摆脱	解除;排除;脱离;除;清除
拜访	访问;呼吁;看望
败坏	糟蹋;摧残;毁灭;腐败
颁布	发布;发表;课题;散发;发行;宣扬;颁发
颁发	发布;颁布;发表;课题;散发;发行;授予
版本	发布;释放;发行
伴侣	伙伴;搭档;对象;配偶
伴随	跟随;陪;盘旋;触犯;去;盯;遵循
扮演	举动;演习;充当;玩意儿
榜样	模型;模特;典型;模范;塑造;比方
包庇	港口;扣;覆盖;掩护;掩盖;盖;被
包袱	分量;锤;重量
包围	围绕
包装	制定;交;使;制作;安置;捏;包裹;挣;组成;化妆;补偿;搭;包;打包;搞;弄
保管	保障;确保;自然;担保;留神;维护;肯定;处置;关照;保卫;保证;当心;捍卫
保姆	护士;哺乳
保守	维持;遮挡;防止;守护;保持;捍卫
保卫	辩护;保障;维护;辩解;防守;保管;捍卫
保养	认定;维修;维护;维持;保持
保障	确保;担保;维护;保卫;保管;保证;捍卫
抱负	野心;志气
报仇	报复
报酬	奖励;奖赏
报答	偿还;回报
报复	回报;报仇
报销	擦;除
爆发	违反;粉碎;分裂;磨合;折;破;迸发;断;断绝;爆炸;中断
爆炸	爆发;打击;吹
曝光	暴露;揭露
暴力	逼迫;动力;剧烈;猛烈;强迫
暴露	曝光;流露;揭露;展示
卑鄙	意味着;基地;残忍;吝啬;底;小气;基础
背叛	辜负
本钱	资产;首都;资本;资金
本人	私自;个人;人家;我;私人
本事	本领;手法;技术;才干;能力;技巧
笨拙	尴尬;别扭;愚蠢;拘束;笨
崩溃	倒闭;解体;塌;瓦解
蹦	跳跃;踊跃;飞跃
迸发	爆发
逼迫	强迫;动力;暴力
比方	榜样
比重	比例
鄙视	蔑视;看不起;藐视;轻视;唾弃
臂	胳膊;武装
弊病	贼;弊端
弊端	糟蹋;弊病;虐待
闭塞	将近;濒临;关闭;跟前;截止;拦;阻拦;近;堵塞;终止;亲密;刹车;停;偏僻;精密;制止
编织	创作;制作;造成;辫子;创造
边界	境界;界限;边境
边境	边界
边缘	周边;界限
扁	平坦;平
贬低	蔑视
遍布	浑身
便利	方便;轻;便于
便于	方便;轻;便利
变故	事故;意外
变质	腐朽;恶化
辩护	维护;辩解;防守;保卫;捍卫
辩解	辩护;解释;维护;说明;交代;防守;保卫;捍卫
辩证	探讨;审查;考察;追究
辨认	认定;分辨;鉴别;区分;鉴定;识别
辫子	编织;办理;把手;处置;排队;对付;处理
标本	品尝;样品
标记	符号;标志;签;手势;登录;痕迹;迹象;签署;象征
标题	题目;称号;科目
表彰	名誉;尊严;引用;表扬;面子
憋	算数;抱;克制;把;压制;举行;容纳;占领;遏制;拘束;约束;举办;占据;盛;扶
别墅	帐篷
别致	空前绝后;唯独;特殊;反常
别扭	笨拙;难;尴尬;艰苦;难受;艰难;拘束
濒临	将近;跟前;关闭;截止;近;亲密;闭塞;精密
冰雹	种子
并列	平行
拨	支配;扒;批;配备
波浪	挥;飘扬
剥削	开拓;开采
搏斗	打架;战斗;斗争;拼搏;挣扎;争取;奋斗;挣;掐;争夺
伯母	阿姨
薄弱	脆弱;弱
不顾	计较;无论
不料	恰巧;竟然;愣;居然
不像话	岂有此理;震撼
补偿	赔偿;制定;交;使;包装;制作;捏;挣;组成;化妆;搞;弄
补救	弥补;挽救
补贴	资助
哺乳	保姆;护士
捕捉	染;抓;攻克
不得已	无奈;不得不;拥有;有;只好;得（助动词）;具备;必须;务必
不禁	不由得
不堪	十分;贼;极其;要命;极;彻底;无比;万分
不免	未免;难免
不时	时常;经常;往往;频繁
不由得	不禁
布告	宣布;发布;通知;须知;公告;启事;公布
布局	批发;整理;格局;分布;孔;布置;分配;作文;安排;条理
布置	布局;摆;整理;安置;筹备;清理;装饰;修理;奠定;点缀;部署;安排;条理
步伐	台阶;步骤
部署	布置;处置
部位	窝;姿势;立场;所;局部;位置;场所;节;方位;寄托;搁;位;职位;职务;阵地;部分;零件;片断
才干	本领;天才;天赋;本事;能力
财政	金融
裁判	华侨;领袖;判断;判决
采集	集合;收;收藏;收获;拾
采纳	将就;接受;服气;采取
参照	指
残酷	残忍
残留	剩;遗留;仍旧;多余
残忍	意味着;残酷;吝啬;卑鄙;小气
灿烂	辉煌;英明;高明;光辉;卓越;美妙
仓促	匆忙;连忙;赶紧
操劳	模样;神态;气色;照顾;力争;样子;东张西望;看;寻觅;瞧;寻找;关照;目光;当心
操练	演习;实践;练习
操纵	治理;克制;控制;节制;支配;牵制;经营;操作;监督
操作	运算;操纵;干;打工;作品;劳动;经营;手术;致力;工作;事务
嘈杂	吵
草案	制定;拟定;起草
草率	马虎;粗心;胡乱;大意
策划	计划;打算;工程师;情节;规划;阴谋
策略	政策;方针;战术
测量	认定;调查;断定;确定;分量
侧面	局面;方面
层次	阶段;淘汰;局面;步骤
差别	误差;信誉;差距;区别;分歧;卓越
查获	揭露
岔	枝;拐弯;转;折;分歧;支;中断
诧异	惊讶
搀	赞助;混合;遭受;夹杂;混淆;支撑;串;拥护;搅拌;支援;携带;做主;支持
馋	贪婪
缠绕	绕;打扰
产业	工业;行业;资产;财产
阐述	敷衍;对待;精心;处置
颤抖	摇;晃;震撼;哆嗦;颠簸;发抖
昌盛	兴旺;隆重;兴隆;繁荣
尝试	试;企图;尝;审理;试图
偿还	报答
场合	局势;格局;形势;状况;情况;事态;时机;地步;局面;情形;场面;情景
场面	场合;现场;镜头;风光;时机;情景
场所	窝;所;位置;寄托;搁;部位;地点
敞开	开放;睁;公开;瞪;开辟;开阔;开展;开;展开
倡导	提倡;倡议;传授;提议;主张;启蒙;创业
倡议	暗示;建议;传授;提议;倡导;启蒙;创业
超越	超过
潮流	当前;趋势;倾向;动态
嘲笑	讥笑;开玩笑
巢穴	窝
撤退	退;扒;拉;牵;拽
撤销	废除
沉淀	和解;奠定
沉闷	压抑;沮丧;沉重;重;忧郁
沉思	琢磨;思索;思考
沉重	严重;大不了;正经;坚固;严肃;沉闷;艰苦;郑重;艰难;重;硬;不得了;坚硬;严峻
沉着	稳定;安详;安宁;坚定
陈列	摆;展示;显示;发挥;展览;施展
陈述	宣布;境界;状态;局势;状况;提;州;提示;呈现;当前;申报;送;地步
衬托	着手;镶嵌;成立;树立;设置;出发;设立;开辟
称心如意	随意
称号	标题;名字
盛	算数;抱;蕴藏;把;举行;容纳;占领;遏制;憋;举办;勺子;占据;扶;包含
乘	趁;乘坐;骑;使用
承办	承包
承包	合同;承办;收缩
承诺	答应;出息
成效	效果;结晶;成果;功效;作用;致使
成心	故意;斟酌
惩罚	制裁;处分;处置
诚挚	认真;诚恳;恳切;衷心;踏实;真挚
澄清	清楚;清晰;清理;明白;清澈;显然
呈现	展现;显得;出现;示范;提示;示威;陈述;送;当前
吃苦	承受;苦;忍受;生育;受罪;承担
迟钝	迟缓
迟缓	迟钝;慢
迟疑	犹豫;徘徊
持久	执着;固执;为期;一贯
赤字	亏损
冲动	声势
冲击	震撼;袭击;震惊;进攻;攻击;打击
冲突	摩擦;争端
充当	担任;扮演;作为
充沛	丰富;丰满;神气;朝气蓬勃;雄厚;富裕;充足
充实	富;丰富;丰满;油腻;雄厚;实惠;丰盛
充足	丰富;雄厚;富裕;充沛
崇高	壮观;壮丽;雄伟;耸;高尚
崇敬	尊重;瞻仰;尊敬
重叠	复制
筹备	摆;准备;布置;安置;安排
稠密	浓厚;浓;厚
丑恶	可恶;丑;庸俗
出身	出生
出息	良好;精通;前景;好;乖;前途;未来;拿手;答应;承诺
初步	最初
除	解除;拆;消灭;报销;消除;分裂;淘汰;排除;摆脱;除了;划分;排斥;间隔;清除;擦
储备	商店;储存
储存	商店;储备
储蓄	救;保存;银行;岸;节省;存;挽救;畔;挽回;节约;攒
处分	制裁;惩罚;处置
处境	地步
处置	惩罚;阐述;制裁;对待;留神;办理;处理;把手;处分;关照;辫子;部署;保管;对付;当心
触犯	伴随;违反;盘旋;去;冒犯;侵犯;得罪;违背
穿越	克服;交叉;及格;过（动词）
传达	转达;遗传;传授;转告
传授	倡议;转达;教;传达;倡导;启蒙;创业
串	漂浮;混合;混淆;夹杂;搀;流浪;搅拌
创立	确立;起源;成立;树立;奠定;设立;建立
创业	雕塑;雕刻;倡议;传授;倡导;启蒙
创作	编织;制作;造成;生产;抹杀;产生;著作;写;创造
吹牛	夸;聊天
吹捧	过奖;捧
锤	分量;包袱;重量
纯粹	清真;单纯;纯洁
纯洁	清真;提炼;单纯;纯粹
慈祥	和蔼;仁慈;慈善
慈善	仁慈;慈祥;宽容
刺	扎
次序	指令;顺序;条理
伺候	等候;等待;等;等 （动）
丛	束
粗鲁	粗糙
窜	逃
摧残	糟蹋;毁灭;败坏
脆弱	薄弱;弱
磋商	交涉;协商;谈判;咨询;授予;请教
挫折	麻痹;扭转;将军;颠倒;失望;周折;秃;征服;遏制;清理;刹车;支票;打击;制止;制服;报到;对照
搭	取;增添;悬挂;包装;安置;开辟;增加;补充;起飞;拿;修建;比赛;建设;火柴;攻克;吊;搭配;沟通;挂;采取;统计
搭档	对象;合伙;伙伴;伴侣;合作
搭配	比赛;搭;火柴
答辩	答案;答复;回答;响应
答复	答案;答辩;回答;响应
达成	抵达;达到
打包	包装
打官司	纠纷;争端;是非;争议;投诉
打击	冲击;周折;殴打;吹;砸;袭击;敲;进攻;罢工;攻击;爆炸;撞;挫折
打架	战斗;斗争;搏斗;殴打;争取;掐;争夺
打量	合算
大不了	严重;正经;严肃;沉重;郑重;不得了;严峻
大伙儿	大家;诸位
大肆	肆无忌惮
大体	差不多;大致
大意	马虎;粗心;草率;胡乱
大致	大概;大约;差不多;左右;大体
歹徒	流氓;无赖
带领	领先;引导;婴儿;向导;主导;引起;导向;导致;率领
代价	耗费;价格
逮捕	扣
怠慢	疏忽;忽视;忽略
担保	保障;确保;保管;保证
胆怯	恐惧;害怕;胆小鬼;畏惧
诞辰	生日
诞生	出生
当初	原先;本来;当时;起初;原来;原始
当前	现代;提示;呈现;送;陈述;潮流
当事人	聚会;党;客户
当选	展现;出;问世;来
党	当事人;俱乐部;协会;联想;棍棒;聚会;社会
档案	纪录;文件;记载;记录
档次	平坦;等级;品质;水平;班;级别;年级;种类;质量
倒闭	解体;封闭;瓦解;崩溃;破产;塌
导航	航行
导向	向导;带领;倾向;引导
捣乱	骚扰;打扰;扰乱;惊动
盗窃	偷
得力	能干;智能
得罪	触犯;冒犯
蹬	踩
登陆	土地;降落
登录	符号;登记;标志;挂号;签;手势;迹象;标记;签署;报到;注册
等候	伺候;等待;等;等 （动）
等级	速度;档次;程度;级别;年级
瞪	开放;睁;公开;敞开;开辟;开阔;盯;开展;凝视;开;展开
敌视	对抗;立足
抵达	达成;降临;达到;到;到达
抵抗	抵制;反抗;对抗
抵制	推辞;否决;反抗;排斥;对抗;抵抗;拒绝
地步	境界;场合;状态;处境;局势;格局;形势;状况;州;制约;情况;事态;局面;幅度;情形;陈述;情景;条件
地势	形势
颠簸	摇;碰;晃;震撼;颤抖
颠倒	扭转;疯狂;糊涂;慌张;挫折
点缀	装饰;布置
典礼	仪式
典型	模型;榜样;模特;代表;模范;塑造
奠定	确立;成立;和解;创立;树立;布置;修理;设立;建立;沉淀
惦记	想念;思念;怀念;小姐
雕刻	雕塑;创业
雕塑	雕刻;创业
吊	挂;搭;悬挂
调动	转移;装卸;转让;机动
跌	坠;滴;掉;衰退
丁	男人
盯	注视;伴随;跟随;瞪;目光;凝视;遵循
叮嘱	劝;催;促使;激励
东张西望	模样;神态;操劳;气色;照顾;样子;看;寻觅;瞧;寻找;关照;目光;当心
栋	幢;建筑
冻结	冻;凝固
动机	意图;动力;激励;心眼儿;机动;内涵;意向
动静	举动;动作;行动;动态
动力	逼迫;激励;权力;动机;暴力;强迫;力量;势力
动身	离开;留
动手	摸;碰
动态	举动;发育;开发;趋势;行动;潮流;倾向;动作;发展;动静
动员	激发;鼓动;发动
陡峭	浸泡
斗争	打架;战斗;战役;拼搏;搏斗;挣扎;争取;奋斗;挣;掐;争夺
堵塞	拦;截止;阻拦;终止;挡;阻碍;刹车;闭塞;阻止;停;制止
杜绝	消灭
端	实施;端正;正规;事项;携带;开展;实行;扛;戴;贯彻;梢;终点;提;结束;执行;港口;完毕;挎;落实
端正	妥当;正;妥善;正经;更正;正当;端;正确;纠正;正规;改正
断定	身材;测量;认定;肯定;确定;断绝
断绝	身材;爆发;违反;粉碎;分裂;磨合;肯定;破;折;断;断定;中断
堆积	堆;积累
对付	办理;把手;处置;应付;辫子;处理
对抗	立足;抵制;敌视;反抗;抵抗
对立	反对
对应	相应
对照	将军;比较;对比;遏制;清理;刹车;支票;制止;制服;报到;挫折
兑现	现金
队伍	行列
顿时	即便;忽然;随即;就;立刻;突然;立即;赶快
哆嗦	发抖;颤抖
额外	多余
恶化	变质
遏制	将军;克制;蕴藏;清理;容纳;刹车;约束;憋;拘束;支票;盛;制止;制服;包含;报到;挫折;对照
恩怨	嫌
发布	宣布;颁布;分散;布告;发表;版本;分布;课题;散发;发行;分配;释放;颁发;公布
发呆	空想
发动	激发;动员;鼓动;发射;开展;开辟
发觉	发现;找
发射	射击;发动;解雇;放;排放;释放;散发;开展;火
发行	发布;颁布;分散;公布;发表;版本;分布;刊登;课题;释放;散发;分配;颁发;出版
发扬	开拓;发达;发挥;发育;演变;开展;生长;发展
发育	开拓;动态;发达;发挥;演变;成长;开发;开展;生长;发展;发扬
法人	集团
番	善良;仁慈;轮流;时刻;时候;趟;亲切;和气;些;某;遍;时间
繁华	欣欣向荣;忙碌;繁荣;繁忙
繁忙	忙;忙碌;占线;繁华
繁殖	孕育;培育;传播;品种
凡是	各;所有;每;都;统统
反常	别致;异常;特殊
反感	嫌;讨厌
反抗	抵抗;对抗;抵制
反面	对方
反射	反映;反思;照;体现;思考
反思	反射;反映;考核;复习;照;体现;回顾;思考;检讨
反问	过问;索取;问;征求
反之	反而;鉴于
范畴	类型
贩卖	交通;卖;推销
方位	神态;姿势;立场;方向;位置;位;职务;阵地;部位;职位
方针	政策;策略
防守	辩护;维护;保护;辩解;防御;守护;保卫;捍卫
防御	防守
防止	保守;预防;守护;阻止;戒备;捍卫
访问	参观;拜访;看望;探望;呼吁;游览
放大	扩充
放射	辐射
飞翔	航班;航行;飘扬
飞跃	跳跃;蹦;踊跃
诽谤	糟蹋;污蔑
废除	撤销
分辨	辨认;鉴别;区分;志气;识别;分解
分解	分辨;志气
分裂	爆发;违反;断绝;粉碎;磨合;折;破;划分;除;断;间隔;中断
分歧	误差;岔;差距;区别;差别
分散	发布;分布;散发;发行;分配
吩咐	指令;指示;指挥;告诉;关照;嘱咐;转告;命令;率领
坟墓	庄重
粉末	灰尘;灰
粉色	白
粉碎	爆发;违反;中断;分裂;磨合;折;破;扣;砸;断;断绝;撞
分量	测量;锤;包袱;重量
风度	神态;神气
风光	风景;伟大;庄重;见解;现场;威风;镜头;景色;厉害;隆重;看待;壮观;雄伟;目光;场面;宏伟;情景
风气	气氛
风趣	机智;逗;幽默;伶俐
封闭	局限;倒闭;封锁;密封
封锁	密封;封闭
丰满	富;丰富;充沛;油腻;充实;雄厚;丰盛
丰盛	富;丰富;丰满;油腻;充实;雄厚
锋利	尖锐;灵敏;敏锐;急剧
否决	抵制;排斥;拒绝
夫人	太太;女士
敷衍	表演;阐述;戏剧;玩弄;精心;玩;耍;播放
幅度	规模;地步;范围
服从	延期;拖延;遵循;遵守
服气	接受;采纳;将就;确信
符号	标志;签;手势;登录;痕迹;迹象;标记;签署;象征
辐射	放射
腐败	腐蚀;腐朽;贪污;败坏;烂
腐烂	腐蚀
腐蚀	腐烂;生锈;贪污;腐败
腐朽	变质;烂;腐败
辅助	赞助;协助;附属;副
抚养	抬;教养;举;饲养;提;翘;培养;耸
抚摸	宠物
俯视	疏忽;忽略
富裕	丰富;雄厚;充足;充沛
副	次要;助理;助手;附属;辅助
覆盖	扣;包庇;掩护;掩盖;盖;被
附件	执着
附属	执着;下属;辅助;副
复活	振兴;复兴
复兴	复活;振兴
赋予	给予;委托;放弃;指定;屈服;给;让步
改良	完善;改善;改进;进步
干旱	干燥;干
干扰	障碍;干涉
干涉	干预;干扰
干预	干涉
尴尬	笨拙;难堪;别扭;拘束
感慨	感受;感觉;感情;滋味
感染	熏陶;影响;势力;传染
干劲	驾驶;志气;魄力;驱逐
纲领	节目;计划;方案;规划
港口	端;包庇
岗位	职务;公告;职位
高超	优秀;庄重;显著;优异;杰出;出色;突出;卓越
高潮	高涨;掀起
高峰	个子
高明	心灵;鲜明;辉煌;机灵;英明;上级;亮;灿烂;明智;光辉;优越
高尚	耸;崇高;贵族
高涨	掀起;高潮
告诫	警告;井;警惕
搁	窝;所;位置;场所;寄托;部位
疙瘩	周折;课题;扣
隔阂	疏远
隔离	孤立
格局	布局;局势;局面;结构;状况;机构;款式;事态;图案;情形;样式;地步;建筑;场合;形势;情况;情景;模型;形态
格式	规范;表格;形式;构成;形态;组成;规格
个体	个别;个人
根源	来历;来源;根
跟前	将近;濒临;关闭;截止;近;附近;亲密;闭塞;精密;就近
跟随	伴随;遵循;盯
跟踪	尾巴;执行;运行;踪迹;影子;跑步;追
更新	装修
更正	正;纠正;正确;端正;改正
公道	司法;公正;公平;正当;正义
公告	布告;职务;须知;岗位;启事;通知;职位
公正	恰巧;索性;正;刚才;公平;正当;刚;唯独;公道
供给	配备;提供
功劳	贡献;荣誉
功效	成效;作用;效果
攻击	冲击;谴责;袭击;进攻;闯;指责;打击
攻克	取;征服;捕捉;起飞;拿;采取;搭
巩固	整顿;综合
共计	归纳;总和
构思	图案;设计;华丽;款式
孤独	寂寞
孤立	隔离
辜负	背叛
姑且	暂时;暂且
股份	股票;份
鼓动	激发;动员;发动;挑拨;搅拌
固然	当然
固体	牢固;坚实;立体;扎实;坚硬
固有	内在
固执	倔强;执着;一贯;持久;顽固
顾虑	疑惑
故乡	家;家乡;祖国
故障	缺陷;毛病;误差;缺点;障碍;偏差;过失;错误;失败
雇佣	租赁;招收;使用
关怀	周到
关照	处置;告诉;瞧;寻觅;目光;提醒;模样;留神;嘱咐;当心;操劳;气色;照顾;吩咐;寻找;转告;保管;东张西望;神态;样子;看
官方	政府;治理
观光	参观
管辖	治理;规律;节制;统治;规定;支配;规章;规则
罐	能;可以;会;壶;锅
贯彻	扛;戴;执行;履行;提;挎;端;实施;携带;开展;实行;落实
惯例	习俗
光彩	光芒;光辉
光辉	辉煌;高明;英明;光彩;灿烂;光芒;壮丽;荣誉;宏伟;雄伟
光芒	光彩;光辉;照耀
广阔	宽;辽阔;宽敞;开阔
规范	指标;格式;调节;规定;标准;准则;规格;规章
规格	规范;指标;格式;准则;标准
规划	节目;计划;纲领;打算;策划
规章	规律;规范;章程;统治;管辖;规定;规矩;规则
轨道	盘旋
贵族	君子;高尚
棍棒	党;俱乐部
果断	坚强;牢固;坚固;坚决;硬;扎实;坚定
过度	奢侈;过期;荒唐;挥霍;过分
过渡	转折
过奖	吹捧;捧
过滤	筛选
过失	缺陷;毛病;故障
过问	索取;问;征求;反问
过瘾	趣味
含糊	模糊;隐约;暧昧
含义	暗示;意思;意义;提示;内涵;示意
捍卫	辩护;保障;保守;维护;辩解;防止;守护;防守;保卫;保管
航行	飞翔;导航;飘扬
行列	队伍
豪迈	开朗;开明;英勇;壮烈;虚心
毫无	无;完全
号召	命名;称;叫;呼吁;命令
耗费	糟蹋;消耗;花（动词）;度过;浪费;支出;代价
呵	哎;哦
和蔼	仁慈;善良;亲切;和气;慈祥
和解	调和;调节;妥协;结算;奠定;沉淀
和睦	和谐;融洽;调和
和气	善良;仁慈;友好;亲切;和蔼;斯文;礼貌;番
和谐	和睦;融洽;调和
合成	构成
合伙	合作;搭档
合算	打量;计算;屑
嘿	喂（叹词）
痕迹	符号;标志;踪迹;迹象;标记
狠心	冷酷
哼	呻吟
哄	骗;喧哗
宏伟	庄重;风光;隆重;壮观;壮丽;雄伟;光辉;伟大
洪水	淹没
喉咙	嗓子
忽略	疏忽;忽视;俯视;怠慢
呼唤	喊;嚷
呼啸	哨
呼吁	号召;访问;拜访;看望
胡乱	马虎;大意;任意;粗心;草率;随意
华丽	图案;设计;构思;款式
华侨	领袖;裁判
化妆	制定;交;使;包装;制作;捏;挣;组成;补偿;搞;弄
划分	分裂;除;间隔
话筒	麦克风
欢乐	幸福;舒畅;快活;痛快;愉快;开心;快乐;高兴;喜悦;美满;乐趣
环节	联络;片断
缓和	节制;缓解;温和
荒凉	冷落;凄凉;偏僻
荒谬	荒唐;岂有此理
荒唐	岂有此理;荒谬;过度
黄昏	傍晚
晃	颠簸;摇;震撼;颤抖
挥霍	奢侈;敏捷;过度;潇洒;灵活
辉煌	英明;高明;灿烂;壮丽;光辉;卓越;美妙
回报	报复;回;报答;还（动词）;往返
回避	避免;逃避
回顾	反思;复习;考核;检讨
回收	愈;恢复;挽回
悔恨	遗憾;后悔
毁灭	摧残;糟蹋;灭亡;销毁;破坏;败坏
会晤	碰;见面;会议;遭遇;符合;迎接
汇报	申报;报告;报道
荤	庸俗
浑身	遍布
混合	混淆;夹杂;搀;串;搅拌
混乱	混淆;乱
混淆	混合;夹杂;搀;迷惑;串;混乱;搅拌
混浊	脏
活该	应该
活力	生机;气势;精神;能量;精力
货币	通用;钱
基地	基础;卑鄙;底
机动	塑造;动机;调动;灵活
机构	结构;制度;格局;团体;组织;建筑
机灵	心灵;伶俐;英明;高明;巧妙;灵敏;机智;聪明;明智
机密	秘密;奥秘
机械	机器
机遇	时机;机会
机智	伶俐;心灵;风趣;机灵
激发	动员;启发;发动;鼓舞;鼓动;耸;振奋
激励	动力;劝;叮嘱;促使;勉励;鼓励;催;动机
激情	热情;热心
讥笑	嘲笑
极端	深沉
极限	局限;限制;约束;界限;制止
即便	随即;顿时;哪怕;即使;立刻;立即
级别	平坦;等级;档次;年级;水平
嫉妒	恨;厌恶;讨厌;羡慕
及早	尽快
急剧	尖锐;迅速;锋利;灵敏;敏锐
急于求成	急躁
急躁	不耐烦;迫不及待;急于求成
集团	团;法人;组;群;派别;团体
吉祥	幸运
给予	展现;表演;放弃;展示;表示;演出;屈服;给;出示;赋予;炫耀;让步;符合
寄托	窝;所;位置;场所;搁;部位
继承	随身;进行
记性	回忆;记忆
记载	纪录;档案;记录
季度	季节
计较	吵架;较量;不顾;无论
寂静	安静;沉默;鸦雀无声
技巧	技术;手法;本事
迹象	符号;标志;签;手势;登录;痕迹;标记;签署
加工	运行;办理;过程;提炼;处理
加剧	恼火
夹杂	混合;混淆;搀;串;搅拌
煎	油炸
坚定	坚强;牢固;坚固;稳定;沉着;踏实;坚决;果断;硬;扎实
坚固	霸道;艰苦;沉重;重;坚定;结实;强烈;牢固;健全;坚决;浓;坚强;毅然;稳定;艰难;果断;硬;扎实;坚硬
坚韧	顽强
坚实	牢固;固体;立体;扎实;坚硬
坚硬	牢固;坚实;固体;坚固;艰苦;立体;沉重;艰难;硬;扎实
监督	治理;操纵;克制;控制;节制;支配;牵制;考察;检查;检验
尖端	最好
尖锐	强烈;激烈;锋利;剧烈;灵敏;敏锐;急剧
艰难	难;别扭;坚固;艰苦;沉重;硬;坚硬
拣	摘;捡;接;掐;拾
检讨	反思;复习;回顾;考核
检验	实验;试验;审查;考验;考核;测验;检查;考察;监督
简化	精简
简要	总而言之;总之
溅	泼
鉴别	分辨;区分;辨认;识别
鉴定	考核;认定;评估;辨认;评价
鉴于	反之
间隔	分裂;缺口;除;划分
见解	意见;风光;主张;看待;目光
见闻	知识;资料;学问;信息
健全	坚强;结实;霸道;强烈;坚固;重;浓;扎实
将近	濒临;关闭;跟前;截止;近;亲密;几乎;差不多;闭塞;精密
将军	遏制;清理;刹车;支票;制止;制服;普遍;报到;挫折;对照
将就	接受;采纳;服气;容忍
桨	划
奖励	报酬;奖赏
奖赏	报酬;奖励
降临	成为;抵达;到;降落;到达
交叉	穿越
交代	递;交;解释;完;辩解;完毕;说明;明确;提示;坦白;表明
交涉	磋商;谈判
焦点	重心;重点;集中
娇气	嫩;精致;细致
搅拌	混合;混淆;夹杂;搀;串;鼓动
缴纳	工资;付款;开支;待遇;支出
教养	培训;抚养;列车;斯文;文化;教育;训练;培育;培养;孕育
较量	竞争;计较
接连	连续;纷纷;陆续
揭露	曝光;暴露;查获;透露
节奏	旋律;揍;拍;殴打
节制	治理;缓和;操纵;克制;温和;控制;调剂;管辖;制约;支配;牵制;拘束;约束;束缚;监督
杰出	优秀;高超;显著;出色;突出;卓越
结晶	成效;成果;致使
结局	结论
结算	和解
竭尽全力	拼命
截至	以致;上;为期;以至;凭
截止	将近;濒临;关闭;跟前;拦;阻拦;近;堵塞;终止;亲密;期限;刹车;闭塞;停;精密;制止
解除	抬;缓解;举;解雇;拆;空闲;消除;排除;摆脱;除;排斥;清除;掀起;自由
解放	释放
解雇	射击;解除;发射;火
解散	融化;溶解
解体	瓦解;倒闭;崩溃;塌
戒备	防止;惊动
界限	局限;境界;极限;边界;限制;边缘;约束;制止
金融	财政
紧迫	迫切;紧急
进攻	冲击;扑;袭击;攻击;打击
进化	演变
进展	演变;上进;相处
近来	最近;一向
浸泡	沐浴;陡峭
精华	灵魂;本质;实质
精简	简化;降低;减少;凝聚
精密	将近;濒临;关闭;跟前;截止;精确;近;确切;亲密;斯文;闭塞;精致;准确;文雅
精确	精密;准确;确切
精通	良好;熟练;乖;好;出息;拿手;主人;掌握
精心	无微不至;阐述;罚款;一丝不苟;精致;细致;晴;优美;敷衍;详细
精致	嫩;娇气;斯文;罚款;精心;细致;晴;优美;精密;文雅
经费	心血;开支;资金
经纬	要点
惊动	骚扰;打扰;捣乱;戒备;扰乱
惊奇	吃惊
惊讶	吃惊;了不起;诧异
井	警告;告诫;嗯;警惕
警告	井;告诫;警惕
警惕	警告;井;告诫
境界	状态;局势;边界;状况;州;界限;陈述;地步
竞赛	种族;竞争
镜头	现场;场面;风光;情景
纠纷	争端;争议;是非;打官司
纠正	正;更正;正确;端正;改正
酒精	掠夺
就近	跟前;附近
就职	上任
拘留	滞留
拘束	笨拙;尴尬;别扭;克制;节制;难受;制约;遏制;牵制;约束;憋;束缚
居民	居住
居住	居民
局部	地方;当地;部位;零件;部分
局面	场合;局势;格局;形势;状况;淘汰;层次;情况;步骤;事态;侧面;地步;情形;方面;情景
局势	境界;场合;状态;格局;形势;状况;州;情况;事态;局面;地步;情形;陈述;情景
局限	极限;封闭;限制;约束;界限;制止
举动	演习;动作;动态;玩意儿;搬;挪;运行;事业;移动;行动;绕;扮演;活动;迁徙;动静
沮丧	泄气;忧郁;沉闷
剧烈	尖锐;激烈;敏锐;厉害;猛烈;暴力;严厉;凶恶;严峻
卷	册;体积;滚
觉悟	意识;知觉
倔强	执着;固执;顽固
君子	绅士;贵族
卡通	漫画;动画片
开采	提炼;开拓;剥削
开除	驱逐
开阔	开放;宽敞;睁;公开;敞开;瞪;开辟;开展;广阔;宽;开;展开
开朗	开明;快活;乐观;愉快;豪迈;虚心
开明	开朗;启蒙;豪迈;虚心;启示
开辟	发动;着手;衬托;镶嵌;成立;睁;公开;开展;修建;展开;开放;建设;树立;瞪;出发;搭;开阔;开;设置;设立;敞开
开拓	发达;发挥;开采;剥削;发育;演变;开展;生长;发展;发扬
开展	发动;发达;实施;落实;开辟;睁;公开;发挥;携带;实行;展开;开放;开拓;扛;戴;贯彻;提;瞪;端;生长;发展;发扬;开阔;开;执行;发育;演变;发射;挎;敞开
开支	工资;付款;心血;经费;缴纳;待遇;支出
刊登	出版;公布;发表;发行
勘探	探测;展望;证明
看待	见解;风光;目光
慷慨	大方
扛	执行;戴;贯彻;实行;提;端;实施;携带;开展;挎;落实
考察	审查;辩证;探讨;检查;检验;监督;追究
考核	审查;评估;反思;复习;权衡;鉴定;回顾;检讨;评价;检验
考验	实验;试验;检验;测验
磕	扣;敲
科目	题目;标题
渴望	长;盼望;久;思念;悠久;巴不得;向往
可口	好吃
可恶	丑恶
可行	切实
课题	发布;颁布;疙瘩;周折;发表;任务;题;散发;发行;题目;颁发
克制	治理;束;操纵;控制;节制;遏制;拘束;牵制;约束;憋;支配;监督
客户	用户;顾客;当事人
啃	咬
恳切	认真;诚恳;踏实;诚挚;真挚
坑	诈骗
空洞	空;空虚
空前绝后	别致;唯独
空想	梦;发呆;幻想
空虚	空;空洞
孔	布局;洞
恐怖	糟糕;凶恶;要命;可怕
恐吓	威胁
恐惧	害怕;胆怯;畏惧
口气	语气
口腔	口;嘴
扣	疙瘩;逮捕;粉碎;纽扣儿;敲;覆盖;砸;系;磕;包庇;掩护;掩盖;盖;被
哭泣	哭
枯燥	无聊;莫名其妙
枯萎	疲惫
挎	扛;戴;贯彻;执行;提;端;实施;携带;开展;实行;落实
快活	幸福;开朗;舒畅;痛快;愉快;开心;欢乐;快乐;高兴;喜悦;美满
宽敞	广阔;宽;开阔
宽容	仁慈;饶恕;原谅;慈善
款待	招待
款式	模样;模型;格局;体裁;模式;风格;图案;形态;华丽;构思;样式;设计;造型
框架	陷害;提纲;诬陷
况且	除非;另外;此外;并且
亏损	遗失;赤字;损失
捆绑	束;约束;束缚
扩充	延伸;延期;放大;延长;铺;蔓延;扩大;发展;扩张
扩散	延伸;流传;摊;铺;蔓延;散布;弥漫;传播
扩张	扩充;发展;扩大
喇叭	角
来历	根源;来源;历史
来源	根源;来历
懒惰	懒;空闲
捞	钓;鱼
牢固	坚强;坚实;坚硬;固体;坚固;立体;坚决;果断;硬;扎实;坚定
牢骚	埋怨;闲话;抱怨
乐趣	趣味;喜悦;欢乐
乐意	满意;内容;内涵
类似	相似;犹如
冷酷	冷却;凉快;狠心;镇定;镇静;严峻
冷却	镇定;镇静;凉快;冷酷
冷落	荒凉;凄凉;偏僻
愣	恰巧;竟然;不料;居然
理睬	讲究;注重
理智	道理;理由;原因;情理;正当;缘故;智力;合理
立场	姿势;位置;方位;位;职务;阵地;部位;职位
立体	牢固;坚实;固体;扎实;坚硬
立足	敌视;对抗
历来	向来;一直;始终;总是;一向;从来
利害	权利;趣味;利息;利益
力所能及	尽量
力争	操劳;力求;争取;努力;谋求
力求	力争;争取;努力;谋求
连同	随着;一起
联络	交流;环节;通讯;交际;联系
联盟	联合
联想	党
廉洁	老实;正当;诚实;坦白;人格
辽阔	广阔
吝啬	意味着;残忍;卑鄙;小气
零星	随意
灵感	启发
灵魂	心灵;气概;气魄;志气;精华;精神
灵敏	尖锐;心灵;伶俐;机灵;巧妙;智能;敏感;敏锐;锋利;敏捷;聪明;急剧
伶俐	智能;巧妙;机灵;灵敏;机智;聪明;风趣
领会	理解;把握;抓紧;懂;了解;领悟
领土	土地
领悟	理解;懂;了解;领会
领先	带领;引导;婴儿;主导;引起;导致;率领
领袖	华侨;裁判;领导
留恋	留念
留念	留恋
留神	手表;小心;处置;关照;保管;当心
流浪	漂浮;串;徘徊
流露	表示;暴露;展示
流氓	无赖;歹徒
流通	循环
隆重	兴旺;庄重;兴隆;昌盛;风光;壮观;雄伟;宏伟;庄严;伟大;繁荣
搂	抱;拥抱
轮船	船
论证	示威;证明;示范
啰唆	麻烦;伤脑筋
落实	实用;扛;戴;贯彻;实行;执行;履行;踏实;提;端;实施;扎实;携带;做主;开展;切实;挎
络绎不绝	昼夜
屡次	一再;反复;再三
履行	执行;贯彻;表演;实施;采取;实行;落实
掠夺	酒精;抢劫;抢
麻痹	秃;麻木;挫折;瘫痪
麻木	麻痹
埋怨	牢骚;抱怨
漫画	卡通;动画片
蔓延	延伸;扩散;流传;延期;摊;延长;铺;散布;扩充;传播
忙碌	忙;占线;繁华;繁忙
茫然	作废;愚昧
盲目	瞎
冒犯	得罪;触犯
枚	颗
媒介	媒体;中介
美观	美丽;漂亮;美妙
美满	幸福;舒畅;快活;完备;完美;愉快;痛快;开心;欢乐;快乐;高兴;喜悦
美妙	美丽;辉煌;奇妙;美观;灿烂;卓越;精彩;漂亮
猛烈	激烈;剧烈;厉害;暴力;凶恶
弥补	挽救;补救
弥漫	扩散;渗透
迷惑	混淆
密封	封锁;封闭
免得	以免
勉励	鼓励;激励
面貌	模样;神态;脸;样子;特征;容貌;体面;面对;面子
面子	表彰;威望;名誉;外表;威风;尊严;声誉;脸;信誉;荣誉;体面;面貌;面对;外
描绘	塑造;描写;形容
瞄准	宗旨;目的;针对
渺小	分;分钟;微不足道
藐视	轻视;鄙视;蔑视;看不起
蔑视	鄙视;看不起;贬低;藐视;轻视
灭亡	去世;熄灭;销毁;毁灭;破坏;淘汰;逝世;死
民间	通俗;火;热门
敏捷	灵敏;挥霍;灵活
敏锐	尖锐;锋利;剧烈;灵敏;急剧
明明	显然;斩钉截铁
明智	机灵;英明;正当;高明
名誉	表彰;尊严;声誉;信誉;荣誉;面子
命名	命令;叫;称;号召
摩擦	揉;致辞;争端;冲突
磨合	爆发;违反;戴;粉碎;分裂;折;破;穿;断;断绝;中断
模范	模型;榜样;模特;典型;塑造
模式	模样;方式;体裁;款式;风格;方法;样式;造型
模型	格局;榜样;模特;款式;图案;形态;典型;模范;样式;塑造
抹杀	取缔;创作;著作;压制;擦;写
莫名其妙	无聊;枯燥
谋求	力求;力争;争取;寻找;努力
模样	对于;寻觅;瞧;目光;体裁;款式;风格;样式;当心;操劳;气色;照顾;寻找;关照;左右;面貌;造型;东张西望;神态;样子;大约;看;模式;关于
目光	见解;眼光;寻觅;瞧;视力;凝视;模样;注视;眼睛;当心;操劳;气色;照顾;寻找;关照;盯;东张西望;神态;样子;风光;看;看待
沐浴	浸泡
拿手	良好;精通;乖;好;出息;专家
难得	珍稀
难堪	尴尬
恼火	生气;要命;加剧
内涵	意图;内容;意思;意义;含义;乐意;心眼儿;动机;意向
内在	天生;固有
能量	精神;活力;精力;气势
拟定	制定;草案;吸取;学习;起草
年度	年
捏	揉;制定;交;使;包装;制作;拧;挣;组成;化妆;掐;补偿;搞;弄
拧	捏;掐
凝固	冻;冻结
凝聚	配套;精简
凝视	注视;瞪;盯;目光
宁肯	宁可;宁愿
宁愿	宁可;愈;宁肯
纽扣儿	扣
扭转	颠倒;挫折
浓厚	深;深刻;稠密;浓;深沉;厚
挪	举动;转移;搬;运行;移动;绕;迁徙
虐待	糟蹋;弊端
哦	呀;啊;哈;哎;呵
殴打	打架;揍;砸;电池;打击;节奏;撞;拍
呕吐	吐
排斥	解除;拆;消灭;否决;消除;淘汰;排除;抵制;除;清除;拒绝
排除	解除;拆;消灭;消除;淘汰;摆脱;除;排斥;清除
排放	放;散发;发射;释放
徘徊	犹豫;迟疑;流浪
派别	团;组;群;派;集团;团体
派遣	发;寄;派
攀登	扒;规模
盘旋	漂浮;伴随;触犯;循环;轨道;去;圈
畔	储蓄;银行;岸;旁边
判决	裁判;句子
庞大	厉害;巨大
抛弃	甩;放弃
培育	培训;教养;列车;训练;品种;孕育;繁殖
配备	装备;器材;供给;武装;支配;拨;设备;提供
配偶	伴侣
配套	凝聚
盆地	盆
捧	称赞;表扬;吹捧;夸;过奖;赞美
劈	看见;砍;拍
批发	分布;布局;分配
批判	谴责;指责
疲惫	疲倦;枯萎;累
疲倦	疲惫;累
屁股	底
譬如	例如;比如
偏差	错误;误差;故障
偏僻	遥远;冷落;荒凉;闭塞;凄凉
偏偏	可惜
片断	部分;部位;环节;节
片刻	时刻;一会儿;刻;瞬间;趁
飘扬	航行;波浪;扑;飞翔;挥
漂浮	飘;盘旋;串;流浪
撇	摔倒;丢;甩;唾弃;铸造
拼搏	斗争;挣扎;搏斗;奋斗;挣
拼命	竭尽全力
频繁	不时;经常;时常;往往
贫乏	穷;可怜;贫困
贫困	穷;可怜;贫乏
品尝	标本;样品
品质	质量;档次
品种	孕育;培育;繁殖;种类
平凡	平庸
平坦	光滑;顺利;平;扁;尚且;档次;级别;熨;水平;连
平行	并列
平原	田野;朴实;领域
平庸	平凡
评估	权衡;评价;鉴定;考核
评论	洽谈;探讨;讨论
屏障	障碍;墙
屏幕	筛选;掩护
坡	倾斜
泼	溅
颇	未免;很;挺;相当;体面
迫不及待	不耐烦;急躁
迫害	折磨
魄力	干劲;气魄;勇气;驾驶;志气;勇于;驱逐
扑	进攻;飘扬
铺	延伸;扩散;流传;延期;摊;延长;蔓延;散布;扩充;传播
普及	普遍
朴实	单纯;简单;踏实;平原
期望	预期;预料;意料;展望;期待;希望;指望
期限	截止;项
欺骗	作弊;骗
凄凉	荒凉;冷落;偏僻
奇妙	精彩;美妙
齐全	完整;完毕;完备;十足;完成
起草	制定;拟定;草案
起初	本来;当初
起码	至少
起源	创立;来自
启示	开明;启蒙
启事	须知;通知;布告;公告
启蒙	开明;倡议;传授;倡导;启示;创业
企图	尝试;试图
岂有此理	荒唐;荒谬;不像话
器材	装备;物质;武装;设备;配备
器官	仪器
气概	心灵;灵魂;气魄;志气;精神
气魄	心灵;气概;灵魂;志气;精神;魄力
气色	模样;神态;操劳;照顾;样子;东张西望;看;寻觅;瞧;寻找;关照;目光;当心
气势	声势;能量;精神;活力;精力
气味	味道;闻
气质	脾气
迄今为止	仍旧;尚且;还;仍然;依旧;依然;至今;还是
掐	打架;斗争;战斗;搏斗;摘;捡;争取;拧;拣;接;争夺;捏;拾
恰当	妥当;适宜;妥善;相应;合适
恰巧	公正;索性;愣;正;刚才;竟然;正当;居然;幸亏;刚;唯独;不料
洽谈	探讨;评论;讨论
牵	拉;扒;撤退
牵扯	涉及;包括
牵制	治理;操纵;克制;妨碍;控制;节制;制约;支配;拘束;约束;束缚;制止;监督
签署	符号;标志;预订;签;手势;登录;迹象;标记
迁就	适应;让步;屈服;容纳
迁徙	举动;搬;挪;运行;移动;绕
谦逊	谦虚;虚心
前景	前途;出息
谴责	批判;攻击;批评;指责
抢劫	掠夺;抢
抢救	救;挽救
强迫	逼迫;动力;暴力
桥梁	桥
翘	抬;抚养;举;饲养;提;耸
窍门	玩意儿;手法;骗;圈套
锲而不舍	坚持
切实	实用;现实;踏实;扎实;可行;落实
亲密	将近;密切;关闭;濒临;亲热;跟前;截止;近;闭塞;精密
亲热	密切;亲密
侵犯	违反;触犯;违背
钦佩	瞻仰;佩服;折
勤劳	勤奋;刻苦;辛勤;用功
清澈	清楚;清晰;清理;明白;显然;澄清
清除	解除;消灭;消除;淘汰;排除;摆脱;除;排斥
清洁	干净;清真;打扫
清理	将军;报到;清楚;制止;清晰;布置;遏制;明白;刹车;清澈;支票;显然;制服;澄清;挫折;对照
清晰	鲜明;清楚;清理;明白;清澈;显然;澄清
清真	纯粹;打扫;干净;清洁;纯洁;单纯
倾听	听
倾向	趋势;潮流;动态;导向
倾斜	坡;靠
情报	智力;智慧;智能
情节	形势;情况;情形;策划;阴谋;条件
情理	道理;理由;原因;理智;缘故
情形	场合;局势;格局;形势;状况;情节;情况;事态;局面;地步;情景;条件
请柬	请帖
请教	磋商;协商;咨询
请帖	请柬
区分	分辨;鉴别;辨认;识别
区域	地区;面积;领域
屈服	窝;给予;迁就;放弃;折;给;赋予;投降;让步
曲折	复杂
驱逐	开除;干劲;驾驶;志气;魄力
取缔	禁止;抹杀;压制
曲子	音乐
趣味	口味;过瘾;利益;利害;味道;审美;利息;滋味;尝;权利;乐趣
圈套	手法;骗;陷阱;玩意儿;窍门
权衡	称;考核;调剂;评估;考虑;着想;平衡;斟酌
权威	威信
拳头	高档
犬	狗
缺口	突破;间隔
缺陷	毛病;故障;过失
确保	保障;保管;保证;担保
确立	成立;创立;树立;奠定;建立;设立
确切	精密;明确;准确;精确
确信	务必;服气;确定
染	抓;捕捉
嚷	喊;呼唤
让步	给予;迁就;放弃;屈服;给;赋予
饶恕	原谅;宽容
扰乱	骚扰;打扰;捣乱;惊动
热门	热;通俗;民间;火
人道	人性
人格	尊严;廉洁;性格;体面;个性
人工	虚伪;人为
人家	本人;家庭;我
人间	世界
人士	人
人为	虚伪;人工
人性	人道
仁慈	善良;亲切;和蔼;和气;宽容;慈祥;慈善;番;爱心
忍耐	压迫
忍受	承受;挨;熬;生育;受罪;吃苦;承担
认定	测量;保养;意志;维护;辨认;决心;维持;鉴定;保持;确定;断定
认可	证书;批准;行;赞成
任命	约会
任意	随意;胡乱
仍旧	尚且;还;迄今为止;仍然;残留;倒;依旧;而;却;剩;依然;不过;还是
融化	衔接;组合;解散;溶解
融洽	和睦;和谐;调和
溶解	解散;方案;融化
容貌	特征;面貌
容纳	算数;抱;迁就;容忍;蕴藏;把;遏制;举行;占领;憋;举办;占据;盛;扶;包含
容忍	将就;容纳
荣誉	名誉;声誉;信誉;光辉;功劳;面子
揉	摩擦;捏;按摩
柔和	软;轻;轻松;斯文;温柔
弱点	缺点
散文	文章
散布	扩散;延伸;流传;摊;铺;蔓延;传播
散发	发布;颁布;分散;发表;分布;排放;课题;发射;发行;分配;颁发
丧失	失去;丢;输;罚款;遗失
骚扰	打扰;捣乱;扰乱;惊动
刹车	拦;截止;将军;报到;阻拦;堵塞;终止;遏制;清理;闭塞;停;支票;制服;制止;挫折;对照
啥	什么;咋
筛选	掩护;屏幕;过滤
擅长	善于
伤脑筋	麻烦;啰唆
上级	优越;高明
上进	进展
上任	就职
尚且	仍旧;平坦;还;迄今为止;仍然;而;倒;却;依旧;依然;不过;连;还是
梢	端;结束;终点;完毕
哨	呼啸
奢侈	豪华;过度;挥霍
设立	着手;衬托;镶嵌;确立;成立;创立;树立;奠定;设置;出发;建立;开辟
设想	想象
设置	着手;衬托;镶嵌;成立;装;树立;出发;设立;安装;开辟
涉及	包括;牵扯
深奥	深刻
深沉	深;单调;浓厚;深刻;极端;厚
申报	宣布;报告;陈述;汇报;报道
绅士	君子
呻吟	哼
神气	神态;充沛;词语;空气;表情;朝气蓬勃;风度;表达
神态	寻觅;表情;瞧;目光;表达;模样;方位;神气;当心;操劳;气色;照顾;寻找;关照;风度;面貌;东张西望;样子;词语;看
审查	考核;辩证;探讨;检验;考察;追究
审理	尝;尝试;试;试图
审美	口味;趣味;味道;滋味;尝
渗透	弥漫
慎重	小心翼翼;谨慎;仔细;细致;周密;注意
生存	存在
生机	活力
生疏	陌生;奇怪
生锈	腐蚀
生育	承受;忍受;栽培;饲养;长（动词）;成长;种植;吃苦;生长;发展;承担
声明	发言
声势	冲动;气势
声誉	荣誉;名誉;信誉;面子
失踪	遗失;消失
师范	正常
施展	展示;显示;展览;陈列;运用
拾	摘;捡;十;收;拣;接;采集;掐;收藏
十足	充分;完整;完毕;完备;完成;齐全
识别	分辨;区分;鉴别;辨认
时常	不时;经常;往往;频繁
时而	偶尔
时机	场面;机会;场合;机遇
时事	现状
实惠	充实;有利
实力	力气;优点
实施	扛;戴;贯彻;实行;执行;履行;提;端;携带;开展;挎;落实
实行	扛;戴;贯彻;执行;履行;提;端;实施;携带;开展;挎;落实
实质	精华;本质
是非	吵架;纠纷;争端;争议;打官司
试图	试;企图;尝试;审理;尝
试验	实验;考验;检验;测验
势力	影响;动力;感染;熏陶;权力;力量
示范	示威;呈现;论证
示威	呈现;论证;示范
示意	指示;暗示;表示;含义;提示;表明
释放	发布;解放;版本;放;排放;发射;发行
事故	变故;案件;意外;战斗
事件	活动
事态	场合;局势;格局;形势;状况;情况;局面;地步;情形;情景
事务	干;打工;作品;劳动;操作;致力;工作
事项	端;物质;事情
事业	举动;计划;缘故;使;职业;原因;造成;引起;项目;导致;活动;致使
适宜	妥当;妥善;恰当;相应;合适
视力	眼光;眼神;目光
逝世	去世;熄灭;灭亡;淘汰;死亡;死
收藏	收;采集;征收;拾;攒
收缩	合同;承包
收益	盈利;收入;利润
手法	骗;圈套;玩意儿;技术;本事;窍门;技巧
手势	符号;标志;签;登录;迹象;标记;签署;信号
手艺	商业;贸易;手工;经商
首要	校长
守护	保守;维护;保护;防止;防守;捍卫
受罪	遭受;受到;挨;熬;忍受;吃苦
授予	磋商;颁发
书籍	作品;著作;预订;书
书记	秘书
舒畅	幸福;快活;痛快;愉快;开心;欢乐;快乐;高兴;喜悦;美满
疏忽	忽视;俯视;怠慢;忽略
疏远	隔阂
束	克制;系;丛;约束;捆绑;束缚;扎
束缚	束;节制;系;制约;拘束;牵制;约束;捆绑;扎
树立	着手;衬托;镶嵌;确立;成立;创立;奠定;设置;建立;出发;设立;开辟
数额	数量;折
耍	表演;戏剧;玩弄;玩;敷衍;播放
衰老	年龄;年纪;时代
衰退	推辞;滴;掉;跌;坠
率领	指令;带领;首;领先;引导;婴儿;指挥;主导;吩咐;引起;命令;导致;脑袋
瞬间	片刻;时刻;刻
司法	公道;正义
思念	长;渴望;觉得;久;以为;盼望;怀念;惦记;认为;小姐;想念;悠久;巴不得
思索	琢磨;思维;沉思;思考;思想
思维	思想;思索
私自	本人;私人;悄悄;个人
斯文	轻;轻松;柔和;教养;和气;礼貌;精致;温柔;精密;文雅
死亡	逝世
肆无忌惮	大肆
饲养	抬;抚养;生育;举;提;翘;耸
耸	激发;抬;抚养;举;饲养;提;翘;高尚;崇高
苏醒	醒
塑造	模型;榜样;模特;典型;机动;模范;描绘;灵活
素食	蔬菜
算数	抱;数;把;举行;容纳;占领;憋;举办;统计;盛;占据;扶
随即	立即;立刻;顿时;即便
随意	自觉;称心如意;任意;随便;零星;胡乱
岁月	年代
隧道	地道
索性	恰巧;公正;正;刚才;简直;正当;干脆;刚;唯独
索取	请求;问;征求;需求;过问;反问
塌	倒闭;解体;崩溃;瓦解
踏实	实用;现实;朴实;认真;恳切;诚挚;切实;扎实;坚定;落实
瘫痪	麻痹
贪婪	馋
贪污	腐蚀;腐败
摊	扩散;延伸;流传;铺;蔓延;散布;传播
坦白	老实;正当;交代;廉洁;诚实;坦率
探测	探讨;勘探;探索
探索	探讨;探测
探讨	洽谈;探测;审查;辩证;探索;评论;讨论;考察;追究
探望	访问;参观;游览;看望
倘若	要是;假如;如果
掏	挖掘;扒
淘汰	去世;熄灭;消灭;消除;灭亡;层次;步骤;排除;逝世;除;排斥;洗;清除;死;局面
讨好	巴结
特长	专长
特定	个别;具体;特殊;指定
提炼	抽象;开采;办理;过程;加工;纯洁;摘要;处理
提示	指示;暗示;含义;交代;呈现;指;陈述;送;示意;当前
提议	建议;倡导;暗示;倡议
题材	主题
体裁	模样;模式;款式;风格;样式;造型
体积	册;卷
体谅	许可;欣赏;允许;感激
体面	尊严;正经;脸;颇;面貌;面对;面子;人格
体系	制度;系统
天才	礼物;天赋;才干
天生	内在;自然
天赋	礼物;才干;天才
田野	平原;领域
条理	指令;布局;整理;次序;顺序;布置;安排
条约	协议
调和	和解;和睦;和谐;调节;融洽
调剂	权衡;节制;平衡;调节
调节	规范;调和;和解;调剂;协调
挑拨	鼓动;刺激;挑衅
挑衅	刺激;挑拨
跳跃	蹦;踊跃;飞跃
通俗	平均;通用;民间;普遍;火;热门
通讯	交际;交流;联络
通用	货币;普遍;通俗
统计	增加;算数;增添;补充;数;搭
统统	所有;完全;都;凡是
统治	治理;规律;管辖;规定;政权;规章;规则
投机	推测
投诉	打官司
投降	屈服
透露	泄露;走漏;漏;揭露
秃	麻痹;挫折
突破	缺口
图案	模型;格局;款式;形态;华丽;构思;样式;设计
途径	频道;方式;作风;办法
涂抹	油漆;应用;申请;使用
团结	联合
团体	团;机构;组;群;组织;派别;集团
推测	投机
推理	推论
推论	演绎;推理
推销	贩卖;市场;卖
脱离	摆脱
拖延	推迟;挨;延期;耽误;服从
妥当	适宜;正经;妥善;恰当;相应;正当;合适;端正
妥善	妥当;适宜;正经;恰当;相应;正当;合适;端正
妥协	和解
唾弃	撇;鄙视
挖掘	掏;扒
娃娃	宝贝;婴儿
瓦解	倒闭;解体;崩溃;塌
外表	外界;外;面子
外行	业余
外界	外表
完备	完整;完毕;十足;完美;完成;美满;齐全
完毕	完整;终点;梢;完;完备;十足;端;结束;交代;完成;齐全
玩弄	表演;戏剧;耍;玩;敷衍;播放;从事
玩意儿	举动;演习;东西;骗;手法;圈套;玩具;窍门;事物;扮演
顽固	执着;固执;倔强
顽强	坚韧
挽回	储蓄;救;回收;保存;节省;存;挽救;节约;攒
挽救	储蓄;救;抢救;保存;节省;存;弥补;补救;挽回;节约;攒
万分	十分;贼;极其;要命;极;不堪;无比
往常	平常
微不足道	渺小
威风	威力;威望;风光;信誉;厉害;面子
威力	威风
威望	信誉;威风;面子
威信	权威
违背	违反;触犯;侵犯
维持	保养;保留;认定;保守;维护;遮挡;保持
维护	辩护;保养;保障;认定;辩解;保护;维持;守护;防守;保持;保卫;保管;捍卫
唯独	恰巧;公正;索性;空前绝后;正;刚才;正当;刚;别致
为期	持久;凭;截至
委托	信誉;赋予;信赖;信任
伪造	假
喂（叹词）	嘿
未免	不免;颇;挺;难免;过分
畏惧	害怕;恐惧;胆怯
温和	节制;缓和
文献	文件;文学
文雅	精密;精致;斯文
问世	展现;出;当选;来
窝	巢穴;所;位置;场所;屈服;折;搁;寄托;部位
乌黑	暗;黑
污蔑	糟蹋;诽谤
诬陷	陷害;框架
无比	十分;贼;极其;要命;极;不堪;万分
无非	光;只（副词）;唯一
无赖	流氓;歹徒
无辜	天真
无微不至	一丝不苟;细致;精心
舞蹈	跳舞
武器	武装
武装	胳膊;装备;臂;器材;武器;设备;配备
侮辱	糟蹋
务必	不得已;需要;确定;必须;确信
误差	故障;差距;区别;分歧;偏差;错误;差别
误解	误会
熄灭	去世;灭亡;淘汰;逝世;死
昔日	原来;以往;从前
媳妇	太太;老婆;姑娘;妻子
习俗	惯例
袭击	冲击;进攻;攻击;打击
喜悦	幸福;舒畅;快活;痛快;愉快;开心;欢乐;快乐;高兴;美满;乐趣
细致	无微不至;嫩;娇气;慎重;刻苦;精心;罚款;一丝不苟;仔细;精致;优美;周密;晴;注意
狭隘	严密
狭窄	窄
下属	附属
先进	进行
先前	以前;从前
鲜明	心灵;高明;清晰;明确;亮
掀起	抬;解除;高潮;举;高涨;开始
嫌	嫌疑;讨厌;恩怨;反感
嫌疑	嫌
闲话	牢骚;抱怨
贤惠	善良
衔接	共同;融化;组合
显著	优秀;高超;杰出;出色;突出;卓越
现场	场面;风光;情景;镜头
现状	时事
宪法	章程
陷害	框架;诬陷
陷阱	圈套
线索	踪迹
相等	平等;一样
相应	妥当;适宜;妥善;恰当;合适;同意;答应;对应
镶嵌	着手;衬托;成立;树立;设置;出发;设立;开辟
响应	回答;反应;答辩;答案;答复
巷	胡同
向导	带领;引导;导向
向来	一直;总是;一贯;一向;历来;从来
向往	渴望;盼望;展望;期待;巴不得
消除	解除;拆;消灭;淘汰;排除;除;排斥;清除
消耗	耗费;利用;用途;用;使用
消灭	杜绝;消除;淘汰;排除;除;排斥;清除
销毁	灭亡;毁灭;破坏
小心翼翼	慎重
效益	收获;利益;好处
潇洒	挥霍
携带	赞助;扛;戴;贯彻;实行;执行;支撑;搀;提;拥护;端;实施;支援;做主;开展;挎;支持;落实
协会	社会;党
协商	磋商;赞成;一致;咨询;请教;协议
协调	谈判;调节
协议	协商;条约;一致;赞成
协助	辅助;支援
屑	合算
泄露	走漏;漏;透露
泄气	忧郁;沮丧
新颖	小说
心得	经验;遭遇
心灵	鲜明;智能;机灵;气概;灵敏;灵魂;气魄;高明;亮;机智;心眼儿;志气;精神;心脏
心态	态度;心理;姿态
心疼	疼爱
心血	经费;开支
心眼儿	在乎;意图;心灵;在意;动机;内涵;意向;心脏
心甘情愿	痛快
辛勤	勤奋;刻苦;勤劳;用功
欣欣向荣	兴旺;繁荣;繁华
信赖	委托;依赖;信任;信誉;依托
信念	信仰
信仰	信念
信誉	名誉;威望;威风;委托;声誉;信任;荣誉;卓越;信赖;差别;面子
兴隆	兴旺;隆重;昌盛;繁荣
兴旺	兴隆;昌盛;隆重;欣欣向荣;繁荣
行政	管理
形态	形式;模型;表格;格局;格式;构成;款式;图案;组成;样式;形状
刑事	罪犯
性命	生命;生活;人生;日子
性能	表演;功能;演出;表现;职能
兴高采烈	兴致勃勃
兴致勃勃	兴高采烈
胸怀	爱惜;珍惜
胸膛	胸
凶恶	恐怖;激烈;剧烈;要命;厉害;猛烈
雄厚	富;丰富;充沛;丰满;油腻;充实;富裕;充足;丰盛
雄伟	庄重;风光;隆重;壮观;壮丽;光辉;宏伟;伟大;崇高
修复	修理;维修
修建	建设;搭;开辟
修养	培训;成就;训练
虚伪	假;人工;人为
需求	要求;索取
须知	启事;通知;布告;公告
许可	体谅;执照;允许
喧哗	哄
宣扬	颁布
悬挂	挂;搭;吊
旋律	节奏
旋转	转;绕;围绕
炫耀	展现;给予;表演;展示;表示;演出;出示
削	砍;切
学说	理论;主义;原理
熏陶	影响;感染;势力
循环	圈;盘旋;流通
寻觅	模样;神态;操劳;气色;照顾;样子;东张西望;看;瞧;寻找;关照;目光;当心
压迫	着重;压抑;忍耐
压抑	沉闷;压迫
压制	抹杀;憋;取缔
鸦雀无声	寂静;沉默
淹没	洪水
延期	推迟;挨;延伸;拖延;耽误;延长;铺;蔓延;服从;扩充
延伸	扩散;流传;延期;摊;延长;铺;蔓延;散布;扩充;传播
延续	持续;继续;最后
严峻	严重;大不了;正经;剧烈;严肃;沉重;郑重;严厉;不得了;冷酷
严厉	剧烈;严格;严密;严峻
严密	狭隘;严格;严厉
言论	舆论;演讲
岩石	摇
演变	开拓;发达;发挥;发育;进展;进化;开展;生长;发展;发扬
演习	举动;实践;操练;运动;玩意儿;练习;扮演
演绎	推论
掩盖	隐蔽;隐瞒;扣;覆盖;包庇;掩护;盖;被
掩护	屏幕;扣;覆盖;包庇;筛选;掩盖;盖;被
眼光	眼睛;视力;目光
眼色	眼神;眨
眼神	视力;眨;眼色
厌恶	恨;讨厌;嫉妒
样品	品尝;标本
遥远	偏僻
要点	挥;经纬
要命	凶恶;恐怖;十分;贼;杀;极其;极;不堪;恼火;无比;非常;不得了;万分
野心	抱负;志气
依旧	仍旧;尚且;还;迄今为止;一如既往;仍然;照样;依然;还是
依据	基础;按照;根据
依靠	依托;依赖;靠
依赖	依托;信赖;依靠;靠
依托	信赖;依靠;依赖;靠
一度	一旦;曾经
一贯	向来;一致;执着;固执;持久;一向
一向	向来;近来;最近;一直;总是;一贯;不断;历来;从来
遗产	遗留;遗传
遗传	传达;遗产;转告
遗留	残留;遗产
遗失	失去;丢;丧失;输;亏损;失踪;损失
疑惑	疑问;怀疑;顾虑
仪器	器官
仪式	典礼
以便	以致;以至;为了
以免	一旦;假设;免得
以往	原来;从前;昔日
以至	以致;上;以便;截至;下
以致	上;以至;以便;截至;下
亦	也;并且
翼	翅膀
一如既往	依旧;照样
一丝不苟	无微不至;细致;精心
异常	优异;反常
意料	预期;预料;期望;期待;指望
意识	觉悟;知觉
意图	心眼儿;动机;内涵;意向
意味着	残忍;卑鄙;吝啬;小气
意向	意图;心眼儿;动机;内涵
意志	决心;毅力;认定
毅力	意志
毅然	坚固
阴谋	策划;情节
隐蔽	掩盖;隐瞒
隐瞒	隐蔽;掩盖
隐约	含糊;模糊;晕;暧昧
引导	带领;领先;婴儿;进行;指挥;向导;主导;引起;举办;导向;行为;导致;率领
引用	表彰;推荐;指定
婴儿	带领;领先;引导;宝贝;娃娃;主导;引起;导致;率领
英明	辉煌;机灵;高明;灿烂;光辉;明智
英勇	豪迈;壮烈
迎面	直接
盈利	收获;收益;利润
应酬	娱乐
拥护	赞助;支撑;搀;支援;携带;做主;支持
拥有	不得不;有;不得已;只好;得（助动词）;具备
庸俗	荤;丑恶
勇于	魄力;敢;勇气
永恒	永远
涌现	春
踊跃	跳跃;蹦;飞跃
用户	客户;顾客
优先	原始;最初;第一;先
优异	优秀;高超;异常;出色;卓越
优越	上级;高明
忧郁	泄气;沉闷;沮丧
油腻	富;丰富;丰满;充实;雄厚;丰盛
油漆	涂抹
犹如	类似;相似;好像;仿佛
幼稚	老实;年轻;青;天真
诱惑	归纳;促使;吸引
愚蠢	傻;笨;笨拙
愚昧	傻;茫然
舆论	言论
愈	宁愿;回收
预料	期望;预期;意料;展望;期待;预报;指望
预期	期望;预料;意料;期待;指望
预先	事先
欲望	胃口;愿望
冤枉	非;错
原理	理论;学说;原则
原始	原先;最初;优先;第一;原来;先;当初
原先	原始;原来;当初
缘故	道理;理由;使;原因;情理;造成;事业;引起;理智;导致;致使
园林	公园
约束	局限;束;克制;极限;节制;限制;遏制;拘束;牵制;制约;憋;界限;捆绑;束缚;制止
熨	光滑;平坦;顺利
蕴藏	盛;容纳;包含;遏制
运算	手术;操作
运行	举动;执行;搬;挪;跟踪;移动;加工;绕;迁徙;跑步;追
孕育	培育;繁殖;教养;品种
砸	输;殴打;粉碎;扣;失败;撞;打击
咋	什么;啥;如何;怎么;为什么;何必
灾难	灾害
栽培	生育;养成;长（动词）;成长;种植;生长;发展
在意	在乎;心眼儿
再接再厉	持续;坚持
攒	储蓄;救;保存;节省;存;挽救;挽回;收藏;节约;积累
赞助	支撑;搀;拥护;支援;携带;做主;辅助;支持
暂且	姑且;暂时
糟蹋	诽谤;摧残;污蔑;耗费;弊端;侮辱;毁灭;败坏;浪费;虐待
遭受	受罪;搀;熬;受到
遭遇	碰;经验;心得;见面;会晤;接触;遇到;符合;迎接
造型	模样;体裁;模式;款式;风格;样式
责怪	责备
贼	弊病;十分;极其;要命;极;不堪;无比;万分
增添	增加;补充;统计;搭;提高
扎	束;束缚;刺;系
扎实	霸道;坚实;重;切实;坚定;实用;结实;强烈;固体;立体;牢固;坚固;健全;坚决;浓;坚强;踏实;果断;硬;坚硬;落实
眨	眼神;眼色
诈骗	坑
摘要	抽象;总结;提炼
瞻仰	崇敬;钦佩;折;佩服
斩钉截铁	明明
展示	展现;暴露;给予;表演;显示;展览;陈列;表示;演出;施展;出示;炫耀;流露
展望	期望;预料;勘探;盼望;期待;巴不得;向往
展现	出;给予;表演;展示;表示;演出;出示;炫耀;问世;呈现;当选;来
战斗	打架;斗争;战役;搏斗;事故;争取;掐;争夺
战术	策略
战役	战斗;斗争
占据	算数;抱;占;把;举行;容纳;占领;憋;举办;盛;扶
占领	算数;抱;占;把;举行;容纳;憋;举办;占据;盛;扶
章程	规矩;宪法;规定;规章;规则
障碍	屏障;故障;干扰
帐篷	别墅
招收	租赁;雇佣;录取;招聘
朝气蓬勃	充沛;神气
照样	依旧;照常;一如既往
照耀	光芒
遮挡	保守;维持;保持
折	数额;磨合;数量;断绝;中断;爆发;粉碎;分裂;破;断;佩服;窝;瞻仰;拐弯;转;屈服;钦佩;违反;岔
折磨	迫害
真理	道理;实话
真挚	恳切;诚恳;诚挚
珍贵	宝贵
珍稀	难得
斟酌	权衡;着想;成心;考虑
阵地	姿势;立场;前面;位置;方位;位;阵;职务;部位;职位
镇定	冷却;平静;凉快;安宁;镇静;冷酷
镇静	冷却;平静;凉快;安宁;镇定;冷酷
振奋	鼓舞;激发;启发
振兴	复活;复兴
震撼	冲击;摇;振动;晃;不像话;震惊;颠簸;颤抖
震惊	冲击;震撼
争端	纠纷;冲突;是非;摩擦;争议;打官司
争夺	打架;斗争;战斗;搏斗;争取;掐
争议	纠纷;是非;争端;打官司
征服	攻克;制服;挫折
征收	收藏
挣扎	斗争;拼搏;搏斗;奋斗;挣
整顿	整齐;整理;收拾;综合;巩固
正当	妥善;明智;公道;端正;公正;正经;公平;及时;廉洁;妥当;索性;正;老实;刚;唯独;坦白;诚实;恰巧;刚才;理智;合理
正规	端;端正;正经
正经	严重;妥当;大不了;妥善;严肃;正当;沉重;郑重;端正;正规;不得了;严峻;体面
正气	正义
正义	公道;正气;司法
正宗	地道
政策	方针;策略
政权	统治
证实	确认
证书	认可
郑重	严重;大不了;正经;严肃;沉重;不得了;严峻
之际	当
枝	岔;支
支撑	赞助;支柱;搀;拥护;支援;携带;做主;支持
支出	耗费;工资;付款;花（动词）;度过;开支;缴纳;待遇
支配	治理;操纵;克制;控制;节制;配备;管辖;牵制;拨;监督
支援	赞助;支撑;搀;后背;拥护;协助;携带;做主;背;支持
支柱	支撑;志气
知觉	觉悟;意识
值班	上班
职能	角色;功能;性能
职位	姿势;立场;位置;方位;办公室;位;职务;阵地;部位;公告;岗位
职务	姿势;立场;位置;方位;位;阵地;部位;公告;岗位;职位
执行	追;扛;戴;贯彻;实行;履行;运行;跟踪;提;端;实施;携带;开展;挎;跑步;落实
执着	附件;倔强;固执;附属;一贯;持久;顽固
指标	规范;准则;规格;目录;目标
指定	赋予;特定;引用
指甲	甲
指令	指示;指挥;吩咐;顺序;命令;次序;条理;率领
指示	指令;表示;吩咐;提示;指;表明;示意
指望	期望;预料;预期;意料;期待
指责	谴责;批判;攻击
治理	操纵;官方;克制;控制;节制;主导;统治;管辖;支配;牵制;政府;监督
制裁	处置;惩罚;处分
制服	将军;征服;遏制;清理;刹车;支票;制止;报到;挫折;对照
制约	状态;节制;状况;拘束;牵制;约束;束缚;地步;条件
制止	局限;终止;牵制;停;报到;将军;阻拦;清理;刹车;闭塞;支票;挫折;拦;限制;堵塞;遏制;制服;截止;极限;约束;界限;对照
致辞	摩擦;地址;称呼
致力	干;打工;作品;劳动;操作;工作;事务
致使	使;原因;结晶;成果;造成;事业;引起;缘故;导致;成效
智力	情报;理智;智慧;智能
智能	得力;心灵;伶俐;灵敏;智慧;情报;智力
滞留	拘留
志气	心灵;干劲;支柱;气概;抱负;精神;灵魂;气魄;分辨;驾驶;魄力;野心;驱逐;分解
终点	端;结束;完毕;梢
终究	结果
终身	婚姻
终止	拦;截止;阻拦;堵塞;刹车;闭塞;停;制止
中断	爆发;违反;粉碎;分裂;磨合;岔;破;折;断;断绝
中央	中心;中间;中旬
衷心	诚挚
种子	冰雹
种族	竞赛
种植	生育;植物;栽培;长（动词）;成长;株;生长;发展
重心	焦点;集中
州	境界;状态;局势;状况;陈述;省;地步
周边	边缘
周密	周到;慎重;彻底;仔细;细致;注意
周折	疙瘩;课题;转折;打击;挫折
昼夜	络绎不绝
株	种植;植物
诸位	大家;大伙儿
主办	整理;做主;主人;主持
主导	治理;带领;领先;引导;婴儿;引起;导致;率领
主管	负责
主义	学说
嘱咐	关照;吩咐;转告;告诉
注视	凝视;盯;目光
注重	讲究;着重;强调;理睬
助理	助手;副
助手	助理;副
著作	书;文章;预订;创作;书籍;抹杀;写
驻扎	站
铸造	撇;丢
拽	撤退
专长	特长
转达	传达;沟通;交流;传授
转让	转移;装卸;调动
转移	改变;换;调动;挪;零钱;变化;转让;装卸;转变
转折	周折;过渡
装备	器材;武装;配备;设备
装卸	转移;转让;调动
庄严	隆重;庄重
庄重	高超;坟墓;风光;隆重;壮观;雄伟;宏伟;庄严;伟大
幢	栋;建筑
壮观	庄重;风光;隆重;雄伟;宏伟;精彩;伟大;崇高
壮丽	辉煌;光辉;雄伟;崇高;宏伟
壮烈	豪迈;英勇;勇敢
追究	探讨;辩证;审查;考察
坠	衰退;滴;掉;跌
准则	标准;指标;规范;规格
琢磨	沉思;思索;思考
着手	衬托;镶嵌;成立;树立;设置;出发;设立;开辟
着想	权衡;斟酌;考虑
着重	强调;注重;压迫
卓越	优秀;辉煌;高超;优异;显著;杰出;出色;信誉;灿烂;突出;差别;美妙
资本	资产;首都;本钱;资金
资产	首都;资本;资金;产业;财产;本钱
资深	高级
资助	补贴
姿态	态度;心态;姿势
滋味	口味;趣味;味道;感慨;感觉;审美;尝;感受;感情
滋润	潮湿
自满	得意
踪迹	线索;跟踪;尾巴;痕迹
宗旨	瞄准;客观;用途;目的;针对
总而言之	简要;总之
总和	归纳;共计
走漏	泄露;漏;透露
揍	节奏;拍;殴打
租赁	雇佣;招收;租
阻碍	拦;阻拦;阻挠;妨碍;堵塞;挡;阻止
阻拦	拦;截止;妨碍;阻挠;堵塞;终止;挡;阻碍;刹车;闭塞;阻止;停;制止
阻挠	阻拦;挡;阻碍;妨碍
祖国	故乡
罪犯	刑事
尊严	表彰;名誉;体面;面子;人格
遵循	伴随;跟随;服从;盯;遵守
做主	赞助;支撑;搀;后背;拥护;支援;携带;主持;主办;主人;背;支持;落实
作弊	欺骗;骗
作废	取消;茫然;删除
作风	方式;途径;办法
