道可道非常道	The Dao that can be spoken of is not the ever-constant Dao. (Chapter 1)
名可名非常名	The name that can be named is not the ever-constant name. (Chapter 1)
無名天地之始	That which is without-name is the beginning of heaven andearth. (Chapter 1)
有名萬物之母	That which possesses a name is the mother of the tenthousand creatures. (Chapter 1)
故常無欲以觀其妙	Therefore : always without-desire, thus you observe itssubtle mystery. (Chapter 1)
常有欲以觀其徼	Always possessing desires, thus you observe its externalappearances. (Chapter 1)
此兩者同出而異名	These two, they arise from the same source but havedifferent names; (Chapter 1)
同謂之玄	This sameness is called their deep mystery. (Chapter 1)
玄之又玄	Deep mysteries, and again deep mysteries – (Chapter 1)
眾妙之門	The gateway of many subtle mysteries. (Chapter 1)
天下皆知美之為美斯惡已	In the world, when all know that the action of beauty isbeautiful, then ugliness ensues. (Chapter 2)
皆知善之為善斯不善已	When all know that the action of good is goodness, thennot-good ensues. (Chapter 2)
故有無相生	Therefore : being and non-being create each other, (Chapter 2)
難易相成	Difficult and easy complete each other, (Chapter 2)
長短相較	Long and short contrast each other, (Chapter 2)
高下相傾	High and low lean on each other, (Chapter 2)
音聲相和	Tone and voice harmonize each other, (Chapter 2)
前後相隨	Before and after follow each other. (Chapter 2)
是以聖人	Thus the sage : (Chapter 2)
處無為之事	Lives by using non-action in his duties, (Chapter 2)
行不言之教	And practicing no-talking in his teachings. (Chapter 2)
萬物作__而不始	The ten thousand creatures arise, but do not have abeginning. (Chapter 2)
生而不有	Creating but not possessing; (Chapter 2)
為而不恃	Acting, but not concerned with the results; (Chapter 2)
功成而弗居	Accomplishing tasks, but not dwelling on them. (Chapter 2)
夫唯弗居	Now : only because there is no dwelling, (Chapter 2)
是以不去	Thus the results do not depart. (Chapter 2)
不尚賢	Not honoring those who are esteemable (Chapter 3)
使民不爭	Ensures that the citizens do not strive. (Chapter 3)
不貴難得之貨	Not valuing rare goods (Chapter 3)
使民不為盜	Ensures that the citizens do not act like thieves. (Chapter 3)
不見可欲	Not showing that which can be desired (Chapter 3)
使民心不亂	Ensures that the citizens’ heart/minds do not becomeconfused. (Chapter 3)
是以聖人之治	Thus the governing of the sage (Chapter 3)
虛其心實其腹	Empties their heart/minds, fills their stomachs, (Chapter 3)
弱其志強其骨	Weakens their ambitions, strengthens their bones. (Chapter 3)
常使民無知無欲	By always ensuring that the citizens arewithout-knowledge and without-desire, (Chapter 3)
使夫智者不敢為__	Those who make men wise will not dare to act. (Chapter 3)
為無為則無不治[矣]	Act with non-action, then all will be governed! (Chapter 3)
道盅而用之有不盈	Dao is like a cup or bowl, yet use it and there exists noneed to fill it. (Chapter 4)
淵兮似萬物之宗	Profound and deep!, it appears to be the ancestor of the tenthousand creatures. (Chapter 4)
挫其銳	It blunts their sharpness, (Chapter 4)
解其紛	Loosens their tangles, (Chapter 4)
和其光	Softens their brightness, (Chapter 4)
同其塵	Makes them the same as the dust of the world. (Chapter 4)
湛兮似或存	Deep and profound!, it seems to barely exist. (Chapter 4)
吾不知誰之子	I do not know whose child it is – (Chapter 4)
象帝之先	Its image came before that of god. (Chapter 4)
天地不仁	Heaven and earth are not kind – (Chapter 5)
以萬物為芻狗	Thus the ten thousand creatures become as straw dogs tothem. (Chapter 5)
聖人不仁	The sage is not kind – (Chapter 5)
以百姓為芻狗	Thus the 100 families become as straw dogs to him. (Chapter 5)
天地之間	The space between heaven and earth, (Chapter 5)
其猶橐籥乎	How is it just like a bellows or flute? (Chapter 5)
虛而不屈	It is empty, yet does not run out. (Chapter 5)
動而愈出	The more it moves, and the more it produces. (Chapter 5)
多言數窮	Too much talking is exceptionally exhausting, (Chapter 5)
不如守中	Which is not as good as maintaining what is within. (Chapter 5)
谷神不死	The spirit of the valley does not die – (Chapter 6)
是謂玄牝	It is called the deep and mysterious feminine. (Chapter 6)
玄牝之門	The gateway of this deep and mysterious feminine – (Chapter 6)
是謂天地之根	It is called the source of heaven and earth. (Chapter 6)
绵绵若存	Unbroken, it seems to exist. (Chapter 6)
用之不勤	Using it takes no effort. (Chapter 6)
天長地久	Heaven is eternal, earth is enduring. (Chapter 7)
天地所以能長且久者	The reason that heaven and earth can be eternal andenduring (Chapter 7)
以其不自生	Is because they do not live for themselves. (Chapter 7)
故能長生	Therefore they can live forever. (Chapter 7)
是以聖人	Thus the sage : (Chapter 7)
後其身而身先	Puts his self behind others, yet finds his self before them. (Chapter 7)
外其身而身存	Considers his self extraneous, yet his self survives. (Chapter 7)
非以其無私邪	Is this not because he has no self-interests? (Chapter 7)
故能成其私	Therefore he can achieve his self-interests. (Chapter 7)
上善若水	The highest virtue is like water – (Chapter 8)
水善利萬物而不爭	Water’s virtue benefits the ten thousand creatures, yet itdoes not strive. (Chapter 8)
處眾人之所惡	It dwells in places that everyone detests, (Chapter 8)
故幾於道[矣]	Therefore it is almost comparable to Dao! (Chapter 8)
居善地	In dwelling, the virtue is in the land. (Chapter 8)
心善淵	In your heart/mind, the virtue is in being profound anddeep. (Chapter 8)
與善仁	In relations, the virtue is in being kind. (Chapter 8)
言善信	In speech, the virtue is in being truthful. (Chapter 8)
正善治	In governing, the virtue is in being honest and just. (Chapter 8)
事善能	In your duties, the virtue is in being competent. (Chapter 8)
動善時	In action, the virtue is in the timing. (Chapter 8)
夫唯不爭	Now : only because there is no striving, (Chapter 8)
故無尤	Therefore there is no blame. (Chapter 8)
持而盈之	Holding and filling it (Chapter 9)
不如其已	Are not as good as your stopping short. (Chapter 9)
揣而銳之	Hammering and sharpening it (Chapter 9)
不可長保	Can not be forever maintained. (Chapter 9)
金玉滿堂	When gold and jade fill a room, (Chapter 9)
莫之能守	There is no one who can protect it. (Chapter 9)
富貴而驕	To have wealth and high rank, but with arrogance – (Chapter 9)
自遺其咎	Then naturally their loss is your own fault. (Chapter 9)
功遂身退	When the task is successful, the self should let go of it. (Chapter 9)
天之道	This is the Way of heaven. (Chapter 9)
載營魄抱一	Carrying and managing a body while embracing the One, (Chapter 10)
能無離乎	Are you able to not separate them? (Chapter 10)
專氣致柔	Concentrating your Qi to become soft, (Chapter 10)
能嬰兒乎	Are you able to be like a newborn infant? (Chapter 10)
滌除玄覽	Cleansing and clearing your deep and mysteriousperception, (Chapter 10)
能無疵乎	Are you able to be without blemish? (Chapter 10)
愛民治國	Loving the citizens and governing the nation, (Chapter 10)
能無為乎	Are you able to use non-action? (Chapter 10)
天門開闔	Opening and closing the gateway of heaven, (Chapter 10)
能為雌乎	Are you able to serve as the feminine? (Chapter 10)
明白四達	Attaining clear insight in all directions, (Chapter 10)
能無[以]知乎	Are you able to not use your knowledge? (Chapter 10)
生之畜之	Creating them and raising them, (Chapter 10)
生而不有	Creating but not possessing, (Chapter 10)
為而不恃	Acting but not concerned with the results, (Chapter 10)
長而不宰	Leading yet not governing – (Chapter 10)
是謂玄德	This is called deep and mysterious De. (Chapter 10)
三十輻共一轂	Thirty spokes of a wheel share one hub; (Chapter 11)
當其無有車之用	In its emptiness exists the usefulness of the cart. (Chapter 11)
埏埴以為器	Mix water with clay thus making a vessel; (Chapter 11)
當其無有器之用	In its emptiness exists the usefulness of the vessel. (Chapter 11)
鑿戶牖以為室	Cut out doors and windows thus making a room; (Chapter 11)
當其無有室之用	In their emptiness exists the usefulness of the room. (Chapter 11)
故有之以為利	Therefore : what exists thus makes a thing profitable; (Chapter 11)
無之以為用	Emptiness thus makes it useful. (Chapter 11)
五色令人目盲	The five colors can make people’s eyes blind. (Chapter 12)
五音令人耳聾	The five tones can make people’s ears deaf. (Chapter 12)
五味令人口爽	The five flavors can make people’s mouths dull. (Chapter 12)
馳騁畋獵令人心發狂	Excessive hunting and horse racing can make people’sheart/minds become wild. (Chapter 12)
難得之貨令人行妨	Rare goods can make people’s behavior corrupt. (Chapter 12)
是以聖人	Thus the sage : (Chapter 12)
為腹不為目	Acts on what is inside, he does not act on what he sees. (Chapter 12)
故去彼取此	Therefore he leaves that and chooses this. (Chapter 12)
寵辱若驚	Favor and disgrace seem alarming. (Chapter 13)
貴大患若身	High rank brings great suffering if you have a self. (Chapter 13)
何謂寵辱若驚	What is meant by “favor and disgrace seem alarming”? (Chapter 13)
寵為下得之若驚	Favor makes you the inferior, so gaining it seems alarming. (Chapter 13)
失之若驚	Losing it also seems alarming. (Chapter 13)
是謂寵辱若驚	This is what is meant by “favor and disgrace seemalarming”. (Chapter 13)
何謂貴大患若身	What is meant by “high rank brings great suffering if youhave a self”? (Chapter 13)
吾所以有大患者為吾有身	I am the reason that I have great suffering, I who act likeI have a self. (Chapter 13)
及吾無身吾有何患	When I am without a self, how could I have suffering? (Chapter 13)
故貴以身為天下	Therefore : he who is high ranking and uses his self toserve the world – (Chapter 13)
若可[以]寄天下[矣]	It seems he can thus be entrusted with the world! (Chapter 13)
愛以身為天下	He who is loving and uses his self to serve the world – (Chapter 13)
若可[以]託天下[矣]	It seems he can thus be entrusted with the world! (Chapter 13)
視之不見名曰夷	Look, it is not seen; its name is called elusive. (Chapter 14)
聽之不聞名曰希	Listen, it is not heard; its name is called tenuous. (Chapter 14)
搏之不得名曰微	Grasp, it is not gotten; its name is called subtle andobscure. (Chapter 14)
此三者不可致詰	These three things can not be investigated any further – (Chapter 14)
故混而為一	Therefore they blend and become one. (Chapter 14)
[一者]	This one thing : (Chapter 14)
其上不皦	Its highest point is not bright; (Chapter 14)
其下不昧	Its lowest point is not dark. (Chapter 14)
繩繩[兮]不可名	Continuous and unending!, it can not be named; (Chapter 14)
復歸於無物	It returns to non-existence. (Chapter 14)
是謂無狀之狀	It is called the form of that which is without-form; (Chapter 14)
無物之象	The image of non-existence. (Chapter 14)
是謂惚恍	It is called confusing and indistinct. (Chapter 14)
迎之不見其首	Meet it and you do not see its beginning; (Chapter 14)
隨之不見其後	Follow it and you do not see its end. (Chapter 14)
執古之道	Hold fast to the Way of the ancients (Chapter 14)
以御今之有	In order to master the present moment. (Chapter 14)
能知古始	The ability to know the ancient beginning – (Chapter 14)
是謂道紀	This is called the main principle of Dao. (Chapter 14)
古之善為士者微妙玄通	The virtue of the ancients made they who were scholarssubtle, mysterious, obscure, deep, and penetrating. (Chapter 15)
深不可識	Their mysterious depths can not be understood. (Chapter 15)
夫唯不可識	Now : only because they can not be understood, (Chapter 15)
故強為之容	Therefore we try to emulate their appearance : (Chapter 15)
豫兮若冬涉川	Hesitant!, as if crossing a winter stream. (Chapter 15)
猶兮若畏四鄰	Wary!, as if afraid of their neighbors all around. (Chapter 15)
儼兮其若客	Respectful!, they are like a visiting guest. (Chapter 15)
渙兮若冰__將釋	Yielding!, like ice that is about to to break off. (Chapter 15)
敦兮其若樸	Honest and genuine!, they are like the uncarved block. (Chapter 15)
曠兮其若谷	Wide and open!, they are like a valley. (Chapter 15)
混兮其若濁	Unclear!, they are like muddy water. (Chapter 15)
孰能濁以靜之徐清	Who can take muddy water and use stillness to slowly andgently make it pure and clear? (Chapter 15)
孰能安以久動之徐生	Who can take what is tranquil and use continual movementto slowly and gently bring it to life? (Chapter 15)
保此道者不欲盈	He who maintains this Way does not desire to be full. (Chapter 15)
夫唯不盈	Now : only because he is not full, (Chapter 15)
是[以]能蔽[而]不__成	Thus he can be hidden and unfinished. (Chapter 15)
致虛極	Attain the utmost emptiness. (Chapter 16)
守靜篤	Maintain a profound stillness. (Chapter 16)
萬物並作	The ten thousand creatures arise in unison, (Chapter 16)
吾以觀[其]復	And thus I observe their return. (Chapter 16)
夫物芸芸各復歸其根	Now : all the myriad creatures return to their source. (Chapter 16)
歸根曰靜	Returning to the source speaks of stillness. (Chapter 16)
[靜]是謂復命	Stillness is called returning to the natural order. (Chapter 16)
復命曰常	Returning to the natural order speaks of the ever-constant. (Chapter 16)
知常曰明	Knowing the ever-constant speaks of insight. (Chapter 16)
不知常妄作凶	Not knowing the ever-constant is foolish and createsmisfortune. (Chapter 16)
知常容	Knowing the ever-constant leads to tolerance. (Chapter 16)
容乃公	Being tolerant leads to being just and unbiased. (Chapter 16)
公乃王	Being just and unbiased leads to being kingly. (Chapter 16)
王乃天	Being kingly leads to heaven. (Chapter 16)
天乃道	Heaven leads to Dao. (Chapter 16)
道乃久	Dao leads to what endures. (Chapter 16)
沒身不殆	When the self disappears, there can be no danger. (Chapter 16)
太上下知有之	The existence of the best ruler is barely known to thepeople. (Chapter 17)
其次親而譽之	Next is one who they love and praise. (Chapter 17)
其次畏之	Next is one who they fear. (Chapter 17)
其次侮之	Next is one who they ridicule. (Chapter 17)
信不足焉有不信__	If the ruler does not trust enough, then he will not haveanyone’s trust. (Chapter 17)
猶兮其貴言	Thoughtful!, he values his words. (Chapter 17)
功成事遂	When tasks are accomplished and duties are successful, (Chapter 17)
百姓皆謂我自然	The 100 families all say “we are naturally so”. (Chapter 17)
大道廢	When the great Dao is abandoned, (Chapter 18)
有仁義	There exists kindness and morality. (Chapter 18)
慧智出	When intelligence and wisdom arise, (Chapter 18)
有大偽	There exists a great deal of deception. (Chapter 18)
六親不和	When the six relationships are not in harmony, (Chapter 18)
有孝慈	There exists devoted children and loving parents. (Chapter 18)
國家昏亂	When the nation and the families are very confused, (Chapter 18)
有忠臣	There exists loyal officials. (Chapter 18)
絕聖棄智	Renounce sacredness, abandon wisdom, (Chapter 19)
民利百倍	And the citizens benefit 100-fold. (Chapter 19)
絕仁棄義	Renounce kindness, abandon morality, (Chapter 19)
民復孝慈	And the citizens return to being devoted children andloving parents. (Chapter 19)
絕巧棄利	Renounce cleverness, abandon profit, (Chapter 19)
盜賊無有	And thieves and bandits will not exist. (Chapter 19)
此三者以為文不足	These three things thus make a civilized society, but are notenough. (Chapter 19)
故令有所屬	Therefore : to ensure the citizens have a place to belong – (Chapter 19)
見素	See the simplicity, (Chapter 19)
抱樸	Embrace the concept of the uncarved block, (Chapter 19)
少私	Less selfishness, (Chapter 19)
寡欲	Fewer desires. (Chapter 19)
絕學無憂	Renounce learning and be without worry. (Chapter 20)
唯之與阿	“Yes” together with “yeah” – (Chapter 20)
相去幾何	What is their mutual distance or nearness? (Chapter 20)
美之與惡	Beautiful together with ugliness – (Chapter 20)
相去若何	What is their mutual distance or similarity? (Chapter 20)
人之所畏不可不畏	That which people fear, they are not able to not fear. (Chapter 20)
荒兮其未央哉	How ridiculous! They are not yet centered! (Chapter 20)
眾人熙熙	Everyone is very festive, (Chapter 20)
如享太牢	As if enjoying the Tai Lao sacrifice, (Chapter 20)
如春登臺	As if climbing terraces in the spring. (Chapter 20)
我獨泊兮	I alone am unmoved! – (Chapter 20)
其未兆	Like one who has not yet given any sign, (Chapter 20)
如嬰兒之未孩	Like a newborn infant who does not yet act like a baby. (Chapter 20)
儽儽兮若無所歸	Very tired and worn out!, as if without a place to return to. (Chapter 20)
眾人皆有餘	Everyone all has more than they need; (Chapter 20)
__我獨若遺	I alone seem to have lost everything. (Chapter 20)
我愚人之心也哉	I have the heart/mind of a foolish person, indeed!! (Chapter 20)
沌沌兮	I am very mixed up and confused! (Chapter 20)
俗人昭昭	Common people are very clear and bright; (Chapter 20)
我獨若昏	I alone seem confused. (Chapter 20)
俗人察察	Common people are very observant and alert; (Chapter 20)
我獨悶悶	I alone am very gloomy and depressed. (Chapter 20)
澹兮其若海	Tranquil!, they are like the ocean; (Chapter 20)
漂兮若無[所]止	I drift on the wind!, as if without a place to rest. (Chapter 20)
眾人皆有以	Everyone all has a purpose; (Chapter 20)
__我獨頑似鄙	I alone am stupid and stubborn, and appear mean andshallow. (Chapter 20)
我獨異於人	I alone am different compared to other people, (Chapter 20)
而貴食母	And value the food of the mother. (Chapter 20)
孔德之容唯道是從	The greatest De is possible only when Dao is followed. (Chapter 21)
道之為物唯恍唯惚	The action of Dao on creatures is just indistinct, justconfusing. (Chapter 21)
惚兮恍兮其中有象	Confusing! and indistinct!, within it exists image. (Chapter 21)
恍兮惚兮其中有物	Indistinct! and confusing!, within it exists things. (Chapter 21)
窈兮冥兮其中有精	Obscure! and dark!, within it exists essence. (Chapter 21)
其精甚真	Its essence is extremely real and true. (Chapter 21)
其中有信	Within it exists truth. (Chapter 21)
自今及古	From the present, reaching to antiquity, (Chapter 21)
其名不去	Its name has not departed – (Chapter 21)
以閱眾甫	Thus I observe the father of the multitudes. (Chapter 21)
吾何以知眾甫之然哉	How do I thus know the father of the multitudes is likethis? (Chapter 21)
以此	By means of this. (Chapter 21)
曲則全	What is wrong then becomes whole and perfect. (Chapter 22)
枉則直	What is bent then becomes straight. (Chapter 22)
窪則盈	What is hollow then becomes filled. (Chapter 22)
敝則新	What is worn out then becomes new. (Chapter 22)
少則得	Have little, then gain. (Chapter 22)
多則惑	Have too much, then become confused. (Chapter 22)
是以聖人	Thus the sage : (Chapter 22)
抱一[以]為天下式	Embraces the One, thus serving as an example to theworld – (Chapter 22)
不自見故明	He does not display himself, therefore he has insight. (Chapter 22)
不自是故彰	Does not consider himself correct, therefore hedistinguishes himself. (Chapter 22)
不自伐故有功	Does not boast about himself, therefore he possessesmerit. (Chapter 22)
不自矜故長	Does not brag about himself, therefore he endures. (Chapter 22)
夫唯不爭	Now : only because he does not strive, (Chapter 22)
故天下莫能與之爭	Therefore no one in the world can strive against him. (Chapter 22)
古之所謂	That which the ancients say : (Chapter 22)
曲則全者	“He who is wrong then becomes whole and perfect” – (Chapter 22)
豈虛言哉	How can these be empty words? (Chapter 22)
誠全而歸之	Be truly whole and perfect, and return to it. (Chapter 22)
希言自然	Minimal words are naturally so. (Chapter 23)
故飄風不終朝	Therefore : strong winds do not last the entire morning, (Chapter 23)
驟雨不終日	Sudden rains do not last the entire day. (Chapter 23)
孰為此者天地	Who makes these things?  Heaven and earth. (Chapter 23)
天地尚不能久	Even heaven and earth can not maintain them forever, (Chapter 23)
而況於人乎	And so how much less can people? (Chapter 23)
故從事於道者	Therefore : of those who engage in Dao – (Chapter 23)
道者同於道	He who Daos is one with Dao. (Chapter 23)
德者同於德	He who Des is one with De. (Chapter 23)
失者同於失	He who loses is one with the loss. (Chapter 23)
同於道者	For he who is one with Dao, (Chapter 23)
道亦樂得之	Dao is also pleased to have him. (Chapter 23)
同於德者	For he who is one with De, (Chapter 23)
德亦樂得之	De is also pleased to have him. (Chapter 23)
同於失者	For he who is one with loss, (Chapter 23)
失亦樂得之	Loss is also pleased to have him. (Chapter 23)
信不足焉有不信__	If you do not trust enough, then you will not have (Chapter 23)
企者不立	He who stands on tiptoe does not really stand. (Chapter 24)
跨者不行	He who stands astride can not travel. (Chapter 24)
自見者不明	He who displays himself does not have insight. (Chapter 24)
自是者不彰	He who considers himself correct does not distinguishhimself. (Chapter 24)
自伐者無功	He who boasts about himself is without merit. (Chapter 24)
自矜者不長	He who brags about himself does not endure. (Chapter 24)
其在道也	He who lives in Dao – (Chapter 24)
曰餘食贅行	Calls these leftover food and unnecessary behavior. (Chapter 24)
物或惡之	Creatures detest them, no matter what. (Chapter 24)
故有道者不處	Therefore : he who possesses Dao does not live by them. (Chapter 24)
有物混成	Something existed unformed yet complete, (Chapter 25)
先天地生	Before heaven and earth were created. (Chapter 25)
寂兮寥兮	Silent!  Empty! (Chapter 25)
獨立不改	Standing alone, not changing. (Chapter 25)
周行而不殆	It circulates everywhere, and causes no danger. (Chapter 25)
可以為天下母	It can be considered the mother of the world. (Chapter 25)
吾不知其名	I do not know its name; (Chapter 25)
字之曰道	Its symbol is called Dao. (Chapter 25)
強為之名曰大	If I tried to make its name, I would call it great. (Chapter 25)
大曰逝	Being great speaks of departing. (Chapter 25)
逝曰遠	Departing speaks of being remote. (Chapter 25)
遠曰反	Being remote speaks of returning. (Chapter 25)
__道大	Dao is great, (Chapter 25)
天大	Heaven is great, (Chapter 25)
地大	Earth is great, (Chapter 25)
王亦大	The king is also great. (Chapter 25)
域中有四大	Within the realm exist four that are great, (Chapter 25)
而王居其一焉	And the king resides as one of them! (Chapter 25)
人法地	People follow the earth. (Chapter 25)
地法天	The earth follows heaven. (Chapter 25)
天法道	Heaven follows Dao. (Chapter 25)
道法自然	Dao follows what is naturally so. (Chapter 25)
重為輕根	Serious serves as the source of frivolous. (Chapter 26)
靜為躁君	Stillness serves as the ruler of restlessness. (Chapter 26)
是以君子終日	Thus the noble man travels the entire day, (Chapter 26)
行不離[其]輜	And does not stray from his wagon. (Chapter 26)
重雖有榮觀燕	He is serious, even though glorious sights and feasts exist; (Chapter 26)
處超然	He lives above them, like this. (Chapter 26)
奈何萬乘之主	So how could one be the master of ten thousand chariots, (Chapter 26)
而以身輕天下	And conduct his self frivolously in the world? (Chapter 26)
輕則失本	Be frivolous, then lose the source. (Chapter 26)
躁則失君	Be restless, then lose the rulership. (Chapter 26)
善行無轍迹	A good traveler is without wagon track or footprint. (Chapter 27)
善言無瑕謫	A good speaker is without flaw or disgrace. (Chapter 27)
善數不用籌策	A good accountant does not use counting tokens. (Chapter 27)
善閉無關楗而不可開	A good barrier is without bar or lock, yet can not beopened. (Chapter 27)
善結無纆約而不可解	A good binding is without cord or restraint, yet can not beloosened. (Chapter 27)
是以聖人	Thus the sage : (Chapter 27)
常善救人	Is always good at helping people, (Chapter 27)
故無棄人	Therefore he does not abandon people. (Chapter 27)
常善救物	Is always good at helping creatures, (Chapter 27)
故無棄物	Therefore he does not abandon creatures. (Chapter 27)
是謂襲明	This is called following your insight. (Chapter 27)
故善人者不善人之師	Therefore : he who is a virtuous person is the teacher of hewho is not a virtuous person. (Chapter 27)
不善人者善人之資	He who is not a virtuous person is the resource of he whois a virtuous person. (Chapter 27)
不貴其師	If the latter does not value his teacher, (Chapter 27)
不愛其資	Or the former does not love his resource, (Chapter 27)
雖智大迷	Even if there is wisdom, there will be great confusion. (Chapter 27)
是謂要妙	This is called the essential subtle mystery. (Chapter 27)
知其雄守其雌	Know your maleness, but maintain your femaleness. (Chapter 28)
為天下谿	Serve as a stream to the world. (Chapter 28)
為天下谿	Serving as a stream to the world, (Chapter 28)
常德不離	The ever-constant De will not depart, (Chapter 28)
復歸於嬰兒	Returning you to the state of the newborn infant. (Chapter 28)
知其白守其黑	Know your brightness, but maintain your darkness. (Chapter 28)
為天下式	Serve as an example to the world. (Chapter 28)
為天下式	Serving as an example to the world, (Chapter 28)
常德不忒	The ever-constant De will not falter, (Chapter 28)
復歸於無極	Returning you to the state of the limitless. (Chapter 28)
知其榮守其辱	Know your honor, but maintain your disgrace. (Chapter 28)
為天下谷	Serve as a valley to the world. (Chapter 28)
為天下谷	Serving as a valley to the world, (Chapter 28)
常德乃足	The ever-constant De will then be sufficient, (Chapter 28)
復歸於樸	Returning you to the state of the uncarved block. (Chapter 28)
樸散則為器	When the uncarved block is broken up, then it becomestools. (Chapter 28)
聖人用之則為官長	When the sage uses it, then he becomes the seniorgovernment official. (Chapter 28)
故大制不割	Therefore : the greatest cutting does not divide. (Chapter 28)
將欲取天下而為之	Would you take hold of the world and control it? (Chapter 29)
吾見其不得已	I see you have no choice. (Chapter 29)
[夫]天下神器	Now : the world is a divine vessel, (Chapter 29)
不可為也	You can not control it (indeed!). (Chapter 29)
為者敗之	He who acts, ruins it; (Chapter 29)
執者失之	He who grasps, loses it. (Chapter 29)
故物	Therefore : creatures are (Chapter 29)
或行或隨	Sometimes active, sometimes passive, (Chapter 29)
或歔或吹	Sometimes breathe heavy, sometimes breathe easy, (Chapter 29)
或強或羸	Sometimes strong, sometimes weak, (Chapter 29)
或挫或隳	Sometimes oppressed, sometimes overthrown. (Chapter 29)
是以聖人	Thus the sage : (Chapter 29)
去甚	Removes the extremes, (Chapter 29)
去奢	Removes the extravagant and wasteful, (Chapter 29)
去泰	Removes the arrogance. (Chapter 29)
以道佐人主者	He who uses Dao to assist the master of the people (Chapter 30)
不以兵強天下	Does not use weapons or strength on the world, (Chapter 30)
其事好還	For his troubles would likely return – (Chapter 30)
師之所處荊棘生	In the dwelling places of armies, thorns and brambles areproduced, (Chapter 30)
焉大軍之後必有凶年	And so what is left behind a great army must have a badyear. (Chapter 30)
善者果而已	He who has virtue gets results and stops. (Chapter 30)
不敢以取強	He does not dare to take by using strength. (Chapter 30)
果而勿矜	He gets results, but never brags. (Chapter 30)
果而勿伐	Gets results, but never boasts. (Chapter 30)
果而勿驕	Gets results, but is not arrogant. (Chapter 30)
果而不得已	Gets results, but only when he has no choice. (Chapter 30)
果而勿強	Gets results, but never uses strength. (Chapter 30)
物壯則老	When creatures are robust but old, (Chapter 30)
是謂不道	This is called “not Dao”. (Chapter 30)
不道早已	That which is “not Dao” has an early finish. (Chapter 30)
夫佳兵者不祥之器	Now : fine weapons, they are not tools of good fortune. (Chapter 31)
物或惡之	Creatures detest them, no matter what. (Chapter 31)
故有道者不處	Therefore : he who possesses Dao does not live by them. (Chapter 31)
君子居則貴左	When a noble man is in his dwelling, then he honors theleft. (Chapter 31)
用兵則貴右	When he commands troops, then he honors the right. (Chapter 31)
兵者不祥之器	Weapons, they are not tools of good fortune. (Chapter 31)
非君子之器	They are not the tools of a noble man. (Chapter 31)
不得已而用之	When he has no choice but to use them, (Chapter 31)
恬淡為上	To be calm and indifferent is superior – (Chapter 31)
____勿美[也]	Never pleased, indeed! (Chapter 31)
而美之者是樂殺人	And he who is pleased enjoys killing people. (Chapter 31)
夫樂殺人者	Now : he who enjoys killing people (Chapter 31)
__不可以得志於天下矣	Can not get what he desires from the world! (Chapter 31)
[故]吉事尚左	Therefore : in fortunate affairs honor the left, (Chapter 31)
凶事尚右	In unfortunate affairs honor the right. (Chapter 31)
[是以]偏將軍居左	Thus the assistant general of the army resides on the left, (Chapter 31)
上將軍居右	The supreme general of the army resides on the right. (Chapter 31)
言以喪禮處之	Thus we say they are dwelling at a funeral : (Chapter 31)
殺人__眾	When many people are killed, (Chapter 31)
以哀悲泣之	Then mourn and weep with grief for them. (Chapter 31)
戰勝以喪禮處之	Victory in war thus means they will dwell at a funeral. (Chapter 31)
道常無名	Dao is ever-constantly without-name. (Chapter 32)
樸雖小	Even though the concept of the uncarved block seemsinsignificant, (Chapter 32)
天下莫能臣__	No one in the world can conquer it. (Chapter 32)
侯王若能守之	If nobles and kings could maintain it, (Chapter 32)
萬物將自賓	The ten thousand creatures would naturally obey. (Chapter 32)
天地相合	Heaven and earth would join with each other, (Chapter 32)
以降甘露	Thus dropping a sweet dew. (Chapter 32)
民莫之令	There are no citizens who would make this happen, (Chapter 32)
而自均	Yet it would be naturally fair and impartial. (Chapter 32)
[焉]始制有名	And so, begin to divide and you have names. (Chapter 32)
名亦既有	Once names exist, (Chapter 32)
夫亦將知止	Men should also be ready to know when to stop. (Chapter 32)
知止所以不殆	Knowing when to stop is the reason that there is no danger. (Chapter 32)
譬道之在天下	An analogy for the action of Dao in the world : (Chapter 32)
猶川谷之與江海	It is similar to a stream in a valley that becomes part of a (Chapter 32)
知人者智	He who knows people is wise; (Chapter 33)
自知者明	He who knows himself has insight. (Chapter 33)
勝人者有力	He who is victorious over people possesses power; (Chapter 33)
自勝者強	He who is victorious over himself is strong. (Chapter 33)
知足者富	He who knows he has enough is wealthy; (Chapter 33)
強行者有志	He who uses force possesses ambition. (Chapter 33)
不失其所者久	He who does not lose his place endures; (Chapter 33)
死而不亡者壽	He who dies yet does not perish has longevity. (Chapter 33)
大道氾兮	Great Dao is like a vast flood! (Chapter 34)
其可左右	It is able to flow left and right. (Chapter 34)
萬物恃之以生	The ten thousand creatures depend on it in order for life, (Chapter 34)
而不辭	And are not rejected. (Chapter 34)
功成遂	It accomplishes its tasks successfully, (Chapter 34)
[而]不名有	Yet does not possess a name. (Chapter 34)
衣養萬物	It clothes and supports the ten thousand creatures, (Chapter 34)
而不為主	But does not act as their master. (Chapter 34)
[故]常無欲	Therefore : since it is ever-constantly without-desire, (Chapter 34)
可名於小	It can then be named insignificant. (Chapter 34)
萬物歸焉	Since the ten thousand creatures return to it (Chapter 34)
而不為主	But it does not act as their master, (Chapter 34)
可名於大	It can then be named great. (Chapter 34)
是以聖人之能成大	Thus the sage can achieve greatness (Chapter 34)
[以其不為大]	Because he does not act great. (Chapter 34)
故能成__大	Therefore he can achieve greatness. (Chapter 34)
執大象	Holding fast to the great image, (Chapter 35)
天下往	The entire world comes towards you. (Chapter 35)
往而不害	Comes towards you, and meeting with no harm, (Chapter 35)
安平太	There is the greatest peace and calm. (Chapter 35)
樂與餌過客止	Music together with good food make passing guests stay, (Chapter 35)
道之出言淡呵	But Dao’s words are bland! (Chapter 35)
其無味	They are without flavor. (Chapter 35)
視之不足見	Look for it, there is not enough to see. (Chapter 35)
聽之不足聞	Listen for it, there is not enough to hear. (Chapter 35)
用之不足既	Use it, there is not enough to exhaust. (Chapter 35)
將欲歙之	When you are about to gather something, (Chapter 36)
必固張之	You must have originally spread it out. (Chapter 36)
將欲弱之	When you are about to weaken something, (Chapter 36)
必固強之	You must have originally strengthened it. (Chapter 36)
將欲廢之	When you are about to abandon something, (Chapter 36)
必固興之	You must have originally been interested in it. (Chapter 36)
將欲奪之	When you are about to seize something, (Chapter 36)
必固與之	You must have originally given it. (Chapter 36)
是謂微明	This is called subtle and obscure insight. (Chapter 36)
柔弱勝剛強	What is soft and weak conquers what is hard and strong. (Chapter 36)
魚不可脫於淵	Fish can not escape from the deep; (Chapter 36)
國之利器	The sharp tools of the nation (Chapter 36)
不可以示人	Can not be shown to the people. (Chapter 36)
道常無為	Dao ever-constantly practices non-action, (Chapter 37)
而無不為	Yet nothing is left undone. (Chapter 37)
侯王若能守之	If nobles and kings could maintain it, (Chapter 37)
萬物將自化	The ten thousand creatures would naturally transform. (Chapter 37)
化而欲作	Transform, and if desire arises, (Chapter 37)
吾將鎮之以無名之樸	I would restrain it by means of the nameless uncarvedblock. (Chapter 37)
無名之樸	In the state of the nameless uncarved block, (Chapter 37)
夫亦將無欲	Men also would be without-desire. (Chapter 37)
不欲以靜	Not desiring, thus they would be still – (Chapter 37)
天下將自定	And the world would naturally settle. (Chapter 37)
上德不德是以有德	A man of highest De does not use his De, thus hepossesses De. (Chapter 38)
下德不失德是以無德	A man of inferior De does not lose his De, thus he iswithout De. (Chapter 38)
上德無為而無以為	A man of highest De uses non-action, and acts withoutmotive. (Chapter 38)
下德為之而有以為	A man of inferior De coerces others, and has a motive toact. (Chapter 38)
上仁為之而無以為	A man of highest kindness coerces others, and actswithout motive. (Chapter 38)
上義為之而有以為	A man of highest morality coerces others, and has amotive to act. (Chapter 38)
上禮為之而莫之以應	A man of highest propriety coerces others, and if thereis no one who responds, (Chapter 38)
則攘臂而仍之	Then he rolls up his sleeves and keeps doing it. (Chapter 38)
故失道而後德	Therefore : lose Dao, and later comes De. (Chapter 38)
失德而後仁	Lose De, and later comes kindness. (Chapter 38)
失仁而後義	Lose kindness, and later comes morality. (Chapter 38)
失義而後禮	Lose morality, and later comes propriety. (Chapter 38)
夫禮者忠信之薄	Now : propriety is that which is merely the appearance ofloyalty and honesty, (Chapter 38)
而亂之首	And the beginning of confusion. (Chapter 38)
前識者道之華	He who is ahead in knowledge has the flower of Dao, (Chapter 38)
而愚之始	But the beginning of stupidity and foolishness. (Chapter 38)
是以大丈夫	Thus the greatest elders : (Chapter 38)
處其厚不居其薄	Live by Dao’s substance, and do not dwell on Dao’sappearance. (Chapter 38)
處其實不居其華	Live on Dao’s fruit, and do not dwell on Dao’s flower. (Chapter 38)
故去彼取此	Therefore they leave that and choose this. (Chapter 38)
昔之得一者	Of those who in ancient times attained oneness : (Chapter 39)
天得一以清	Heaven attained oneness, thus becoming pure and clear. (Chapter 39)
地得一以寧	Earth attained oneness, thus becoming stable. (Chapter 39)
神得一以靈	Spirit attained oneness, thus becoming potent. (Chapter 39)
谷得一以盈	The valley attained oneness, thus becoming full. (Chapter 39)
萬物得一以生	The ten thousand creatures attained oneness, thusbecoming alive. (Chapter 39)
侯王得一以為天下貞	Nobles and kings attained oneness, thus serving the worldfaithfully. (Chapter 39)
其致之	They attained it. (Chapter 39)
天無以清	If heaven could not use its purity and clarity, (Chapter 39)
將恐裂	I fear it would split apart. (Chapter 39)
地無以寧	If earth could not use its stability, (Chapter 39)
將恐發	I fear it would erupt. (Chapter 39)
神無以靈	If spirit could not use its potency, (Chapter 39)
將恐歇	I fear it would cease to be. (Chapter 39)
谷無以盈	If the valley could not use its fullness, (Chapter 39)
將恐竭	I fear it would be used up. (Chapter 39)
萬物無以生	If the ten thousand creatures could not use their life, (Chapter 39)
將恐滅	I fear they would be destroyed. (Chapter 39)
侯王無以貴高	If nobles and kings could not use their high rank andprominence, (Chapter 39)
將恐蹶	I fear they would fall. (Chapter 39)
故貴以賤為本	Therefore : humility thus serves as the source of high rank; (Chapter 39)
高以下為基	Low thus serves as the foundation of high. (Chapter 39)
是以侯王自謂孤寡不穀	Thus nobles and kings call themselves orphaned, lonely,and unlucky. (Chapter 39)
此非以賤為本邪	Does this not mean that humility thus serves as the source? (Chapter 39)
非乎	Does it not? (Chapter 39)
故致數輿無輿	Therefore : to attain exceptional popularity is to be withoutpopularity – (Chapter 39)
不欲琭琭如玉	Do not desire to be scarce like jade, (Chapter 39)
珞珞如石	But common like rock. (Chapter 39)
反者道之動	The movement of Dao returns things. (Chapter 40)
弱者道之用	The function of Dao is to weaken things. (Chapter 40)
天下萬物生於有	The ten thousand creatures of the world are created frombeing; (Chapter 40)
有生於無	Being is created from non-being. (Chapter 40)
上士聞道勤而行之	The superior scholar hearing of Dao works hard andpractices it. (Chapter 41)
中士聞道若存若亡	The average scholar hearing of Dao seems to keep it,seems to lose it. (Chapter 41)
下士聞道大笑之	The inferior scholar hearing of Dao laughs greatly at it. (Chapter 41)
不笑不足以為道	If he did not laugh, it would not be qualified to be Dao. (Chapter 41)
故建言有之曰	Therefore : in the established sayings that exist, it is said – (Chapter 41)
明道若昧	Insight into Dao seems like darkness. (Chapter 41)
進道若退	Advancing in Dao seems like retreating. (Chapter 41)
夷道若纇	Smooth Dao seems knotted. (Chapter 41)
上德若谷	Superior De seems like a valley. (Chapter 41)
大白若辱	The greatest purity seems like disgrace. (Chapter 41)
廣德若不足	The most extensive De seems like it is not enough. (Chapter 41)
建德若偷	Established De seems aimless. (Chapter 41)
質真若渝	Real and true character seems inconsistent. (Chapter 41)
大方無隅	The greatest region is without borders. (Chapter 41)
大器晚成	The greatest vessel is last to be completed. (Chapter 41)
大音希聲	The greatest tone is a tenuous sound. (Chapter 41)
大象無形	The greatest image is without-form. (Chapter 41)
道隱無名	Dao is hidden and without-name. (Chapter 41)
夫唯道善始且善成	Now : only Dao is good at beginning and also good at (Chapter 41)
道生一	Dao creates one. (Chapter 42)
一生二	One creates two. (Chapter 42)
二生三	Two creates three. (Chapter 42)
三生萬物	Three creates the ten thousand creatures. (Chapter 42)
萬物負陰而抱陽	The ten thousand creatures carry Yin and embrace Yang, (Chapter 42)
沖氣以為和	Pouring their Qi together, thus becoming harmonious. (Chapter 42)
人之所惡	That which people detest : (Chapter 42)
唯孤寡不穀	Being alone, orphaned, lonely, and unlucky – (Chapter 42)
而王公以自稱	Yet kings and nobles thus name themselves. (Chapter 42)
故物	Therefore : creatures (Chapter 42)
或損之而益	Sometimes lose, yet they gain; (Chapter 42)
或益之而損	Sometimes gain, yet they lose. (Chapter 42)
人之所教我亦教之	That which people teach, I also teach : (Chapter 42)
強梁者不得其死	Those who are bullies and hoodlums do not meet theirnatural death. (Chapter 42)
吾將以為教父	I will thus become their elder teacher. (Chapter 42)
天下之至柔	The softest things of the world (Chapter 43)
馳騁天下之至堅	Overrun the hardest things of the world. (Chapter 43)
無有入無間	Non-being can enter where there is no space in between. (Chapter 43)
吾是以知無為之有益	Thus I know that non-action has benefits. (Chapter 43)
不言之教	The teaching of no-talking, (Chapter 43)
無為之益	The benefit of non-action – (Chapter 43)
天下希及之	Few in the world attain these. (Chapter 43)
名與身孰親	Fame and self : which do you love? (Chapter 44)
身與貨孰多	Self and property : which is greater? (Chapter 44)
得與亡孰病	Gain and loss : which is the affliction? (Chapter 44)
甚愛必大費	Extreme desire must lead to great expense. (Chapter 44)
多藏必厚亡	Collecting too much must lead to substantial loss. (Chapter 44)
知足不辱	Knowing when you have enough, there can be no disgrace. (Chapter 44)
知止不殆	Knowing when to stop, there can be no danger. (Chapter 44)
可以長久	Then you can forever endure. (Chapter 44)
大成若缺	Great achievement seems incomplete, (Chapter 45)
其用不弊	But its usefulness is not impaired. (Chapter 45)
大盈若盅	Great fullness is like a cup or bowl, (Chapter 45)
其用不窮	Its usefulness is not exhausted. (Chapter 45)
大直若屈	Great straightness seems bent. (Chapter 45)
大巧若拙	Great skillfulness seems clumsy. (Chapter 45)
大辯若訥	Great debaters seem slow of speech. (Chapter 45)
躁勝寒	Restlessness conquers cold. (Chapter 45)
靜勝熱	Stillness conquers heat. (Chapter 45)
清靜為天下正	Purity and clarity along with stillness makes the world (Chapter 45)
天下有道	When the world possesses Dao, (Chapter 46)
卻走馬以糞	Riding horses are nonetheless used for manure. (Chapter 46)
天下無道	When the world is without Dao, (Chapter 46)
戎馬生於郊	War-horses are bred in the countryside. (Chapter 46)
罪莫大於可欲	There is no fault greater than the capacity for desire. (Chapter 46)
禍莫大於不知足	There is no misfortune greater than not knowing whenyou have enough. (Chapter 46)
咎莫大於欲得	There is no error greater than desire for gain. (Chapter 46)
故知足之足常足矣	Therefore : knowing the sufficiency of having enough, (Chapter 46)
不出戶	You do not have to go out the door (Chapter 47)
[以]知天下	In order to to know the world. (Chapter 47)
不闚牖	You do not have to look out the window (Chapter 47)
[以]知天道	In order to to know the Way of heaven. (Chapter 47)
其出彌遠	The farther you go out, (Chapter 47)
其知彌少	You know even less. (Chapter 47)
是以聖人	Thus the sage : (Chapter 47)
不行而知	Does not travel, yet knows. (Chapter 47)
不見而名	Does not display himself, yet has a reputation. (Chapter 47)
不為而成	Does not act, yet accomplishes. (Chapter 47)
為學者日益	The actions of those who learn daily increase. (Chapter 48)
為道者日損	The actions of those who Dao daily decrease. (Chapter 48)
損之又損	Decreasing and again decreasing, (Chapter 48)
以至於無為	In order to arrive at non-action. (Chapter 48)
無為而無不為	Use non-action, and nothing is left undone. (Chapter 48)
取天下常以無事	To take hold of the world, always use non-interference. (Chapter 48)
及其有事	When you are compelled  to interfere, (Chapter 48)
不足以取天下	Then you are not qualified to take hold of the world. (Chapter 48)
聖人無常心	The sage does not have a constant heart/mind, (Chapter 49)
以百姓心為心	Thus the 100 families’ heart/minds become his heart/mind. (Chapter 49)
善者吾善之	He who is virtuous, I am virtuous to him. (Chapter 49)
不善者吾亦善之	He who is not virtuous, I am also virtuous to him. (Chapter 49)
德善	Because De is virtue. (Chapter 49)
信者吾信之	He who is honest, I am honest with him. (Chapter 49)
不信者吾亦信之	He who is not honest, I am also honest with him. (Chapter 49)
德信	Because De is honesty. (Chapter 49)
聖人在天下歙歙	The sage lives in the world, gathering it all in. (Chapter 49)
[焉]為天下渾其心	And so he serves the world, merging with theirheart/minds. (Chapter 49)
百姓皆注其耳目	The 100 families all pay attention to their ears and eyes, (Chapter 49)
聖人皆孩之	And the sage treats them all like his children. (Chapter 49)
出生入死	Between coming out into life and entering death, (Chapter 50)
生之徒十有三	Followers of life are 3 in 10. (Chapter 50)
死之徒十有三	Followers of death are 3 in 10. (Chapter 50)
人之生動之死地	People whose lives are merely moving them towards theplace of death (Chapter 50)
亦十有三	Are also 3 in 10. (Chapter 50)
夫何故	Now : what is the reason? (Chapter 50)
以其生生之厚	Because they live life for its substance. (Chapter 50)
蓋聞善攝生者	But I have heard that he who is skilled at taking in life (Chapter 50)
陵行不遇兕虎	Can travel the mountains and does not meet rhino or tiger, (Chapter 50)
入軍不被甲兵	Can enter a battle not wearing armor or weapons. (Chapter 50)
兕無所投其角	The rhino has no place to thrust its horns, (Chapter 50)
虎無所措其爪	The tiger has no place to use its claws, (Chapter 50)
兵無所容其刃	The weapon has no place to allow its blade. (Chapter 50)
夫何故	Now : what is the reason? (Chapter 50)
以其無死地	Because for him there is no place of death. (Chapter 50)
道生之	Dao creates them, (Chapter 51)
德畜之	De raises them, (Chapter 51)
物形之	Things shape them, (Chapter 51)
勢成之	Circumstances complete them. (Chapter 51)
是以萬物	Thus among the ten thousand creatures, (Chapter 51)
莫不尊道而貴德	There are none who do not respect Dao and honor De. (Chapter 51)
道之尊	Respect of Dao, (Chapter 51)
德之貴	Honor of De – (Chapter 51)
夫莫之命	Now : there is no one who commands this, (Chapter 51)
而常自然	Yet it is always naturally so. (Chapter 51)
故道生之德畜之	Therefore : Dao creates them, De raises them. (Chapter 51)
長之育之	Leads them, nourishes them, (Chapter 51)
亭之毒之	Shelters them, heals  them, (Chapter 51)
養之覆之	Supports them, protects them. (Chapter 51)
生而不有	Creating but not possessing, (Chapter 51)
為而不恃	Acting but not concerned with the results, (Chapter 51)
長而不宰	Leading yet not governing – (Chapter 51)
是謂玄德	This is called deep and mysterious De. (Chapter 51)
天下有始	The world had a beginning, (Chapter 52)
以為天下母	Which can be considered the mother of the world. (Chapter 52)
既得其母	Once you have realized its mother, (Chapter 52)
以知其子	You thus know her children. (Chapter 52)
既知其子	Once you know her children, (Chapter 52)
復守其母	Return to and maintain their mother. (Chapter 52)
沒身不殆	When the self disappears, there can be no danger. (Chapter 52)
塞其兌閉其門	Block your senses, close your gateway – (Chapter 52)
終身不勤	All your life you will not struggle. (Chapter 52)
開其兌濟其事	Open your senses, be successful in your duties – (Chapter 52)
終身不救	All your life you will not have relief. (Chapter 52)
見小曰明	Seeing the insignificant speaks of insight. (Chapter 52)
守柔曰強	Maintaining softness speaks of strength. (Chapter 52)
用其光復歸其明	Use your brightness to return to your insight. (Chapter 52)
無遺身殃	Do not lose your self in misfortune. (Chapter 52)
是謂習常	This is called practicing the ever-constant. (Chapter 52)
使我介然有知	If I correctly use the tiniest bit of knowledge that I possess (Chapter 53)
行於大道	While travelling on the great Way, (Chapter 53)
唯迤是畏	It is only walking off the path that I need to fear. (Chapter 53)
大道甚夷	The great Way is extremely even, (Chapter 53)
而民好徑	But the citizens are fond of side paths. (Chapter 53)
朝甚除	Although the royal court is very well-kept, (Chapter 53)
田甚蕪	The fields are very overgrown with weeds, (Chapter 53)
倉甚虛	The granaries are very empty. (Chapter 53)
服文綵	While at the court they wear refined multicolored silks, (Chapter 53)
帶利劍	Carry sharp swords, (Chapter 53)
厭飲食	Stuff themselves with drink and food, (Chapter 53)
財貨有餘	And have an excess of wealth and goods. (Chapter 53)
是謂盜夸	This is called robbery and extravagance, (Chapter 53)
非道也哉	Not Dao, indeed!! (Chapter 53)
善建者不拔	That which is well established is not uprooted. (Chapter 54)
善抱者不脫	That which is well embraced is not abandoned. (Chapter 54)
子孫以祭祀不輟	Thus children and grandchildren offer sacrifices, and sosacrifices do not stop. (Chapter 54)
修之__身其德乃眞	Cultivate it in the self – your De will then be true and real. (Chapter 54)
修之__家其德乃餘	Cultivate it in the family – its De will then be more thanenough. (Chapter 54)
修之__鄉其德乃長	Cultivate it in the village – its De will then last forever. (Chapter 54)
修之__國其德乃豐	Cultivate it in the nation – its De will then be abundant. (Chapter 54)
修之__天下其德乃普	Cultivate it in the world – its De will then be everywhere. (Chapter 54)
故以身觀身	Therefore : use your self to contemplate the self. (Chapter 54)
以家觀家	Use your family to contemplate the family. (Chapter 54)
以鄉觀鄉	Use your village to contemplate the village. (Chapter 54)
以國觀國	Use your nation to contemplate the nation. (Chapter 54)
以天下觀天下	Use the world to contemplate the world. (Chapter 54)
吾何以知天下然哉	How do I thus know the world is like this? (Chapter 54)
以此	By means of this. (Chapter 54)
含德之厚[者]	He who embodies the substance of De (Chapter 55)
比於赤子	Can be compared to a newborn child : (Chapter 55)
蜂蠆虺蛇不螫	Wasps, scorpions, snakes, and serpents do not sting him, (Chapter 55)
猛獸不據	Fierce beasts do not seize him, (Chapter 55)
攫鳥不摶	Birds of prey do not claw him. (Chapter 55)
骨弱筋柔而握固	His bones are weak, his muscles are soft, yet his grasp isfirm and strong. (Chapter 55)
未知牝牡之合而脧作	He has not yet known the union of female and male, yet hispenis rises. (Chapter 55)
精之至也	He has the utmost essence, indeed! (Chapter 55)
終日號而不嗄	He cries the entire day yet does not get hoarse. (Chapter 55)
和之至也	He has the utmost harmony, indeed! (Chapter 55)
知和曰常	Knowing harmony speaks of the ever-constant. (Chapter 55)
知常曰明	Knowing the ever-constant speaks of insight. (Chapter 55)
益生曰祥	Benefitting life speaks of good fortune. (Chapter 55)
心使氣曰強	Heart/mind making Qi speaks of strength. (Chapter 55)
物壯則老	When creatures are robust but old, (Chapter 55)
謂之不道	We call them “not Dao”. (Chapter 55)
不道早已	That which is “not Dao” has an early finish. (Chapter 55)
知者不言	He who knows does not speak; (Chapter 56)
言者不知	He who speaks does not know. (Chapter 56)
塞其兌閉其門	Block your senses, close your gateway. (Chapter 56)
挫其銳	Blunt your sharpness, (Chapter 56)
解其紛	Loosen your tangles, (Chapter 56)
和其光	Soften your brightness, (Chapter 56)
同其塵	Be the same as the dust of the world. (Chapter 56)
是謂玄同	This is called a deep and mysterious sameness. (Chapter 56)
故不可得而親	Therefore : you can not gain it and be friendly, (Chapter 56)
不可得而疏	Can not gain it and be unfriendly, (Chapter 56)
不可得而利	Can not gain it and benefit, (Chapter 56)
不可得而害	Can not gain it and cause harm, (Chapter 56)
不可得而貴	Can not gain it and have high rank, (Chapter 56)
不可得而賤	Can not gain it and be lowly. (Chapter 56)
故為天下貴	Therefore you become valuable to the world. (Chapter 56)
以正治國	Use honesty and justness when governing a nation. (Chapter 57)
以奇用兵	Use strange and unusual tactics when commanding troops. (Chapter 57)
以無事取天下	Use non-interference to take hold of the world. (Chapter 57)
吾何以知其然哉	How do I thus know it is like this? (Chapter 57)
以此	By means of this : (Chapter 57)
天下多忌諱	The world has many prohibitions and taboos, (Chapter 57)
而民彌貧	And the citizens become even poorer. (Chapter 57)
民多利器	The citizens have many sharp tools, (Chapter 57)
[而]國家滋昏	And the nation and the families grow in confusion. (Chapter 57)
人多知巧	The people have too much knowledge and cleverness, (Chapter 57)
[而]奇物滋起	And strange things begin to increase. (Chapter 57)
法物滋章	Matters of law are increasingly proclaimed, (Chapter 57)
盜賊多有	And more thieves and bandits exist. (Chapter 57)
故聖人云	Therefore : the sage says – (Chapter 57)
我無為而民自化	I use non-action, and the citizens naturally transform. (Chapter 57)
我好靜而民自正	I cherish stillness, and the citizens naturally becomehonest and just. (Chapter 57)
我無事而民自富	I use non-interference, and the citizens naturally becomewealthy. (Chapter 57)
我無欲而民自樸	I am without-desire, and the citizens naturally return to the (Chapter 57)
其政悶悶	If their government is very restrained, (Chapter 58)
其民淳淳	Its citizens will be very genuine and honest. (Chapter 58)
其政察察	If their government is very observant and alert, (Chapter 58)
其民缺缺	Its citizens will be very lacking and deficient. (Chapter 58)
禍兮福之所倚	Misfortune! is that which good fortune leans on. (Chapter 58)
福兮禍之所伏	Good fortune! is that which misfortune lies on. (Chapter 58)
孰知其極	Who knows their limits? (Chapter 58)
其無正	They are not honest and just. (Chapter 58)
正復為奇	Honesty and justness returns, becoming strange andunusual. (Chapter 58)
善復為妖	Virtue returns, becoming weird and strange. (Chapter 58)
人之迷	The confusion of the people – (Chapter 58)
其日固久	Its days have indeed been everlasting. (Chapter 58)
是以聖人	Thus the sage : (Chapter 58)
方而不割	Is honest and does not divide, (Chapter 58)
廉而不劌	Is honorable and does not injure, (Chapter 58)
直而不肆	Is straightforward and does not indulge in excess, (Chapter 58)
光而不燿	Is bright but does not dazzle. (Chapter 58)
治人事天	When governing people or doing heaven’s duties, (Chapter 59)
莫若嗇	It is better to be sparing. (Chapter 59)
夫唯嗇	Now : only when you can be sparing, (Chapter 59)
是謂早服	This is called early acceptance. (Chapter 59)
早服謂之重積德	Early acceptance is called doubling your accumulation ofDe. (Chapter 59)
重積德	With a double accumulation of De, (Chapter 59)
則無不克	Then everything can be overcome. (Chapter 59)
無不克	When everything can be overcome, (Chapter 59)
則莫知其極	Then no one knows your limits. (Chapter 59)
莫知其極	When no one knows your limits, (Chapter 59)
可以有國	You can possess the nation. (Chapter 59)
有國之母	Possessing the mother of the nation, (Chapter 59)
可以長久	You can forever endure. (Chapter 59)
是謂深根固柢	This is called having a deep source and a firm foundation, (Chapter 59)
長生久視之道	The Way of long life and enduring sight. (Chapter 59)
治大國若烹小鮮	Governing a great nation is like cooking a small fish. (Chapter 60)
以道莅天下	Because Dao is present in the world, (Chapter 60)
其鬼不神	Its ghosts do not have spirit. (Chapter 60)
非其鬼不神	Not that its ghosts do not have any spirit, (Chapter 60)
其神不傷人	But their spirit does not injure people. (Chapter 60)
非其神不傷人	Not only does their spirit not injure people, (Chapter 60)
聖人亦不傷人	The sage also does not injure people. (Chapter 60)
夫兩不相傷	Now : since these two do not injure each other, (Chapter 60)
故德交歸焉	Therefore their De merges and returns! (Chapter 60)
大國者下流	A great nation is like the lowest places water can flow – (Chapter 61)
天下之交	The merging place of the world, (Chapter 61)
天下之牝	The female of the world. (Chapter 61)
牝常以靜勝牡	The female always uses stillness to conquer the male. (Chapter 61)
以靜為下	By using stillness, she becomes lower-than. (Chapter 61)
故大國以下小國	Therefore : if a great nation is lower-than a small nation, (Chapter 61)
則取小國	Then it takes hold of the small nation. (Chapter 61)
小國以下大國	If a small nation is lower-than a great nation, (Chapter 61)
則取[於]大國	Then it is taken hold of by the great nation. (Chapter 61)
故或下以取	Therefore : sometimes one nation is lower-than in orderto take hold of, (Chapter 61)
或下而取	Sometimes one nation is lower-than and then it is takenhold of. (Chapter 61)
大國不過欲兼畜人	A great nation merely desires to combine livestock andpeople, (Chapter 61)
小國不過欲入事人	A small nation merely desires to get work for its people. (Chapter 61)
夫兩者各得[其]所欲	Now : for both nations to each get that which is their desire, (Chapter 61)
大者宜為下	It is proper for the great nation to be lower-than. (Chapter 61)
道者萬物之奧	That which Daos is the obscure mystery of the ten thousand       creatures. (Chapter 62)
善人之寶	This is the treasure of a virtuous person, (Chapter 62)
不善人之所保	And that which is the protection of a person who is notvirtuous. (Chapter 62)
美言可以市	Beautiful speech can be used in the market, (Chapter 62)
尊行可以加人	Respectful behavior can benefit people. (Chapter 62)
人之不善	People who are not virtuous, (Chapter 62)
何棄之有	Why abandon them? (Chapter 62)
故立天子	Therefore : when inaugurating the son of heaven, (Chapter 62)
置三公	Or installing the three nobles – (Chapter 62)
雖有拱璧以先駟馬	Even if you possessed jade disks drawn by a team of fourhorses, (Chapter 62)
不如坐進此道	That is not as good as sitting and offering this Way. (Chapter 62)
古之所以貴此道者何	What was the ancients’ reason that they valued this Way? (Chapter 62)
不曰	Did they not say : (Chapter 62)
以求得	Seek in order to obtain, (Chapter 62)
有罪以免邪	Have faults in order to be forgiven? (Chapter 62)
故為天下貴	Therefore Dao becomes valuable to the world. (Chapter 62)
為無為	Act with non-action. (Chapter 63)
事無事	Handle duties with non-interference. (Chapter 63)
味無味	Taste that which is without-flavor. (Chapter 63)
大小多少	Greatness is insignificant, too much is less. (Chapter 63)
報怨以德	Repay animosity with De. (Chapter 63)
圖難於其易	Plan for the difficult while it is easy. (Chapter 63)
為大於其細	Act on the great while it is tiny. (Chapter 63)
天下難事必作於易	In the world, difficult duties certainly start while easy. (Chapter 63)
天下大事必作於細	In the world, great duties certainly start while tiny. (Chapter 63)
是以聖人終不為大	Thus the sage in the end does not act great, (Chapter 63)
故能成其大	Therefore he can achieve his greatness. (Chapter 63)
夫輕諾必寡信	Men who make promises lightly, certainly few will trust. (Chapter 63)
多易必多難	Men who expect most duties to be easy will certainly havemany difficulties. (Chapter 63)
是以聖人猶難之	Thus the sage plans for things to be difficult, (Chapter 63)
故終無難矣	Therefore in the end he is without difficulty! (Chapter 63)
其安易持	What is peaceful is easy to hold. (Chapter 64)
其未兆易謀	What has not yet been revealed is easy to plan for. (Chapter 64)
其脆易泮	What is brittle is easy to shatter. (Chapter 64)
其微易散	What is minute is easy to scatter. (Chapter 64)
為之於未有	Act on it while it does not yet exist. (Chapter 64)
治之於未亂	Govern them while they are not yet confused. (Chapter 64)
合抱之木生於毫末	A tree too big to embrace is created from the tiniest shoot. (Chapter 64)
九層之臺起於累土	A terrace of nine stories rises from a pile of dirt. (Chapter 64)
千里之行始於足下	A journey of a thousand miles begins from under the feet. (Chapter 64)
為者敗之	He who acts, ruins it. (Chapter 64)
執者失之	He who grasps, loses it. (Chapter 64)
是以聖人	Thus the sage : (Chapter 64)
無為故無敗	Does not act, therefore he does not ruin. (Chapter 64)
無執故無失	Does not grasp, therefore he does not lose. (Chapter 64)
民之從事常於幾成而敗之	Citizens are always on the verge of achieving theirundertakings, yet they ruin them. (Chapter 64)
慎終如始	Be as careful in the end as if it was the beginning, (Chapter 64)
則無敗事	Then you will not ruin your affairs. (Chapter 64)
是以聖人	Thus the sage : (Chapter 64)
欲不欲	Desires to not desire, (Chapter 64)
不貴難得之貨	Does not value rare goods, (Chapter 64)
學不學	Learns to not learn. (Chapter 64)
復眾人之所過	He returns to that which everyone else has passed over, (Chapter 64)
以輔萬物之自然	Thus helping the ten thousand creatures to be naturally so, (Chapter 64)
而不敢為	Yet not daring to act. (Chapter 64)
古之善為道者	The virtue of the ancients (they who acted in Dao), (Chapter 65)
非以明民	Did not use it to enlighten the citizens, (Chapter 65)
將以愚之	But would have used it to keep them ignorant – (Chapter 65)
民之難治	The citizens are hard to govern (Chapter 65)
以其知多	Because they have too much knowledge. (Chapter 65)
故以知治國	Therefore : using knowledge to govern the nation (Chapter 65)
國之賊	Is the bane of the nation. (Chapter 65)
不以知治國	Not using knowledge to govern the nation (Chapter 65)
國之福	Is the good fortune of the nation. (Chapter 65)
知此兩者亦稽式	He who has knowledge of these two also has them asexamples. (Chapter 65)
常知稽式	To always understand these examples – (Chapter 65)
是謂玄德	This is called deep and mysterious De. (Chapter 65)
玄德深矣遠矣	Deep and mysterious De is so profound! and remote! (Chapter 65)
與物反矣	That when creatures return, it returns with them! (Chapter 65)
____乃至大順	Then they reach the greatest harmony. (Chapter 65)
江海所以能為百谷王者	The reason that rivers and seas can act as kings of the 100valleys (Chapter 66)
以其善下之	Is because they are good at being lower-than them. (Chapter 66)
故能為百谷王	Therefore : they can act as kings of the 100 valleys. (Chapter 66)
是以[聖人]	Thus the sage : (Chapter 66)
欲上民	In desiring to be above the citizens, (Chapter 66)
必以言下之	He must by means of his speech be lower-than them. (Chapter 66)
欲先民	In desiring to be before the citizens, (Chapter 66)
必以身後之	He must by means of his self be behind them. (Chapter 66)
是以聖人	Thus the sage : (Chapter 66)
處上而民不重	Lives above them, but the citizens are not burdened. (Chapter 66)
處前而民不害	Lives in front of them, but the citizens are not harmed. (Chapter 66)
是以天下樂推而不厭	Thus the world is pleased to promote him, and does nottire of him. (Chapter 66)
以其不爭	Because he does not strive, (Chapter 66)
故天下莫能與之爭	Therefore no one in the world can strive against him. (Chapter 66)
天下皆謂我__大	In the world, all say I am great, (Chapter 67)
似不肖	But do not seem to be like everyone else. (Chapter 67)
夫唯不肖故[能]大	Now : only because I am not like everyone else, therefore Ican be great. (Chapter 67)
若肖	If I was like everyone else, (Chapter 67)
久矣其細也	Long ago! I would have become insignificant, indeed! (Chapter 67)
夫我有三寶	Now : I possess three treasures – (Chapter 67)
持而保之	Hold and maintain them. (Chapter 67)
一曰慈	The first is called compassion, (Chapter 67)
二曰儉	The second is called economy, (Chapter 67)
三曰不敢為天下先	The third is called not daring to act first in the world. (Chapter 67)
慈故能勇	With compassion, you can therefore be brave. (Chapter 67)
儉故能廣	With economy, you can therefore expand. (Chapter 67)
不敢為天下先	By not daring to act first in the world, (Chapter 67)
故能成器長	Therefore you can achieve the capacity for leadership. (Chapter 67)
今舍慈且勇	At present, people abandon compassion but also try to bebrave, (Chapter 67)
舍儉且廣	Abandon economy but also try to expand, (Chapter 67)
舍後且先	Abandon being behind but also try to be first – (Chapter 67)
死矣	This is death! (Chapter 67)
夫慈以戰則勝	Now : when compassion is used in war, the consequenceis victory. (Chapter 67)
以守則固	When it is used for protection, the consequence is strength. (Chapter 67)
天將救之	When heaven would help you, (Chapter 67)
以慈衛之	Using compassion it protects you. (Chapter 67)
善為士者不武	He who is good at being a scholar is not militant. (Chapter 68)
善戰者不怒	He who is good at war does not get angry. (Chapter 68)
善勝敵者不與	He who is good at conquering the enemy does not engagethem. (Chapter 68)
善用人者為之下	He who is good at making use of people acts lower-thanthem. (Chapter 68)
是謂不爭之德	This is called the De of not striving. (Chapter 68)
是謂用人之力	This is called the power of making use of people. (Chapter 68)
是謂配天古之極[也]	This is called joining the elite of heaven’s ancients, indeed! (Chapter 68)
用兵有言	Those who command troops have a saying : (Chapter 69)
吾不敢為主而為客	I dare not act like the master, but instead act like a guest. (Chapter 69)
不敢進寸而退尺	Dare not advance an inch, but instead retreat a foot. (Chapter 69)
是謂行無行	This is called marching without marching, (Chapter 69)
攘無臂	Seizing without using your arms, (Chapter 69)
扔無敵	Routing without having an enemy, (Chapter 69)
執無兵	Defending without using weapons. (Chapter 69)
禍莫大於輕敵	There is no misfortune greater than underestimating theenemy. (Chapter 69)
輕敵幾喪吾寶	By underestimating the enemy, I nearly lose my treasures. (Chapter 69)
故抗兵相若	Therefore : when armies on opposing sides are evenlymatched, (Chapter 69)
[則]哀者勝矣	Then they who mourn will be victorious! (Chapter 69)
吾言甚易知	My words are very easy to understand, (Chapter 70)
甚易行	Very easy to practice. (Chapter 70)
[而]天下莫[之]能知	But there is no one in the world who can understand them, (Chapter 70)
莫[之]能行	There is no one who can practice them. (Chapter 70)
言有宗	My words possess a lineage, (Chapter 70)
事有君	My duties possess a ruler. (Chapter 70)
夫唯無知	Now : only because I am without-knowledge, (Chapter 70)
是以不我知	Thus I am not understood. (Chapter 70)
知我者希	Those who understand me are rare, (Chapter 70)
則我者貴[矣]	Consequently I am one who is valued! (Chapter 70)
是以聖人	Thus the sage wears coarse cloth, but carries jade in hisheart. (Chapter 70)
被褐[而]懷玉	♦My words are very easy to understand, (Chapter 70)
知不知尚[矣]	Knowing that you do not know is honorable! (Chapter 71)
不知知病[矣]	Not knowing that you know is a sickness! (Chapter 71)
夫唯病病	Now : only when you are sick of sickness, (Chapter 71)
是以不病	Thus you are not sick. (Chapter 71)
聖人不病	The sage is not sick (Chapter 71)
以其病病	Because he is sick of sickness. (Chapter 71)
是以不病	Thus he is not sick. (Chapter 71)
民不畏威	If the citizens do not fear your authority, (Chapter 72)
則大威至[矣]	Then a greater authority will arrive! (Chapter 72)
無狎其所居	Do not disrespect their dwellings, (Chapter 72)
無厭其所生	Do not despise their livelihood. (Chapter 72)
夫唯不厭	Now : only because you do not despise them, (Chapter 72)
是以不厭	Thus they will not tire of you. (Chapter 72)
是以聖人	Thus the sage : (Chapter 72)
自知不自見	Knows himself but not display himself, (Chapter 72)
自愛不自貴	Loves himself but does not exalt himself. (Chapter 72)
故去彼取此	Therefore he leaves that and chooses this. (Chapter 72)
勇於敢	When your courage lies in daring, (Chapter 73)
則殺	The consequence is killing. (Chapter 73)
勇於不敢	When your courage lies in not daring, (Chapter 73)
則活	The consequence is survival. (Chapter 73)
此兩者或利或害	These two choices, they sometimes cause benefit,sometimes cause harm. (Chapter 73)
天之所惡孰知其故	That which heaven detests – who knows its reasons? (Chapter 73)
是以聖人猶難之	The Way of heaven : (Chapter 73)
天之道	Does not strive, yet skillfully achieves its goals. (Chapter 73)
不爭而善勝	Does not speak, yet skillfully responds. (Chapter 73)
不言而善應	Does not summon, yet everything naturally comes to it. (Chapter 73)
不召而自來	Is certainly unhurried, yet skillfully prepares. (Chapter 73)
繟然而善謀	Heaven’s net is extremely vast; (Chapter 73)
天網恢恢	It is wide meshed, yet does not fail. (Chapter 73)
疏而不失	♦When your courage* lies in daring, (Chapter 73)
民不畏死	If the citizens do not fear death, (Chapter 74)
奈何以死懼之	How can you use death to frighten them? (Chapter 74)
若使民常畏死	Assuming you could ensure that the citizens always feardeath, (Chapter 74)
而為奇者吾得執而殺之	And I get hold of those who act strange and unusual andkill them, (Chapter 74)
孰敢	Then who would be daring? (Chapter 74)
常有司殺者__	There will always exist an executioner. (Chapter 74)
夫代司殺者殺	Now : to take the place of the executioner to do thekilling, (Chapter 74)
是謂代大匠斲	This is called taking the place of a great craftsman to carvewood. (Chapter 74)
夫代大匠斲者	Now : of those who take the place of a great craftsman tocarve wood, (Chapter 74)
希__不傷其手矣	Few will not injure their hand! (Chapter 74)
民之饑	The citizens are hungry (Chapter 75)
以其上食稅之多	Because their superiors eat too much of their taxes. (Chapter 75)
是以饑	Thus they are hungry. (Chapter 75)
民之難治	The citizens are hard to govern (Chapter 75)
以其上之有為	Because their superiors are compelled to take action. (Chapter 75)
是以難治	Thus they are hard to govern. (Chapter 75)
民之輕死	The citizens take death lightly (Chapter 75)
以其求生之厚	Because they seek the substance of life. (Chapter 75)
是以輕死	Thus they take death lightly. (Chapter 75)
夫唯無以生為者	Now : only he who has no use for being alive (Chapter 75)
是賢於貴生	Is virtuous compared to he who values living. (Chapter 75)
人之生也柔弱	The people are born (indeed!) soft and weak. (Chapter 76)
其死也堅強	They die (indeed!) hard and inflexible. (Chapter 76)
萬物草木之生也柔脆	The ten thousand creatures, the grass and trees, are born(indeed!) soft and fragile. (Chapter 76)
其死也枯槁	They die (indeed!) dried and withered. (Chapter 76)
故堅強者死之徒	Therefore : that which is hard and inflexible is a followerof death. (Chapter 76)
柔弱者生之徒	That which is soft and weak is a follower of life. (Chapter 76)
是以兵強則不勝	Thus if a weapon is inflexible, the consequence is defeat. (Chapter 76)
木強則兵	If a tree is inflexible, then it snaps. (Chapter 76)
強大處下	Inflexible and great dwell below. (Chapter 76)
柔弱處上	Soft and weak dwell above. (Chapter 76)
天之道其猶張弓與	The Way of heaven, how it is just like stretching a bow? (Chapter 77)
高者抑之	He who is high is pressed down by it. (Chapter 77)
下者舉之	He who is low is lifted by it. (Chapter 77)
有餘者損之	He who has excess is reduced by it. (Chapter 77)
不足者補之	He who does not have enough is filled by it. (Chapter 77)
天之道	The Way of heaven (Chapter 77)
損有餘而補不足	Reduces what has excess and fills what does not haveenough. (Chapter 77)
人之道則不然	The Way of people on the other hand is not like this, (Chapter 77)
損不足以奉有餘	And takes from those who do not have enough in order tooffer it to those who have too much. (Chapter 77)
孰能有餘而奉[於]天下	Who can have too much and offer it to the world? (Chapter 77)
唯有道者	Only he who possesses Dao. (Chapter 77)
是以聖人	Thus the sage : (Chapter 77)
為而不恃	Acts, but is not concerned with the results. (Chapter 77)
功成而不處	Accomplishes his tasks, but does not dwell on them. (Chapter 77)
其不欲見賢	He does not desire to display his virtue. (Chapter 77)
天下莫柔弱於水	In the world, nothing is softer and weaker than water. (Chapter 78)
而攻堅強者	Yet for attacking that which is hard and strong, (Chapter 78)
莫之能勝	There is nothing that can surpass it. (Chapter 78)
以其無以易之	This is because it endlessly replaces itself. (Chapter 78)
弱之勝強	Weakness conquers strength. (Chapter 78)
柔之勝剛	Softness conquers hardness. (Chapter 78)
天下莫不知	In the world, there is no one who does not know this, (Chapter 78)
莫能行	But there is no one who can practice it. (Chapter 78)
是以聖人云	Thus the sage says : (Chapter 78)
受國之垢	Accepting upon oneself the disgrace of the nation (Chapter 78)
是謂社稷[之]主	Is called being master of the shrines. (Chapter 78)
受國[之]不祥	Accepting upon oneself the misfortune of the nation (Chapter 78)
是謂天下[之]王	Is called being king of the world. (Chapter 78)
正言若反	Honest words seem contrary. (Chapter 78)
和大怨	Harmonize a great resentment, (Chapter 79)
必有餘怨	And there must exist some remaining resentment. (Chapter 79)
安可以為善	How can this be considered good? (Chapter 79)
是以聖人	Thus the sage : (Chapter 79)
執左契	Holds the left side of an agreement, (Chapter 79)
而不責於人	But does not demand payment of people. (Chapter 79)
[故]有德司契	Therefore : to have De is to take charge of youragreements; (Chapter 79)
無德司徹	To be without De is to take charge of taking away fromothers. (Chapter 79)
天道無親	The Way of heaven, while without favor, (Chapter 79)
常與善人	Is always with virtuous people. (Chapter 79)
小國寡民	In a small nation with few citizens : (Chapter 80)
使有什伯之器而不用	Ensure that it has the weapons of ten nobles, but does notuse them. (Chapter 80)
使民重死而不遠徙	Ensure that the citizens take death seriously, and do notmigrate far. (Chapter 80)
雖有舟輿無所乘之	Even though they have boats and carriages, there is noplace to take advantage of them. (Chapter 80)
雖有甲兵無所陳之	Even though they have armor and weapons, there is noplace to display them. (Chapter 80)
使民復結繩而用之	Ensure that the citizens return to knotting ropes and usingthem, (Chapter 80)
甘其食	Find deliciousness in their food, (Chapter 80)
美其服	Beauty in their clothes, (Chapter 80)
安其居	Contentment in their dwellings, (Chapter 80)
樂其俗	Happiness in their customs. (Chapter 80)
鄰國相望	Although neighboring nations overlook one another, (Chapter 80)
雞犬之聲相聞	And sounds of roosters and dogs can be heard in oneanother – (Chapter 80)
民至老死	The citizens reach old age and die, (Chapter 80)
不相往來	And do not come and go between one another. (Chapter 80)
信言不美	True words are not beautiful; (Chapter 81)
美言不信	Beautiful words are not true. (Chapter 81)
善者不辯	He who has virtue does not argue; (Chapter 81)
辯者不善	He who argues does not have virtue. (Chapter 81)
知者不博	He who knows is not learned; (Chapter 81)
博者不知	He who is learned does not know. (Chapter 81)
聖人不積	The sage does not accumulate things – (Chapter 81)
既以為人己愈有	Since through serving people, the more one has; (Chapter 81)
既以與人己愈多	Since through giving to people, one has even more. (Chapter 81)
天之道利而不害	The Way of heaven benefits and does not cause harm. (Chapter 81)
聖人之道為而不爭	The Way of the sage acts yet does not strive. (Chapter 81)
